السنة,الربع,المنطقة,النشاط الاقتصادي,حجم المنشأة,عدد المنشآت,عدد العاملين السعوديين,عدد السعوديين (ذكور),عدد السعوديات (إناث),عدد العاملين الأجانب,عدد الأجانب (ذكور),عدد الأجنبيات (إناث)
2022,2,المنطقة الشرقية,وكالات السفر ومشغّلو الجولات السياحية وخدمات الحجز والأنشطة المتصلة بها,صغيرة,49,282,132,150,445,434,11
2022,2,المنطقة الشرقية,وكالات السفر ومشغّلو الجولات السياحية وخدمات الحجز والأنشطة المتصلة بها,كبيرة,1,266,252,14,328,327,1
2022,2,المنطقة الشرقية,وكالات السفر ومشغّلو الجولات السياحية وخدمات الحجز والأنشطة المتصلة بها,متناهية الصغر,149,106,55,51,219,216,3
2022,2,المنطقة الشرقية,وكالات السفر ومشغّلو الجولات السياحية وخدمات الحجز والأنشطة المتصلة بها,متوسطة,8,220,122,98,443,441,2
2022,2,منطقة الباحة,وكالات السفر ومشغّلو الجولات السياحية وخدمات الحجز والأنشطة المتصلة بها,متناهية الصغر,2,0,0,0,6,6,0
2022,2,منطقة الجوف,وكالات السفر ومشغّلو الجولات السياحية وخدمات الحجز والأنشطة المتصلة بها,صغيرة,3,15,13,2,35,34,1
2022,2,منطقة الجوف,وكالات السفر ومشغّلو الجولات السياحية وخدمات الحجز والأنشطة المتصلة بها,متناهية الصغر,7,3,0,3,12,12,0
2022,2,منطقة الحدود الشمالية,وكالات السفر ومشغّلو الجولات السياحية وخدمات الحجز والأنشطة المتصلة بها,صغيرة,1,2,2,0,7,7,0
2022,2,منطقة الحدود الشمالية,وكالات السفر ومشغّلو الجولات السياحية وخدمات الحجز والأنشطة المتصلة بها,كبيرة,1,109,106,3,492,492,0
2022,2,منطقة الحدود الشمالية,وكالات السفر ومشغّلو الجولات السياحية وخدمات الحجز والأنشطة المتصلة بها,متناهية الصغر,8,2,1,1,11,11,0
2022,2,منطقة الرياض,وكالات السفر ومشغّلو الجولات السياحية وخدمات الحجز والأنشطة المتصلة بها,صغيرة,111,567,259,308,1057,1042,15
2022,2,منطقة الرياض,وكالات السفر ومشغّلو الجولات السياحية وخدمات الحجز والأنشطة المتصلة بها,كبيرة,4,608,440,168,900,873,27
2022,2,منطقة الرياض,وكالات السفر ومشغّلو الجولات السياحية وخدمات الحجز والأنشطة المتصلة بها,متناهية الصغر,323,194,94,100,548,536,12
2022,2,منطقة الرياض,وكالات السفر ومشغّلو الجولات السياحية وخدمات الحجز والأنشطة المتصلة بها,متوسطة,17,626,355,271,1120,1114,6
2022,2,منطقة القصيم,وكالات السفر ومشغّلو الجولات السياحية وخدمات الحجز والأنشطة المتصلة بها,صغيرة,15,42,16,26,133,131,2
2022,2,منطقة القصيم,وكالات السفر ومشغّلو الجولات السياحية وخدمات الحجز والأنشطة المتصلة بها,متناهية الصغر,73,16,8,8,164,163,1
2022,2,منطقة المدينة المنورة,وكالات السفر ومشغّلو الجولات السياحية وخدمات الحجز والأنشطة المتصلة بها,صغيرة,24,101,48,53,295,283,12
2022,2,منطقة المدينة المنورة,وكالات السفر ومشغّلو الجولات السياحية وخدمات الحجز والأنشطة المتصلة بها,متناهية الصغر,112,71,47,24,181,180,1
2022,2,منطقة تبوك,وكالات السفر ومشغّلو الجولات السياحية وخدمات الحجز والأنشطة المتصلة بها,صغيرة,6,27,16,11,52,52,0
2022,2,منطقة تبوك,وكالات السفر ومشغّلو الجولات السياحية وخدمات الحجز والأنشطة المتصلة بها,متناهية الصغر,30,16,7,9,47,46,1
2022,2,منطقة جازان,وكالات السفر ومشغّلو الجولات السياحية وخدمات الحجز والأنشطة المتصلة بها,صغيرة,3,12,4,8,14,14,0
2022,2,منطقة جازان,وكالات السفر ومشغّلو الجولات السياحية وخدمات الحجز والأنشطة المتصلة بها,متناهية الصغر,21,13,6,7,30,30,0
2022,2,منطقة حائل,وكالات السفر ومشغّلو الجولات السياحية وخدمات الحجز والأنشطة المتصلة بها,صغيرة,6,27,5,22,57,57,0
2022,2,منطقة حائل,وكالات السفر ومشغّلو الجولات السياحية وخدمات الحجز والأنشطة المتصلة بها,متناهية الصغر,17,10,6,4,27,27,0
2022,2,منطقة حائل,وكالات السفر ومشغّلو الجولات السياحية وخدمات الحجز والأنشطة المتصلة بها,متوسطة,1,11,11,0,42,42,0
2022,2,منطقة عسير,وكالات السفر ومشغّلو الجولات السياحية وخدمات الحجز والأنشطة المتصلة بها,صغيرة,6,18,9,9,34,34,0
2022,2,منطقة عسير,وكالات السفر ومشغّلو الجولات السياحية وخدمات الحجز والأنشطة المتصلة بها,متناهية الصغر,41,29,20,9,61,61,0
2022,2,منطقة مكة المكرمة,وكالات السفر ومشغّلو الجولات السياحية وخدمات الحجز والأنشطة المتصلة بها,صغيرة,198,755,448,307,1560,1531,29
2022,2,منطقة مكة المكرمة,وكالات السفر ومشغّلو الجولات السياحية وخدمات الحجز والأنشطة المتصلة بها,كبيرة,2,3848,3161,687,1343,1343,0
2022,2,منطقة مكة المكرمة,وكالات السفر ومشغّلو الجولات السياحية وخدمات الحجز والأنشطة المتصلة بها,متناهية الصغر,539,401,250,151,872,852,20
2022,2,منطقة مكة المكرمة,وكالات السفر ومشغّلو الجولات السياحية وخدمات الحجز والأنشطة المتصلة بها,متوسطة,16,779,495,284,778,772,6
2022,2,منطقة نجران,وكالات السفر ومشغّلو الجولات السياحية وخدمات الحجز والأنشطة المتصلة بها,صغيرة,3,4,2,2,34,34,0
2022,2,منطقة نجران,وكالات السفر ومشغّلو الجولات السياحية وخدمات الحجز والأنشطة المتصلة بها,متناهية الصغر,10,5,4,1,20,20,0
2022,2,المنطقة الشرقية,صيد الأسماك وتربية المائيات,صغيرة,122,130,52,78,1339,1338,1
2022,2,المنطقة الشرقية,صيد الأسماك وتربية المائيات,متناهية الصغر,554,96,55,41,1349,1345,4
2022,2,المنطقة الشرقية,صيد الأسماك وتربية المائيات,متوسطة,1,7,3,4,57,57,0
2022,2,منطقة الباحة,صيد الأسماك وتربية المائيات,صغيرة,1,1,1,0,5,5,0
2022,2,منطقة الباحة,صيد الأسماك وتربية المائيات,متناهية الصغر,26,5,4,1,51,51,0
2022,2,منطقة الجوف,صيد الأسماك وتربية المائيات,متناهية الصغر,177,9,8,1,270,270,0
2022,2,منطقة الحدود الشمالية,صيد الأسماك وتربية المائيات,متناهية الصغر,38,4,2,2,84,84,0
2022,2,منطقة الرياض,صيد الأسماك وتربية المائيات,صغيرة,103,123,71,52,750,750,0
2022,2,منطقة الرياض,صيد الأسماك وتربية المائيات,متناهية الصغر,18369,2550,1258,1292,41601,41375,226
2022,2,منطقة القصيم,صيد الأسماك وتربية المائيات,صغيرة,3,1,0,1,28,28,0
2022,2,منطقة القصيم,صيد الأسماك وتربية المائيات,متناهية الصغر,559,95,54,41,1252,1251,1
2022,2,منطقة المدينة المنورة,صيد الأسماك وتربية المائيات,صغيرة,10,3,1,2,80,80,0
2022,2,منطقة المدينة المنورة,صيد الأسماك وتربية المائيات,متناهية الصغر,272,35,16,19,499,475,24
2022,2,منطقة تبوك,صيد الأسماك وتربية المائيات,صغيرة,5,8,2,6,43,43,0
2022,2,منطقة تبوك,صيد الأسماك وتربية المائيات,متناهية الصغر,112,11,5,6,181,180,1
2022,2,منطقة جازان,صيد الأسماك وتربية المائيات,صغيرة,48,120,94,26,567,566,1
2022,2,منطقة جازان,صيد الأسماك وتربية المائيات,كبيرة,1,76,70,6,229,229,0
2022,2,منطقة جازان,صيد الأسماك وتربية المائيات,متناهية الصغر,287,39,19,20,574,569,5
2022,2,منطقة جازان,صيد الأسماك وتربية المائيات,متوسطة,1,28,11,17,203,203,0
2022,2,منطقة حائل,صيد الأسماك وتربية المائيات,صغيرة,3,2,1,1,16,16,0
2022,2,منطقة حائل,صيد الأسماك وتربية المائيات,متناهية الصغر,964,96,50,46,2143,2135,8
2022,2,منطقة عسير,صيد الأسماك وتربية المائيات,صغيرة,7,3,2,1,65,65,0
2022,2,منطقة عسير,صيد الأسماك وتربية المائيات,متناهية الصغر,294,39,20,19,534,533,1
2022,2,منطقة مكة المكرمة,صيد الأسماك وتربية المائيات,صغيرة,48,42,24,18,477,475,2
2022,2,منطقة مكة المكرمة,صيد الأسماك وتربية المائيات,كبيرة,1,262,238,24,1777,1774,3
2022,2,منطقة مكة المكرمة,صيد الأسماك وتربية المائيات,متناهية الصغر,1888,183,96,87,3438,3288,150
2022,2,منطقة مكة المكرمة,صيد الأسماك وتربية المائيات,متوسطة,1,1,1,0,67,67,0
2022,2,منطقة نجران,صيد الأسماك وتربية المائيات,صغيرة,5,4,1,3,33,33,0
2022,2,منطقة نجران,صيد الأسماك وتربية المائيات,متناهية الصغر,697,83,47,36,1469,1465,4
2022,2,المنطقة الشرقية,صنع منتجات المعادن المشكلة ( باستثناء الآلات والمعدات ),صغيرة,612,1842,1151,691,7280,7268,12
2022,2,المنطقة الشرقية,صنع منتجات المعادن المشكلة ( باستثناء الآلات والمعدات ),كبيرة,23,6879,6547,332,7980,7971,9
2022,2,المنطقة الشرقية,صنع منتجات المعادن المشكلة ( باستثناء الآلات والمعدات ),متناهية الصغر,1355,478,266,212,2933,2929,4
2022,2,المنطقة الشرقية,صنع منتجات المعادن المشكلة ( باستثناء الآلات والمعدات ),متوسطة,99,2485,1895,590,7623,7615,8
2022,2,منطقة الباحة,صنع منتجات المعادن المشكلة ( باستثناء الآلات والمعدات ),صغيرة,22,24,15,9,171,171,0
2022,2,منطقة الباحة,صنع منتجات المعادن المشكلة ( باستثناء الآلات والمعدات ),متناهية الصغر,244,53,37,16,503,503,0
2022,2,منطقة الباحة,صنع منتجات المعادن المشكلة ( باستثناء الآلات والمعدات ),متوسطة,1,14,13,1,55,55,0
2022,2,منطقة الجوف,صنع منتجات المعادن المشكلة ( باستثناء الآلات والمعدات ),صغيرة,33,41,33,8,343,343,0
2022,2,منطقة الجوف,صنع منتجات المعادن المشكلة ( باستثناء الآلات والمعدات ),متناهية الصغر,247,43,36,7,542,541,1
2022,2,منطقة الحدود الشمالية,صنع منتجات المعادن المشكلة ( باستثناء الآلات والمعدات ),صغيرة,19,34,21,13,209,209,0
2022,2,منطقة الحدود الشمالية,صنع منتجات المعادن المشكلة ( باستثناء الآلات والمعدات ),متناهية الصغر,97,24,13,11,225,221,4
2022,2,منطقة الرياض,صنع منتجات المعادن المشكلة ( باستثناء الآلات والمعدات ),صغيرة,912,2712,1173,1539,11612,11551,61
2022,2,منطقة الرياض,صنع منتجات المعادن المشكلة ( باستثناء الآلات والمعدات ),كبيرة,14,2499,1536,963,4966,4956,10
2022,2,منطقة الرياض,صنع منتجات المعادن المشكلة ( باستثناء الآلات والمعدات ),متناهية الصغر,2299,656,301,355,5164,5147,17
2022,2,منطقة الرياض,صنع منتجات المعادن المشكلة ( باستثناء الآلات والمعدات ),متوسطة,139,3050,1697,1353,10663,10631,32
2022,2,منطقة القصيم,صنع منتجات المعادن المشكلة ( باستثناء الآلات والمعدات ),صغيرة,181,297,166,131,1822,1821,1
2022,2,منطقة القصيم,صنع منتجات المعادن المشكلة ( باستثناء الآلات والمعدات ),كبيرة,1,125,103,22,380,380,0
2022,2,منطقة القصيم,صنع منتجات المعادن المشكلة ( باستثناء الآلات والمعدات ),متناهية الصغر,1118,219,124,95,2634,2627,7
2022,2,منطقة القصيم,صنع منتجات المعادن المشكلة ( باستثناء الآلات والمعدات ),متوسطة,7,121,74,47,379,379,0
2022,2,منطقة المدينة المنورة,صنع منتجات المعادن المشكلة ( باستثناء الآلات والمعدات ),صغيرة,88,187,103,84,857,856,1
2022,2,منطقة المدينة المنورة,صنع منتجات المعادن المشكلة ( باستثناء الآلات والمعدات ),متناهية الصغر,557,123,80,43,1241,1239,2
2022,2,منطقة المدينة المنورة,صنع منتجات المعادن المشكلة ( باستثناء الآلات والمعدات ),متوسطة,8,185,131,54,693,692,1
2022,2,منطقة تبوك,صنع منتجات المعادن المشكلة ( باستثناء الآلات والمعدات ),صغيرة,36,51,30,21,334,333,1
2022,2,منطقة تبوك,صنع منتجات المعادن المشكلة ( باستثناء الآلات والمعدات ),متناهية الصغر,209,54,27,27,452,452,0
2022,2,منطقة تبوك,صنع منتجات المعادن المشكلة ( باستثناء الآلات والمعدات ),متوسطة,2,25,17,8,114,113,1
2022,2,منطقة جازان,صنع منتجات المعادن المشكلة ( باستثناء الآلات والمعدات ),صغيرة,46,76,44,32,377,376,1
2022,2,منطقة جازان,صنع منتجات المعادن المشكلة ( باستثناء الآلات والمعدات ),متناهية الصغر,735,100,68,32,1761,1757,4
2022,2,منطقة حائل,صنع منتجات المعادن المشكلة ( باستثناء الآلات والمعدات ),صغيرة,48,128,71,57,480,480,0
2022,2,منطقة حائل,صنع منتجات المعادن المشكلة ( باستثناء الآلات والمعدات ),متناهية الصغر,221,44,26,18,490,486,4
2022,2,منطقة حائل,صنع منتجات المعادن المشكلة ( باستثناء الآلات والمعدات ),متوسطة,2,24,7,17,117,117,0
2022,2,منطقة عسير,صنع منتجات المعادن المشكلة ( باستثناء الآلات والمعدات ),صغيرة,91,198,124,74,873,872,1
2022,2,منطقة عسير,صنع منتجات المعادن المشكلة ( باستثناء الآلات والمعدات ),متناهية الصغر,915,183,113,70,2050,2049,1
2022,2,منطقة عسير,صنع منتجات المعادن المشكلة ( باستثناء الآلات والمعدات ),متوسطة,7,75,54,21,482,482,0
2022,2,منطقة مكة المكرمة,صنع منتجات المعادن المشكلة ( باستثناء الآلات والمعدات ),صغيرة,369,888,453,435,4245,4221,24
2022,2,منطقة مكة المكرمة,صنع منتجات المعادن المشكلة ( باستثناء الآلات والمعدات ),كبيرة,10,1095,733,362,2997,2991,6
2022,2,منطقة مكة المكرمة,صنع منتجات المعادن المشكلة ( باستثناء الآلات والمعدات ),متناهية الصغر,1897,361,192,169,4322,4308,14
2022,2,منطقة مكة المكرمة,صنع منتجات المعادن المشكلة ( باستثناء الآلات والمعدات ),متوسطة,74,1876,1396,480,5983,5963,20
2022,2,منطقة نجران,صنع منتجات المعادن المشكلة ( باستثناء الآلات والمعدات ),صغيرة,24,37,17,20,242,241,1
2022,2,منطقة نجران,صنع منتجات المعادن المشكلة ( باستثناء الآلات والمعدات ),متناهية الصغر,289,42,25,17,731,731,0
2022,2,المنطقة الشرقية,صنع منتجات المعادن اللافلزية الأخرى,صغيرة,274,1008,627,381,4357,4331,26
2022,2,المنطقة الشرقية,صنع منتجات المعادن اللافلزية الأخرى,كبيرة,18,2494,2059,435,6168,6165,3
2022,2,المنطقة الشرقية,صنع منتجات المعادن اللافلزية الأخرى,متناهية الصغر,355,144,79,65,782,781,1
2022,2,المنطقة الشرقية,صنع منتجات المعادن اللافلزية الأخرى,متوسطة,101,1930,1341,589,8330,8327,3
2022,2,منطقة الباحة,صنع منتجات المعادن اللافلزية الأخرى,صغيرة,25,91,67,24,343,342,1
2022,2,منطقة الباحة,صنع منتجات المعادن اللافلزية الأخرى,متناهية الصغر,43,11,10,1,89,89,0
2022,2,منطقة الباحة,صنع منتجات المعادن اللافلزية الأخرى,متوسطة,5,64,42,22,347,346,1
2022,2,منطقة الجوف,صنع منتجات المعادن اللافلزية الأخرى,صغيرة,36,122,81,41,490,488,2
2022,2,منطقة الجوف,صنع منتجات المعادن اللافلزية الأخرى,متناهية الصغر,48,12,9,3,91,90,1
2022,2,منطقة الجوف,صنع منتجات المعادن اللافلزية الأخرى,متوسطة,7,129,105,24,571,571,0
2022,2,منطقة الحدود الشمالية,صنع منتجات المعادن اللافلزية الأخرى,صغيرة,23,68,33,35,314,314,0
2022,2,منطقة الحدود الشمالية,صنع منتجات المعادن اللافلزية الأخرى,كبيرة,1,246,244,2,240,240,0
2022,2,منطقة الحدود الشمالية,صنع منتجات المعادن اللافلزية الأخرى,متناهية الصغر,38,14,9,5,76,76,0
2022,2,منطقة الحدود الشمالية,صنع منتجات المعادن اللافلزية الأخرى,متوسطة,1,34,16,18,94,94,0
2022,2,منطقة الرياض,صنع منتجات المعادن اللافلزية الأخرى,صغيرة,1192,2039,943,1096,19756,19687,69
2022,2,منطقة الرياض,صنع منتجات المعادن اللافلزية الأخرى,كبيرة,31,4908,3726,1182,12149,12136,13
2022,2,منطقة الرياض,صنع منتجات المعادن اللافلزية الأخرى,متناهية الصغر,1586,396,186,210,3706,3687,19
2022,2,منطقة الرياض,صنع منتجات المعادن اللافلزية الأخرى,متوسطة,315,3537,1848,1689,23398,23351,47
2022,2,منطقة القصيم,صنع منتجات المعادن اللافلزية الأخرى,صغيرة,136,303,180,123,2153,2141,12
2022,2,منطقة القصيم,صنع منتجات المعادن اللافلزية الأخرى,كبيرة,5,824,668,156,2736,2736,0
2022,2,منطقة القصيم,صنع منتجات المعادن اللافلزية الأخرى,متناهية الصغر,242,57,29,28,619,619,0
2022,2,منطقة القصيم,صنع منتجات المعادن اللافلزية الأخرى,متوسطة,36,598,382,216,2932,2930,2
2022,2,منطقة المدينة المنورة,صنع منتجات المعادن اللافلزية الأخرى,صغيرة,90,197,125,72,1205,1203,2
2022,2,منطقة المدينة المنورة,صنع منتجات المعادن اللافلزية الأخرى,كبيرة,4,595,427,168,1555,1553,2
2022,2,منطقة المدينة المنورة,صنع منتجات المعادن اللافلزية الأخرى,متناهية الصغر,173,43,27,16,388,386,2
2022,2,منطقة المدينة المنورة,صنع منتجات المعادن اللافلزية الأخرى,متوسطة,34,1031,813,218,2717,2716,1
2022,2,منطقة تبوك,صنع منتجات المعادن اللافلزية الأخرى,صغيرة,28,114,69,45,359,359,0
2022,2,منطقة تبوك,صنع منتجات المعادن اللافلزية الأخرى,كبيرة,2,347,327,20,594,592,2
2022,2,منطقة تبوك,صنع منتجات المعادن اللافلزية الأخرى,متناهية الصغر,49,15,8,7,100,100,0
2022,2,منطقة تبوك,صنع منتجات المعادن اللافلزية الأخرى,متوسطة,3,47,32,15,199,199,0
2022,2,منطقة جازان,صنع منتجات المعادن اللافلزية الأخرى,صغيرة,67,258,147,111,879,876,3
2022,2,منطقة جازان,صنع منتجات المعادن اللافلزية الأخرى,كبيرة,1,352,352,0,164,164,0
2022,2,منطقة جازان,صنع منتجات المعادن اللافلزية الأخرى,متناهية الصغر,128,41,28,13,313,313,0
2022,2,منطقة جازان,صنع منتجات المعادن اللافلزية الأخرى,متوسطة,22,510,344,166,1571,1571,0
2022,2,منطقة حائل,صنع منتجات المعادن اللافلزية الأخرى,صغيرة,44,47,34,13,564,562,2
2022,2,منطقة حائل,صنع منتجات المعادن اللافلزية الأخرى,كبيرة,1,254,254,0,166,166,0
2022,2,منطقة حائل,صنع منتجات المعادن اللافلزية الأخرى,متناهية الصغر,146,32,19,13,351,350,1
2022,2,منطقة حائل,صنع منتجات المعادن اللافلزية الأخرى,متوسطة,8,139,93,46,531,531,0
2022,2,منطقة عسير,صنع منتجات المعادن اللافلزية الأخرى,صغيرة,159,413,246,167,2146,2140,6
2022,2,منطقة عسير,صنع منتجات المعادن اللافلزية الأخرى,كبيرة,6,963,900,63,2130,2129,1
2022,2,منطقة عسير,صنع منتجات المعادن اللافلزية الأخرى,متناهية الصغر,246,79,46,33,599,598,1
2022,2,منطقة عسير,صنع منتجات المعادن اللافلزية الأخرى,متوسطة,34,666,448,218,2649,2649,0
2022,2,منطقة مكة المكرمة,صنع منتجات المعادن اللافلزية الأخرى,صغيرة,248,738,393,345,3651,3640,11
2022,2,منطقة مكة المكرمة,صنع منتجات المعادن اللافلزية الأخرى,كبيرة,16,2870,2007,863,6419,6414,5
2022,2,منطقة مكة المكرمة,صنع منتجات المعادن اللافلزية الأخرى,متناهية الصغر,429,140,86,54,918,913,5
2022,2,منطقة مكة المكرمة,صنع منتجات المعادن اللافلزية الأخرى,متوسطة,64,1351,843,508,4930,4924,6
2022,2,منطقة نجران,صنع منتجات المعادن اللافلزية الأخرى,صغيرة,38,127,77,50,573,563,10
2022,2,منطقة نجران,صنع منتجات المعادن اللافلزية الأخرى,كبيرة,1,344,327,17,392,392,0
2022,2,منطقة نجران,صنع منتجات المعادن اللافلزية الأخرى,متناهية الصغر,74,17,11,6,178,177,1
2022,2,منطقة نجران,صنع منتجات المعادن اللافلزية الأخرى,متوسطة,17,294,193,101,1445,1438,7
2022,2,المنطقة الشرقية,صنع منتجات المطاط واللدائن,صغيرة,42,167,107,60,719,719,0
2022,2,المنطقة الشرقية,صنع منتجات المطاط واللدائن,كبيرة,3,403,349,54,869,869,0
2022,2,المنطقة الشرقية,صنع منتجات المطاط واللدائن,متناهية الصغر,48,25,14,11,104,104,0
2022,2,المنطقة الشرقية,صنع منتجات المطاط واللدائن,متوسطة,36,1071,824,247,2696,2693,3
2022,2,منطقة الباحة,صنع منتجات المطاط واللدائن,صغيرة,1,3,2,1,21,21,0
2022,2,منطقة الباحة,صنع منتجات المطاط واللدائن,متناهية الصغر,2,1,0,1,1,1,0
2022,2,منطقة الجوف,صنع منتجات المطاط واللدائن,صغيرة,2,7,5,2,30,30,0
2022,2,منطقة الجوف,صنع منتجات المطاط واللدائن,كبيرة,1,133,92,41,355,354,1
2022,2,منطقة الجوف,صنع منتجات المطاط واللدائن,متناهية الصغر,9,2,2,0,24,24,0
2022,2,منطقة الحدود الشمالية,صنع منتجات المطاط واللدائن,صغيرة,1,3,1,2,5,5,0
2022,2,منطقة الحدود الشمالية,صنع منتجات المطاط واللدائن,متوسطة,1,0,0,0,101,101,0
2022,2,منطقة الرياض,صنع منتجات المطاط واللدائن,صغيرة,112,505,222,283,2035,2025,10
2022,2,منطقة الرياض,صنع منتجات المطاط واللدائن,كبيرة,10,964,529,435,2813,2808,5
2022,2,منطقة الرياض,صنع منتجات المطاط واللدائن,متناهية الصغر,177,70,38,32,379,378,1
2022,2,منطقة الرياض,صنع منتجات المطاط واللدائن,متوسطة,71,1778,939,839,5817,5806,11
2022,2,منطقة القصيم,صنع منتجات المطاط واللدائن,صغيرة,6,35,16,19,64,64,0
2022,2,منطقة القصيم,صنع منتجات المطاط واللدائن,متناهية الصغر,7,1,0,1,13,13,0
2022,2,منطقة القصيم,صنع منتجات المطاط واللدائن,متوسطة,6,163,104,59,479,478,1
2022,2,منطقة المدينة المنورة,صنع منتجات المطاط واللدائن,صغيرة,18,95,47,48,354,353,1
2022,2,منطقة المدينة المنورة,صنع منتجات المطاط واللدائن,كبيرة,1,137,72,65,340,340,0
2022,2,منطقة المدينة المنورة,صنع منتجات المطاط واللدائن,متناهية الصغر,22,16,9,7,33,33,0
2022,2,منطقة المدينة المنورة,صنع منتجات المطاط واللدائن,متوسطة,7,219,154,65,643,637,6
2022,2,منطقة تبوك,صنع منتجات المطاط واللدائن,صغيرة,6,17,10,7,73,73,0
2022,2,منطقة تبوك,صنع منتجات المطاط واللدائن,متناهية الصغر,6,3,0,3,15,15,0
2022,2,منطقة جازان,صنع منتجات المطاط واللدائن,صغيرة,3,7,6,1,42,42,0
2022,2,منطقة جازان,صنع منتجات المطاط واللدائن,متناهية الصغر,2,0,0,0,7,7,0
2022,2,منطقة حائل,صنع منتجات المطاط واللدائن,صغيرة,4,27,9,18,90,90,0
2022,2,منطقة حائل,صنع منتجات المطاط واللدائن,متناهية الصغر,5,0,0,0,9,9,0
2022,2,منطقة حائل,صنع منتجات المطاط واللدائن,متوسطة,2,110,85,25,170,170,0
2022,2,منطقة عسير,صنع منتجات المطاط واللدائن,صغيرة,5,11,7,4,53,53,0
2022,2,منطقة عسير,صنع منتجات المطاط واللدائن,متناهية الصغر,24,6,5,1,48,48,0
2022,2,منطقة عسير,صنع منتجات المطاط واللدائن,متوسطة,3,64,35,29,200,200,0
2022,2,منطقة مكة المكرمة,صنع منتجات المطاط واللدائن,صغيرة,76,389,214,175,1356,1340,16
2022,2,منطقة مكة المكرمة,صنع منتجات المطاط واللدائن,كبيرة,10,1145,842,303,2895,2876,19
2022,2,منطقة مكة المكرمة,صنع منتجات المطاط واللدائن,متناهية الصغر,74,33,22,11,141,140,1
2022,2,منطقة مكة المكرمة,صنع منتجات المطاط واللدائن,متوسطة,33,913,543,370,2957,2953,4
2022,2,منطقة نجران,صنع منتجات المطاط واللدائن,صغيرة,5,29,16,13,96,96,0
2022,2,منطقة نجران,صنع منتجات المطاط واللدائن,متناهية الصغر,8,2,0,2,25,25,0
2022,2,منطقة نجران,صنع منتجات المطاط واللدائن,متوسطة,1,52,19,33,113,113,0
2022,2,المنطقة الشرقية,صنع فحم الكوك والمنتجات النفطية المكررة,صغيرة,20,102,71,31,324,323,1
2022,2,المنطقة الشرقية,صنع فحم الكوك والمنتجات النفطية المكررة,كبيرة,7,3383,3339,44,1645,1644,1
2022,2,المنطقة الشرقية,صنع فحم الكوك والمنتجات النفطية المكررة,متناهية الصغر,16,20,11,9,24,24,0
2022,2,المنطقة الشرقية,صنع فحم الكوك والمنتجات النفطية المكررة,متوسطة,10,588,558,30,613,613,0
2022,2,منطقة الجوف,صنع فحم الكوك والمنتجات النفطية المكررة,متناهية الصغر,2,0,0,0,4,4,0
2022,2,منطقة الرياض,صنع فحم الكوك والمنتجات النفطية المكررة,صغيرة,31,132,86,46,340,337,3
2022,2,منطقة الرياض,صنع فحم الكوك والمنتجات النفطية المكررة,متناهية الصغر,41,32,18,14,67,66,1
2022,2,منطقة الرياض,صنع فحم الكوك والمنتجات النفطية المكررة,متوسطة,5,171,127,44,342,341,1
2022,2,منطقة القصيم,صنع فحم الكوك والمنتجات النفطية المكررة,صغيرة,3,19,18,1,53,53,0
2022,2,منطقة القصيم,صنع فحم الكوك والمنتجات النفطية المكررة,متناهية الصغر,4,4,3,1,6,6,0
2022,2,منطقة المدينة المنورة,صنع فحم الكوك والمنتجات النفطية المكررة,صغيرة,1,8,8,0,22,22,0
2022,2,منطقة المدينة المنورة,صنع فحم الكوك والمنتجات النفطية المكررة,كبيرة,4,1958,1900,58,784,784,0
2022,2,منطقة المدينة المنورة,صنع فحم الكوك والمنتجات النفطية المكررة,متناهية الصغر,5,4,3,1,12,12,0
2022,2,منطقة المدينة المنورة,صنع فحم الكوك والمنتجات النفطية المكررة,متوسطة,3,289,289,0,170,170,0
2022,2,منطقة جازان,صنع فحم الكوك والمنتجات النفطية المكررة,متوسطة,1,114,109,5,43,38,5
2022,2,منطقة عسير,صنع فحم الكوك والمنتجات النفطية المكررة,صغيرة,2,9,5,4,20,20,0
2022,2,منطقة مكة المكرمة,صنع فحم الكوك والمنتجات النفطية المكررة,صغيرة,20,110,77,33,266,264,2
2022,2,منطقة مكة المكرمة,صنع فحم الكوك والمنتجات النفطية المكررة,كبيرة,2,2821,2731,90,1610,1597,13
2022,2,منطقة مكة المكرمة,صنع فحم الكوك والمنتجات النفطية المكررة,متناهية الصغر,14,7,6,1,23,23,0
2022,2,منطقة مكة المكرمة,صنع فحم الكوك والمنتجات النفطية المكررة,متوسطة,2,13,13,0,120,120,0
2022,2,المنطقة الشرقية,صُنع الورق ومنتجات الورق,صغيرة,51,257,150,107,877,876,1
2022,2,المنطقة الشرقية,صُنع الورق ومنتجات الورق,كبيرة,5,573,458,115,1420,1418,2
2022,2,المنطقة الشرقية,صُنع الورق ومنتجات الورق,متناهية الصغر,44,25,14,11,106,105,1
2022,2,المنطقة الشرقية,صُنع الورق ومنتجات الورق,متوسطة,15,563,402,161,1406,1405,1
2022,2,منطقة الباحة,صُنع الورق ومنتجات الورق,متناهية الصغر,1,0,0,0,1,1,0
2022,2,منطقة الجوف,صُنع الورق ومنتجات الورق,صغيرة,1,3,2,1,12,12,0
2022,2,منطقة الجوف,صُنع الورق ومنتجات الورق,متناهية الصغر,2,1,1,0,7,7,0
2022,2,منطقة الحدود الشمالية,صُنع الورق ومنتجات الورق,صغيرة,2,2,1,1,15,15,0
2022,2,منطقة الحدود الشمالية,صُنع الورق ومنتجات الورق,متناهية الصغر,2,0,0,0,3,3,0
2022,2,منطقة الرياض,صُنع الورق ومنتجات الورق,صغيرة,93,450,207,243,1347,1344,3
2022,2,منطقة الرياض,صُنع الورق ومنتجات الورق,كبيرة,2,136,43,93,378,378,0
2022,2,منطقة الرياض,صُنع الورق ومنتجات الورق,متناهية الصغر,108,62,26,36,245,244,1
2022,2,منطقة الرياض,صُنع الورق ومنتجات الورق,متوسطة,31,828,507,321,2528,2524,4
2022,2,منطقة القصيم,صُنع الورق ومنتجات الورق,صغيرة,9,35,15,20,135,134,1
2022,2,منطقة القصيم,صُنع الورق ومنتجات الورق,متناهية الصغر,15,7,2,5,34,34,0
2022,2,منطقة القصيم,صُنع الورق ومنتجات الورق,متوسطة,4,98,74,24,364,363,1
2022,2,منطقة المدينة المنورة,صُنع الورق ومنتجات الورق,صغيرة,10,40,20,20,157,156,1
2022,2,منطقة المدينة المنورة,صُنع الورق ومنتجات الورق,متناهية الصغر,15,6,3,3,37,37,0
2022,2,منطقة المدينة المنورة,صُنع الورق ومنتجات الورق,متوسطة,1,26,10,16,76,76,0
2022,2,منطقة تبوك,صُنع الورق ومنتجات الورق,صغيرة,3,17,7,10,57,57,0
2022,2,منطقة تبوك,صُنع الورق ومنتجات الورق,متناهية الصغر,5,6,4,2,10,10,0
2022,2,منطقة جازان,صُنع الورق ومنتجات الورق,صغيرة,1,1,0,1,6,6,0
2022,2,منطقة جازان,صُنع الورق ومنتجات الورق,متناهية الصغر,6,4,2,2,14,14,0
2022,2,منطقة جازان,صُنع الورق ومنتجات الورق,متوسطة,1,17,8,9,51,51,0
2022,2,منطقة حائل,صُنع الورق ومنتجات الورق,صغيرة,3,8,4,4,41,41,0
2022,2,منطقة حائل,صُنع الورق ومنتجات الورق,متناهية الصغر,5,5,3,2,13,13,0
2022,2,منطقة عسير,صُنع الورق ومنتجات الورق,صغيرة,10,24,14,10,107,107,0
2022,2,منطقة عسير,صُنع الورق ومنتجات الورق,متناهية الصغر,8,2,2,0,18,17,1
2022,2,منطقة مكة المكرمة,صُنع الورق ومنتجات الورق,صغيرة,68,265,158,107,969,965,4
2022,2,منطقة مكة المكرمة,صُنع الورق ومنتجات الورق,كبيرة,5,667,505,162,1645,1638,7
2022,2,منطقة مكة المكرمة,صُنع الورق ومنتجات الورق,متناهية الصغر,53,31,19,12,104,100,4
2022,2,منطقة مكة المكرمة,صُنع الورق ومنتجات الورق,متوسطة,21,675,349,326,1616,1606,10
2022,2,منطقة نجران,صُنع الورق ومنتجات الورق,صغيرة,2,1,1,0,15,15,0
2022,2,منطقة نجران,صُنع الورق ومنتجات الورق,متناهية الصغر,23,3,2,1,59,59,0
2022,2,المنطقة الشرقية,صُنع المواد الكيميائية والمنتجات الكيميائية,صغيرة,167,1010,707,303,2415,2405,10
2022,2,المنطقة الشرقية,صُنع المواد الكيميائية والمنتجات الكيميائية,كبيرة,16,11079,10962,117,2597,2596,1
2022,2,المنطقة الشرقية,صُنع المواد الكيميائية والمنتجات الكيميائية,متناهية الصغر,158,121,63,58,274,274,0
2022,2,المنطقة الشرقية,صُنع المواد الكيميائية والمنتجات الكيميائية,متوسطة,74,3236,2853,383,4737,4731,6
2022,2,منطقة الباحة,صُنع المواد الكيميائية والمنتجات الكيميائية,صغيرة,4,5,4,1,64,64,0
2022,2,منطقة الباحة,صُنع المواد الكيميائية والمنتجات الكيميائية,متناهية الصغر,5,0,0,0,10,10,0
2022,2,منطقة الجوف,صُنع المواد الكيميائية والمنتجات الكيميائية,صغيرة,1,2,1,1,5,5,0
2022,2,منطقة الجوف,صُنع المواد الكيميائية والمنتجات الكيميائية,متناهية الصغر,8,1,1,0,16,16,0
2022,2,منطقة الحدود الشمالية,صُنع المواد الكيميائية والمنتجات الكيميائية,كبيرة,1,581,574,7,229,229,0
2022,2,منطقة الحدود الشمالية,صُنع المواد الكيميائية والمنتجات الكيميائية,متناهية الصغر,10,2,2,0,23,23,0
2022,2,منطقة الرياض,صُنع المواد الكيميائية والمنتجات الكيميائية,صغيرة,375,1577,740,837,5735,5720,15
2022,2,منطقة الرياض,صُنع المواد الكيميائية والمنتجات الكيميائية,كبيرة,14,2401,1609,792,4116,4101,15
2022,2,منطقة الرياض,صُنع المواد الكيميائية والمنتجات الكيميائية,متناهية الصغر,450,212,93,119,950,939,11
2022,2,منطقة الرياض,صُنع المواد الكيميائية والمنتجات الكيميائية,متوسطة,81,2024,1069,955,6331,6321,10
2022,2,منطقة القصيم,صُنع المواد الكيميائية والمنتجات الكيميائية,صغيرة,19,41,18,23,222,222,0
2022,2,منطقة القصيم,صُنع المواد الكيميائية والمنتجات الكيميائية,كبيرة,2,480,456,24,1185,1184,1
2022,2,منطقة القصيم,صُنع المواد الكيميائية والمنتجات الكيميائية,متناهية الصغر,26,7,3,4,49,49,0
2022,2,منطقة القصيم,صُنع المواد الكيميائية والمنتجات الكيميائية,متوسطة,8,182,111,71,554,554,0
2022,2,منطقة المدينة المنورة,صُنع المواد الكيميائية والمنتجات الكيميائية,صغيرة,29,155,120,35,421,419,2
2022,2,منطقة المدينة المنورة,صُنع المواد الكيميائية والمنتجات الكيميائية,كبيرة,4,2579,2569,10,497,497,0
2022,2,منطقة المدينة المنورة,صُنع المواد الكيميائية والمنتجات الكيميائية,متناهية الصغر,35,13,7,6,78,77,1
2022,2,منطقة المدينة المنورة,صُنع المواد الكيميائية والمنتجات الكيميائية,متوسطة,11,255,216,39,625,621,4
2022,2,منطقة تبوك,صُنع المواد الكيميائية والمنتجات الكيميائية,صغيرة,10,50,35,15,156,156,0
2022,2,منطقة تبوك,صُنع المواد الكيميائية والمنتجات الكيميائية,كبيرة,1,521,321,200,721,716,5
2022,2,منطقة تبوك,صُنع المواد الكيميائية والمنتجات الكيميائية,متناهية الصغر,16,4,2,2,32,32,0
2022,2,منطقة جازان,صُنع المواد الكيميائية والمنتجات الكيميائية,صغيرة,10,23,14,9,100,100,0
2022,2,منطقة جازان,صُنع المواد الكيميائية والمنتجات الكيميائية,متناهية الصغر,16,6,4,2,41,40,1
2022,2,منطقة جازان,صُنع المواد الكيميائية والمنتجات الكيميائية,متوسطة,1,9,9,0,73,73,0
2022,2,منطقة حائل,صُنع المواد الكيميائية والمنتجات الكيميائية,صغيرة,8,15,6,9,63,63,0
2022,2,منطقة حائل,صُنع المواد الكيميائية والمنتجات الكيميائية,متناهية الصغر,56,12,8,4,157,157,0
2022,2,منطقة عسير,صُنع المواد الكيميائية والمنتجات الكيميائية,صغيرة,26,110,67,43,348,347,1
2022,2,منطقة عسير,صُنع المواد الكيميائية والمنتجات الكيميائية,كبيرة,1,644,529,115,1383,1380,3
2022,2,منطقة عسير,صُنع المواد الكيميائية والمنتجات الكيميائية,متناهية الصغر,37,9,8,1,78,78,0
2022,2,منطقة عسير,صُنع المواد الكيميائية والمنتجات الكيميائية,متوسطة,3,76,52,24,211,211,0
2022,2,منطقة مكة المكرمة,صُنع المواد الكيميائية والمنتجات الكيميائية,صغيرة,180,751,417,334,2634,2612,22
2022,2,منطقة مكة المكرمة,صُنع المواد الكيميائية والمنتجات الكيميائية,كبيرة,4,861,651,210,2221,2217,4
2022,2,منطقة مكة المكرمة,صُنع المواد الكيميائية والمنتجات الكيميائية,متناهية الصغر,232,112,57,55,447,435,12
2022,2,منطقة مكة المكرمة,صُنع المواد الكيميائية والمنتجات الكيميائية,متوسطة,72,1999,1299,700,5256,5214,42
2022,2,منطقة نجران,صُنع المواد الكيميائية والمنتجات الكيميائية,صغيرة,5,21,16,5,77,77,0
2022,2,منطقة نجران,صُنع المواد الكيميائية والمنتجات الكيميائية,متناهية الصغر,13,2,1,1,25,25,0
2022,2,منطقة نجران,صُنع المواد الكيميائية والمنتجات الكيميائية,متوسطة,1,13,0,13,45,45,0
2022,2,المنطقة الشرقية,صُنع المنسوجات,صغيرة,74,165,83,82,856,842,14
2022,2,المنطقة الشرقية,صُنع المنسوجات,متناهية الصغر,299,58,22,36,634,612,22
2022,2,المنطقة الشرقية,صُنع المنسوجات,متوسطة,6,248,203,45,512,512,0
2022,2,منطقة الباحة,صُنع المنسوجات,صغيرة,4,7,4,3,46,45,1
2022,2,منطقة الباحة,صُنع المنسوجات,متناهية الصغر,19,5,2,3,41,41,0
2022,2,منطقة الجوف,صُنع المنسوجات,صغيرة,5,3,3,0,55,55,0
2022,2,منطقة الجوف,صُنع المنسوجات,متناهية الصغر,45,8,6,2,109,108,1
2022,2,منطقة الحدود الشمالية,صُنع المنسوجات,صغيرة,3,5,3,2,29,29,0
2022,2,منطقة الحدود الشمالية,صُنع المنسوجات,متناهية الصغر,25,4,3,1,52,52,0
2022,2,منطقة الرياض,صُنع المنسوجات,صغيرة,95,215,82,133,1000,995,5
2022,2,منطقة الرياض,صُنع المنسوجات,كبيرة,6,1485,982,503,3688,3663,25
2022,2,منطقة الرياض,صُنع المنسوجات,متناهية الصغر,411,87,39,48,904,899,5
2022,2,منطقة الرياض,صُنع المنسوجات,متوسطة,10,322,213,109,889,887,2
2022,2,منطقة القصيم,صُنع المنسوجات,صغيرة,17,30,28,2,130,130,0
2022,2,منطقة القصيم,صُنع المنسوجات,متناهية الصغر,85,13,4,9,220,220,0
2022,2,منطقة القصيم,صُنع المنسوجات,متوسطة,1,18,8,10,51,51,0
2022,2,منطقة المدينة المنورة,صُنع المنسوجات,صغيرة,29,66,48,18,345,343,2
2022,2,منطقة المدينة المنورة,صُنع المنسوجات,متناهية الصغر,121,26,11,15,266,257,9
2022,2,منطقة المدينة المنورة,صُنع المنسوجات,متوسطة,4,97,56,41,307,307,0
2022,2,منطقة تبوك,صُنع المنسوجات,صغيرة,8,11,3,8,91,91,0
2022,2,منطقة تبوك,صُنع المنسوجات,متناهية الصغر,61,11,8,3,158,155,3
2022,2,منطقة جازان,صُنع المنسوجات,صغيرة,1,3,3,0,12,12,0
2022,2,منطقة جازان,صُنع المنسوجات,متناهية الصغر,25,2,1,1,53,53,0
2022,2,منطقة حائل,صُنع المنسوجات,صغيرة,12,20,15,5,115,115,0
2022,2,منطقة حائل,صُنع المنسوجات,متناهية الصغر,51,6,3,3,135,133,2
2022,2,منطقة عسير,صُنع المنسوجات,صغيرة,8,17,10,7,69,69,0
2022,2,منطقة عسير,صُنع المنسوجات,متناهية الصغر,62,14,11,3,139,134,5
2022,2,منطقة مكة المكرمة,صُنع المنسوجات,صغيرة,58,160,80,80,669,660,9
2022,2,منطقة مكة المكرمة,صُنع المنسوجات,كبيرة,3,311,300,11,1009,1008,1
2022,2,منطقة مكة المكرمة,صُنع المنسوجات,متناهية الصغر,270,56,32,24,606,592,14
2022,2,منطقة مكة المكرمة,صُنع المنسوجات,متوسطة,8,322,245,77,542,540,2
2022,2,منطقة نجران,صُنع المنسوجات,صغيرة,5,6,3,3,68,63,5
2022,2,منطقة نجران,صُنع المنسوجات,متناهية الصغر,48,6,5,1,115,112,3
2022,2,المنطقة الشرقية,صُنع المنتجات الغذائية,صغيرة,280,1035,548,487,3524,3518,6
2022,2,المنطقة الشرقية,صُنع المنتجات الغذائية,كبيرة,12,1251,613,638,4534,4525,9
2022,2,المنطقة الشرقية,صُنع المنتجات الغذائية,متناهية الصغر,742,266,135,131,1503,1499,4
2022,2,المنطقة الشرقية,صُنع المنتجات الغذائية,متوسطة,63,1269,736,533,4576,4553,23
2022,2,منطقة الباحة,صُنع المنتجات الغذائية,صغيرة,19,44,29,15,207,207,0
2022,2,منطقة الباحة,صُنع المنتجات الغذائية,متناهية الصغر,91,24,18,6,189,186,3
2022,2,منطقة الباحة,صُنع المنتجات الغذائية,متوسطة,1,11,5,6,50,50,0
2022,2,منطقة الجوف,صُنع المنتجات الغذائية,صغيرة,35,100,87,13,299,298,1
2022,2,منطقة الجوف,صُنع المنتجات الغذائية,متناهية الصغر,159,35,29,6,332,332,0
2022,2,منطقة الجوف,صُنع المنتجات الغذائية,متوسطة,1,5,2,3,53,53,0
2022,2,منطقة الحدود الشمالية,صُنع المنتجات الغذائية,صغيرة,22,39,23,16,246,246,0
2022,2,منطقة الحدود الشمالية,صُنع المنتجات الغذائية,متناهية الصغر,96,11,7,4,209,209,0
2022,2,منطقة الحدود الشمالية,صُنع المنتجات الغذائية,متوسطة,1,16,12,4,60,60,0
2022,2,منطقة الرياض,صُنع المنتجات الغذائية,صغيرة,559,1925,884,1041,7402,7357,45
2022,2,منطقة الرياض,صُنع المنتجات الغذائية,كبيرة,35,5317,3497,1820,14784,14728,56
2022,2,منطقة الرياض,صُنع المنتجات الغذائية,متناهية الصغر,1661,506,242,264,3458,3426,32
2022,2,منطقة الرياض,صُنع المنتجات الغذائية,متوسطة,125,3307,1883,1424,9050,8995,55
2022,2,منطقة القصيم,صُنع المنتجات الغذائية,صغيرة,122,476,283,193,1624,1617,7
2022,2,منطقة القصيم,صُنع المنتجات الغذائية,كبيرة,8,859,615,244,2868,2733,135
2022,2,منطقة القصيم,صُنع المنتجات الغذائية,متناهية الصغر,346,89,52,37,727,726,1
2022,2,منطقة القصيم,صُنع المنتجات الغذائية,متوسطة,46,1043,609,434,3584,3580,4
2022,2,منطقة المدينة المنورة,صُنع المنتجات الغذائية,صغيرة,119,306,177,129,1388,1377,11
2022,2,منطقة المدينة المنورة,صُنع المنتجات الغذائية,متناهية الصغر,493,142,73,69,1031,1018,13
2022,2,منطقة المدينة المنورة,صُنع المنتجات الغذائية,متوسطة,14,379,253,126,1081,1079,2
2022,2,منطقة تبوك,صُنع المنتجات الغذائية,صغيرة,38,84,37,47,439,436,3
2022,2,منطقة تبوك,صُنع المنتجات الغذائية,كبيرة,1,81,16,65,200,200,0
2022,2,منطقة تبوك,صُنع المنتجات الغذائية,متناهية الصغر,192,41,17,24,375,375,0
2022,2,منطقة تبوك,صُنع المنتجات الغذائية,متوسطة,5,96,32,64,324,324,0
2022,2,منطقة جازان,صُنع المنتجات الغذائية,صغيرة,55,125,71,54,704,698,6
2022,2,منطقة جازان,صُنع المنتجات الغذائية,متناهية الصغر,265,57,38,19,556,554,2
2022,2,منطقة جازان,صُنع المنتجات الغذائية,متوسطة,6,116,38,78,476,476,0
2022,2,منطقة حائل,صُنع المنتجات الغذائية,صغيرة,22,65,35,30,218,217,1
2022,2,منطقة حائل,صُنع المنتجات الغذائية,كبيرة,1,74,35,39,197,196,1
2022,2,منطقة حائل,صُنع المنتجات الغذائية,متناهية الصغر,197,34,11,23,411,408,3
2022,2,منطقة حائل,صُنع المنتجات الغذائية,متوسطة,10,177,36,141,821,818,3
2022,2,منطقة عسير,صُنع المنتجات الغذائية,صغيرة,79,224,118,106,854,854,0
2022,2,منطقة عسير,صُنع المنتجات الغذائية,كبيرة,3,204,118,86,1135,1135,0
2022,2,منطقة عسير,صُنع المنتجات الغذائية,متناهية الصغر,477,101,58,43,861,861,0
2022,2,منطقة عسير,صُنع المنتجات الغذائية,متوسطة,14,416,250,166,1165,1164,1
2022,2,منطقة مكة المكرمة,صُنع المنتجات الغذائية,صغيرة,402,1243,594,649,4984,4941,43
2022,2,منطقة مكة المكرمة,صُنع المنتجات الغذائية,كبيرة,35,6395,3501,2894,18001,17656,345
2022,2,منطقة مكة المكرمة,صُنع المنتجات الغذائية,متناهية الصغر,1384,406,201,205,2850,2828,22
2022,2,منطقة مكة المكرمة,صُنع المنتجات الغذائية,متوسطة,75,2047,1072,975,5487,5404,83
2022,2,منطقة نجران,صُنع المنتجات الغذائية,صغيرة,21,32,12,20,231,231,0
2022,2,منطقة نجران,صُنع المنتجات الغذائية,متناهية الصغر,155,42,26,16,340,338,2
2022,2,المنطقة الشرقية,صنع المنتجات الصيدلانية الأساسية والمستحضرات الصيدلانية,صغيرة,10,48,29,19,164,152,12
2022,2,المنطقة الشرقية,صنع المنتجات الصيدلانية الأساسية والمستحضرات الصيدلانية,متناهية الصغر,8,5,2,3,16,13,3
2022,2,المنطقة الشرقية,صنع المنتجات الصيدلانية الأساسية والمستحضرات الصيدلانية,متوسطة,4,184,137,47,191,189,2
2022,2,منطقة الجوف,صنع المنتجات الصيدلانية الأساسية والمستحضرات الصيدلانية,متناهية الصغر,4,0,0,0,10,10,0
2022,2,منطقة الحدود الشمالية,صنع المنتجات الصيدلانية الأساسية والمستحضرات الصيدلانية,متناهية الصغر,1,1,0,1,0,0,0
2022,2,منطقة الرياض,صنع المنتجات الصيدلانية الأساسية والمستحضرات الصيدلانية,صغيرة,25,202,92,110,329,318,11
2022,2,منطقة الرياض,صنع المنتجات الصيدلانية الأساسية والمستحضرات الصيدلانية,كبيرة,5,552,269,283,1479,1451,28
2022,2,منطقة الرياض,صنع المنتجات الصيدلانية الأساسية والمستحضرات الصيدلانية,متناهية الصغر,127,31,18,13,310,309,1
2022,2,منطقة الرياض,صنع المنتجات الصيدلانية الأساسية والمستحضرات الصيدلانية,متوسطة,5,141,61,80,297,292,5
2022,2,منطقة القصيم,صنع المنتجات الصيدلانية الأساسية والمستحضرات الصيدلانية,صغيرة,2,11,3,8,11,11,0
2022,2,منطقة القصيم,صنع المنتجات الصيدلانية الأساسية والمستحضرات الصيدلانية,كبيرة,1,290,275,15,314,309,5
2022,2,منطقة القصيم,صنع المنتجات الصيدلانية الأساسية والمستحضرات الصيدلانية,متناهية الصغر,9,0,0,0,16,16,0
2022,2,منطقة القصيم,صنع المنتجات الصيدلانية الأساسية والمستحضرات الصيدلانية,متوسطة,1,34,29,5,94,85,9
2022,2,منطقة المدينة المنورة,صنع المنتجات الصيدلانية الأساسية والمستحضرات الصيدلانية,صغيرة,2,10,7,3,38,38,0
2022,2,منطقة المدينة المنورة,صنع المنتجات الصيدلانية الأساسية والمستحضرات الصيدلانية,متناهية الصغر,4,1,0,1,6,6,0
2022,2,منطقة تبوك,صنع المنتجات الصيدلانية الأساسية والمستحضرات الصيدلانية,متناهية الصغر,1,0,0,0,4,4,0
2022,2,منطقة جازان,صنع المنتجات الصيدلانية الأساسية والمستحضرات الصيدلانية,صغيرة,1,1,1,0,5,5,0
2022,2,منطقة جازان,صنع المنتجات الصيدلانية الأساسية والمستحضرات الصيدلانية,متناهية الصغر,5,0,0,0,11,9,2
2022,2,منطقة حائل,صنع المنتجات الصيدلانية الأساسية والمستحضرات الصيدلانية,متناهية الصغر,5,0,0,0,13,13,0
2022,2,منطقة عسير,صنع المنتجات الصيدلانية الأساسية والمستحضرات الصيدلانية,متناهية الصغر,5,2,1,1,18,18,0
2022,2,منطقة عسير,صنع المنتجات الصيدلانية الأساسية والمستحضرات الصيدلانية,متوسطة,1,16,4,12,37,33,4
2022,2,منطقة مكة المكرمة,صنع المنتجات الصيدلانية الأساسية والمستحضرات الصيدلانية,صغيرة,9,32,23,9,91,86,5
2022,2,منطقة مكة المكرمة,صنع المنتجات الصيدلانية الأساسية والمستحضرات الصيدلانية,كبيرة,2,593,316,277,674,655,19
2022,2,منطقة مكة المكرمة,صنع المنتجات الصيدلانية الأساسية والمستحضرات الصيدلانية,متناهية الصغر,14,18,13,5,17,17,0
2022,2,منطقة مكة المكرمة,صنع المنتجات الصيدلانية الأساسية والمستحضرات الصيدلانية,متوسطة,8,424,224,200,539,523,16
2022,2,منطقة نجران,صنع المنتجات الصيدلانية الأساسية والمستحضرات الصيدلانية,صغيرة,1,0,0,0,8,8,0
2022,2,المنطقة الشرقية,صُنع المنتجات الجلدية والمنتجات ذات الصلة,صغيرة,8,14,7,7,104,104,0
2022,2,المنطقة الشرقية,صُنع المنتجات الجلدية والمنتجات ذات الصلة,متناهية الصغر,13,0,0,0,25,25,0
2022,2,المنطقة الشرقية,صُنع المنتجات الجلدية والمنتجات ذات الصلة,متوسطة,2,57,55,2,140,140,0
2022,2,منطقة الباحة,صُنع المنتجات الجلدية والمنتجات ذات الصلة,متناهية الصغر,2,0,0,0,5,5,0
2022,2,منطقة الجوف,صُنع المنتجات الجلدية والمنتجات ذات الصلة,صغيرة,1,1,1,0,5,5,0
2022,2,منطقة الجوف,صُنع المنتجات الجلدية والمنتجات ذات الصلة,متناهية الصغر,1,0,0,0,3,3,0
2022,2,منطقة الحدود الشمالية,صُنع المنتجات الجلدية والمنتجات ذات الصلة,صغيرة,3,1,1,0,23,23,0
2022,2,منطقة الحدود الشمالية,صُنع المنتجات الجلدية والمنتجات ذات الصلة,متناهية الصغر,3,0,0,0,10,10,0
2022,2,منطقة الرياض,صُنع المنتجات الجلدية والمنتجات ذات الصلة,صغيرة,37,36,17,19,384,382,2
2022,2,منطقة الرياض,صُنع المنتجات الجلدية والمنتجات ذات الصلة,كبيرة,2,180,46,134,634,634,0
2022,2,منطقة الرياض,صُنع المنتجات الجلدية والمنتجات ذات الصلة,متناهية الصغر,67,9,6,3,168,168,0
2022,2,منطقة الرياض,صُنع المنتجات الجلدية والمنتجات ذات الصلة,متوسطة,4,92,33,59,261,260,1
2022,2,منطقة القصيم,صُنع المنتجات الجلدية والمنتجات ذات الصلة,متناهية الصغر,6,2,0,2,16,16,0
2022,2,منطقة المدينة المنورة,صُنع المنتجات الجلدية والمنتجات ذات الصلة,صغيرة,2,3,0,3,20,20,0
2022,2,منطقة المدينة المنورة,صُنع المنتجات الجلدية والمنتجات ذات الصلة,متناهية الصغر,8,3,3,0,23,23,0
2022,2,منطقة المدينة المنورة,صُنع المنتجات الجلدية والمنتجات ذات الصلة,متوسطة,1,24,10,14,113,113,0
2022,2,منطقة جازان,صُنع المنتجات الجلدية والمنتجات ذات الصلة,صغيرة,1,0,0,0,6,6,0
2022,2,منطقة جازان,صُنع المنتجات الجلدية والمنتجات ذات الصلة,متناهية الصغر,59,4,3,1,204,204,0
2022,2,منطقة حائل,صُنع المنتجات الجلدية والمنتجات ذات الصلة,صغيرة,1,0,0,0,6,6,0
2022,2,منطقة حائل,صُنع المنتجات الجلدية والمنتجات ذات الصلة,متناهية الصغر,9,2,0,2,22,22,0
2022,2,منطقة عسير,صُنع المنتجات الجلدية والمنتجات ذات الصلة,صغيرة,1,0,0,0,10,10,0
2022,2,منطقة عسير,صُنع المنتجات الجلدية والمنتجات ذات الصلة,متناهية الصغر,13,3,1,2,38,38,0
2022,2,منطقة مكة المكرمة,صُنع المنتجات الجلدية والمنتجات ذات الصلة,صغيرة,5,22,11,11,93,92,1
2022,2,منطقة مكة المكرمة,صُنع المنتجات الجلدية والمنتجات ذات الصلة,متناهية الصغر,30,3,0,3,79,78,1
2022,2,منطقة مكة المكرمة,صُنع المنتجات الجلدية والمنتجات ذات الصلة,متوسطة,2,28,15,13,98,98,0
2022,2,منطقة نجران,صُنع المنتجات الجلدية والمنتجات ذات الصلة,متناهية الصغر,4,3,0,3,5,5,0
2022,2,المنطقة الشرقية,صُنع الملبوسات,صغيرة,242,532,206,326,2450,2233,217
2022,2,المنطقة الشرقية,صُنع الملبوسات,متناهية الصغر,2080,384,164,220,4382,4062,320
2022,2,المنطقة الشرقية,صُنع الملبوسات,متوسطة,12,289,76,213,710,707,3
2022,2,منطقة الباحة,صُنع الملبوسات,صغيرة,14,29,15,14,124,105,19
2022,2,منطقة الباحة,صُنع الملبوسات,متناهية الصغر,154,34,24,10,303,247,56
2022,2,منطقة الجوف,صُنع الملبوسات,صغيرة,18,20,13,7,117,107,10
2022,2,منطقة الجوف,صُنع الملبوسات,متناهية الصغر,277,42,25,17,588,545,43
2022,2,منطقة الحدود الشمالية,صُنع الملبوسات,صغيرة,7,11,2,9,76,52,24
2022,2,منطقة الحدود الشمالية,صُنع الملبوسات,متناهية الصغر,280,37,19,18,681,646,35
2022,2,منطقة الرياض,صُنع الملبوسات,صغيرة,420,954,329,625,4264,3791,473
2022,2,منطقة الرياض,صُنع الملبوسات,كبيرة,7,966,165,801,2095,2034,61
2022,2,منطقة الرياض,صُنع الملبوسات,متناهية الصغر,3588,668,219,449,7663,7083,580
2022,2,منطقة الرياض,صُنع الملبوسات,متوسطة,24,593,189,404,1856,1658,198
2022,2,منطقة القصيم,صُنع الملبوسات,صغيرة,52,71,34,37,440,387,53
2022,2,منطقة القصيم,صُنع الملبوسات,متناهية الصغر,732,114,54,60,1564,1442,122
2022,2,منطقة القصيم,صُنع الملبوسات,متوسطة,5,65,54,11,462,457,5
2022,2,منطقة المدينة المنورة,صُنع الملبوسات,صغيرة,71,100,44,56,596,516,80
2022,2,منطقة المدينة المنورة,صُنع الملبوسات,متناهية الصغر,968,158,69,89,2076,1806,270
2022,2,منطقة المدينة المنورة,صُنع الملبوسات,متوسطة,3,64,37,27,215,211,4
2022,2,منطقة تبوك,صُنع الملبوسات,صغيرة,32,40,14,26,280,264,16
2022,2,منطقة تبوك,صُنع الملبوسات,متناهية الصغر,783,96,54,42,2024,1980,44
2022,2,منطقة تبوك,صُنع الملبوسات,متوسطة,1,0,0,0,87,87,0
2022,2,منطقة جازان,صُنع الملبوسات,صغيرة,25,25,13,12,182,158,24
2022,2,منطقة جازان,صُنع الملبوسات,متناهية الصغر,594,65,41,24,1386,1268,118
2022,2,منطقة حائل,صُنع الملبوسات,صغيرة,26,43,11,32,205,156,49
2022,2,منطقة حائل,صُنع الملبوسات,متناهية الصغر,395,41,21,20,841,774,67
2022,2,منطقة عسير,صُنع الملبوسات,صغيرة,57,81,36,45,521,479,42
2022,2,منطقة عسير,صُنع الملبوسات,متناهية الصغر,938,154,83,71,2028,1812,216
2022,2,منطقة عسير,صُنع الملبوسات,متوسطة,3,43,27,16,191,191,0
2022,2,منطقة مكة المكرمة,صُنع الملبوسات,صغيرة,219,486,177,309,2019,1834,185
2022,2,منطقة مكة المكرمة,صُنع الملبوسات,كبيرة,1,142,38,104,413,413,0
2022,2,منطقة مكة المكرمة,صُنع الملبوسات,متناهية الصغر,2738,488,206,282,5852,5266,586
2022,2,منطقة مكة المكرمة,صُنع الملبوسات,متوسطة,16,404,93,311,1059,965,94
2022,2,منطقة نجران,صُنع الملبوسات,صغيرة,21,19,6,13,181,161,20
2022,2,منطقة نجران,صُنع الملبوسات,متناهية الصغر,413,66,30,36,941,882,59
2022,2,منطقة نجران,صُنع الملبوسات,متوسطة,1,16,2,14,43,43,0
2022,2,المنطقة الشرقية,صنع المعدات الكهربائية,صغيرة,59,291,199,92,816,813,3
2022,2,المنطقة الشرقية,صنع المعدات الكهربائية,كبيرة,6,1781,1731,50,1303,1299,4
2022,2,المنطقة الشرقية,صنع المعدات الكهربائية,متناهية الصغر,155,57,33,24,320,319,1
2022,2,المنطقة الشرقية,صنع المعدات الكهربائية,متوسطة,24,748,558,190,1655,1653,2
2022,2,منطقة الباحة,صنع المعدات الكهربائية,متناهية الصغر,10,0,0,0,17,17,0
2022,2,منطقة الجوف,صنع المعدات الكهربائية,صغيرة,2,0,0,0,14,14,0
2022,2,منطقة الجوف,صنع المعدات الكهربائية,متناهية الصغر,13,1,1,0,29,29,0
2022,2,منطقة الحدود الشمالية,صنع المعدات الكهربائية,صغيرة,1,0,0,0,6,6,0
2022,2,منطقة الحدود الشمالية,صنع المعدات الكهربائية,متناهية الصغر,19,0,0,0,46,46,0
2022,2,منطقة الرياض,صنع المعدات الكهربائية,صغيرة,91,371,205,166,1466,1463,3
2022,2,منطقة الرياض,صنع المعدات الكهربائية,كبيرة,8,765,687,78,1999,1996,3
2022,2,منطقة الرياض,صنع المعدات الكهربائية,متناهية الصغر,170,57,35,22,369,367,2
2022,2,منطقة الرياض,صنع المعدات الكهربائية,متوسطة,51,1433,855,578,4288,4280,8
2022,2,منطقة القصيم,صنع المعدات الكهربائية,صغيرة,11,34,22,12,167,167,0
2022,2,منطقة القصيم,صنع المعدات الكهربائية,متناهية الصغر,26,2,0,2,52,52,0
2022,2,منطقة القصيم,صنع المعدات الكهربائية,متوسطة,1,19,19,0,72,72,0
2022,2,منطقة المدينة المنورة,صنع المعدات الكهربائية,صغيرة,11,42,25,17,152,152,0
2022,2,منطقة المدينة المنورة,صنع المعدات الكهربائية,كبيرة,1,97,90,7,295,295,0
2022,2,منطقة المدينة المنورة,صنع المعدات الكهربائية,متناهية الصغر,39,10,9,1,80,80,0
2022,2,منطقة المدينة المنورة,صنع المعدات الكهربائية,متوسطة,2,68,37,31,254,254,0
2022,2,منطقة تبوك,صنع المعدات الكهربائية,صغيرة,1,0,0,0,6,6,0
2022,2,منطقة تبوك,صنع المعدات الكهربائية,متناهية الصغر,16,0,0,0,36,36,0
2022,2,منطقة جازان,صنع المعدات الكهربائية,صغيرة,1,0,0,0,6,6,0
2022,2,منطقة جازان,صنع المعدات الكهربائية,متناهية الصغر,32,2,1,1,84,84,0
2022,2,منطقة حائل,صنع المعدات الكهربائية,صغيرة,1,0,0,0,6,6,0
2022,2,منطقة حائل,صنع المعدات الكهربائية,متناهية الصغر,13,6,1,5,35,35,0
2022,2,منطقة عسير,صنع المعدات الكهربائية,صغيرة,6,18,10,8,74,74,0
2022,2,منطقة عسير,صنع المعدات الكهربائية,متناهية الصغر,32,4,3,1,69,69,0
2022,2,منطقة مكة المكرمة,صنع المعدات الكهربائية,صغيرة,53,178,108,70,739,735,4
2022,2,منطقة مكة المكرمة,صنع المعدات الكهربائية,كبيرة,3,378,357,21,1266,1265,1
2022,2,منطقة مكة المكرمة,صنع المعدات الكهربائية,متناهية الصغر,147,30,19,11,326,322,4
2022,2,منطقة مكة المكرمة,صنع المعدات الكهربائية,متوسطة,7,155,90,65,510,509,1
2022,2,منطقة نجران,صنع المعدات الكهربائية,صغيرة,2,7,5,2,34,34,0
2022,2,منطقة نجران,صنع المعدات الكهربائية,متناهية الصغر,8,2,0,2,16,16,0
2022,2,المنطقة الشرقية,صُنع المشروبات,صغيرة,20,100,54,46,321,320,1
2022,2,المنطقة الشرقية,صُنع المشروبات,كبيرة,4,593,386,207,1486,1485,1
2022,2,المنطقة الشرقية,صُنع المشروبات,متناهية الصغر,39,13,6,7,85,85,0
2022,2,المنطقة الشرقية,صُنع المشروبات,متوسطة,4,109,44,65,314,312,2
2022,2,منطقة الباحة,صُنع المشروبات,صغيرة,1,18,1,17,4,4,0
2022,2,منطقة الباحة,صُنع المشروبات,متناهية الصغر,4,1,1,0,6,6,0
2022,2,منطقة الباحة,صُنع المشروبات,متوسطة,3,55,25,30,175,171,4
2022,2,منطقة الجوف,صُنع المشروبات,صغيرة,2,4,0,4,12,12,0
2022,2,منطقة الجوف,صُنع المشروبات,متناهية الصغر,7,1,0,1,11,11,0
2022,2,منطقة الجوف,صُنع المشروبات,متوسطة,1,15,9,6,50,50,0
2022,2,منطقة الحدود الشمالية,صُنع المشروبات,صغيرة,1,3,2,1,10,10,0
2022,2,منطقة الرياض,صُنع المشروبات,صغيرة,50,238,97,141,725,721,4
2022,2,منطقة الرياض,صُنع المشروبات,كبيرة,15,2102,1443,659,5289,5280,9
2022,2,منطقة الرياض,صُنع المشروبات,متناهية الصغر,67,21,7,14,151,149,2
2022,2,منطقة الرياض,صُنع المشروبات,متوسطة,27,743,375,368,2028,2024,4
2022,2,منطقة القصيم,صُنع المشروبات,صغيرة,7,13,8,5,95,95,0
2022,2,منطقة القصيم,صُنع المشروبات,كبيرة,2,369,159,210,743,743,0
2022,2,منطقة القصيم,صُنع المشروبات,متناهية الصغر,16,5,2,3,27,27,0
2022,2,منطقة القصيم,صُنع المشروبات,متوسطة,4,126,50,76,357,357,0
2022,2,منطقة المدينة المنورة,صُنع المشروبات,صغيرة,11,45,29,16,187,186,1
2022,2,منطقة المدينة المنورة,صُنع المشروبات,متناهية الصغر,22,10,7,3,42,42,0
2022,2,منطقة المدينة المنورة,صُنع المشروبات,متوسطة,4,115,59,56,360,360,0
2022,2,منطقة تبوك,صُنع المشروبات,صغيرة,3,10,6,4,56,56,0
2022,2,منطقة تبوك,صُنع المشروبات,متناهية الصغر,21,1,0,1,43,43,0
2022,2,منطقة تبوك,صُنع المشروبات,متوسطة,3,110,59,51,205,204,1
2022,2,منطقة جازان,صُنع المشروبات,صغيرة,2,1,1,0,19,19,0
2022,2,منطقة جازان,صُنع المشروبات,كبيرة,2,120,66,54,437,437,0
2022,2,منطقة جازان,صُنع المشروبات,متناهية الصغر,21,3,1,2,48,48,0
2022,2,منطقة جازان,صُنع المشروبات,متوسطة,5,154,95,59,403,403,0
2022,2,منطقة حائل,صُنع المشروبات,صغيرة,4,18,12,6,65,65,0
2022,2,منطقة حائل,صُنع المشروبات,كبيرة,1,70,38,32,183,183,0
2022,2,منطقة حائل,صُنع المشروبات,متناهية الصغر,6,2,2,0,16,16,0
2022,2,منطقة حائل,صُنع المشروبات,متوسطة,1,13,4,9,42,41,1
2022,2,منطقة عسير,صُنع المشروبات,صغيرة,10,37,28,9,178,178,0
2022,2,منطقة عسير,صُنع المشروبات,كبيرة,1,136,126,10,309,309,0
2022,2,منطقة عسير,صُنع المشروبات,متناهية الصغر,25,5,1,4,58,58,0
2022,2,منطقة عسير,صُنع المشروبات,متوسطة,1,32,24,8,67,67,0
2022,2,منطقة مكة المكرمة,صُنع المشروبات,صغيرة,47,210,99,111,680,680,0
2022,2,منطقة مكة المكرمة,صُنع المشروبات,كبيرة,4,951,779,172,1776,1770,6
2022,2,منطقة مكة المكرمة,صُنع المشروبات,متناهية الصغر,104,29,19,10,203,200,3
2022,2,منطقة مكة المكرمة,صُنع المشروبات,متوسطة,17,628,386,242,1811,1808,3
2022,2,منطقة نجران,صُنع المشروبات,صغيرة,3,22,8,14,56,55,1
2022,2,منطقة نجران,صُنع المشروبات,متناهية الصغر,6,3,1,2,12,12,0
2022,2,منطقة نجران,صُنع المشروبات,متوسطة,1,86,67,19,126,126,0
2022,2,المنطقة الشرقية,صنع الفلزات القاعدية,صغيرة,102,526,375,151,1569,1566,3
2022,2,المنطقة الشرقية,صنع الفلزات القاعدية,كبيرة,13,2355,2252,103,3757,3757,0
2022,2,المنطقة الشرقية,صنع الفلزات القاعدية,متناهية الصغر,130,55,43,12,254,254,0
2022,2,المنطقة الشرقية,صنع الفلزات القاعدية,متوسطة,59,1914,1460,454,5081,5080,1
2022,2,منطقة الباحة,صنع الفلزات القاعدية,متناهية الصغر,12,1,1,0,28,28,0
2022,2,منطقة الجوف,صنع الفلزات القاعدية,صغيرة,2,1,1,0,12,12,0
2022,2,منطقة الجوف,صنع الفلزات القاعدية,متناهية الصغر,16,0,0,0,39,39,0
2022,2,منطقة الحدود الشمالية,صنع الفلزات القاعدية,صغيرة,2,2,1,1,13,13,0
2022,2,منطقة الحدود الشمالية,صنع الفلزات القاعدية,متناهية الصغر,12,1,1,0,34,34,0
2022,2,منطقة الرياض,صنع الفلزات القاعدية,صغيرة,193,627,332,295,2829,2818,11
2022,2,منطقة الرياض,صنع الفلزات القاعدية,كبيرة,8,721,506,215,2769,2765,4
2022,2,منطقة الرياض,صنع الفلزات القاعدية,متناهية الصغر,388,96,44,52,840,835,5
2022,2,منطقة الرياض,صنع الفلزات القاعدية,متوسطة,53,1295,787,508,4126,4103,23
2022,2,منطقة القصيم,صنع الفلزات القاعدية,صغيرة,17,44,28,16,287,286,1
2022,2,منطقة القصيم,صنع الفلزات القاعدية,متناهية الصغر,85,12,7,5,199,198,1
2022,2,منطقة القصيم,صنع الفلزات القاعدية,متوسطة,3,32,23,9,195,195,0
2022,2,منطقة المدينة المنورة,صنع الفلزات القاعدية,صغيرة,11,32,26,6,131,130,1
2022,2,منطقة المدينة المنورة,صنع الفلزات القاعدية,متناهية الصغر,69,7,4,3,142,142,0
2022,2,منطقة المدينة المنورة,صنع الفلزات القاعدية,متوسطة,2,189,176,13,183,183,0
2022,2,منطقة تبوك,صنع الفلزات القاعدية,صغيرة,3,13,2,11,25,25,0
2022,2,منطقة تبوك,صنع الفلزات القاعدية,متناهية الصغر,19,3,3,0,37,37,0
2022,2,منطقة تبوك,صنع الفلزات القاعدية,متوسطة,1,31,17,14,97,97,0
2022,2,منطقة جازان,صنع الفلزات القاعدية,صغيرة,2,8,3,5,23,23,0
2022,2,منطقة جازان,صنع الفلزات القاعدية,كبيرة,1,152,152,0,114,114,0
2022,2,منطقة جازان,صنع الفلزات القاعدية,متناهية الصغر,44,4,2,2,101,101,0
2022,2,منطقة جازان,صنع الفلزات القاعدية,متوسطة,2,104,92,12,237,237,0
2022,2,منطقة حائل,صنع الفلزات القاعدية,صغيرة,5,4,3,1,36,36,0
2022,2,منطقة حائل,صنع الفلزات القاعدية,متناهية الصغر,52,6,5,1,111,111,0
2022,2,منطقة حائل,صنع الفلزات القاعدية,متوسطة,2,24,12,12,103,103,0
2022,2,منطقة عسير,صنع الفلزات القاعدية,صغيرة,19,65,54,11,247,247,0
2022,2,منطقة عسير,صنع الفلزات القاعدية,متناهية الصغر,78,12,7,5,166,166,0
2022,2,منطقة عسير,صنع الفلزات القاعدية,متوسطة,1,31,30,1,108,108,0
2022,2,منطقة مكة المكرمة,صنع الفلزات القاعدية,صغيرة,90,319,171,148,1302,1301,1
2022,2,منطقة مكة المكرمة,صنع الفلزات القاعدية,كبيرة,10,1100,719,381,2506,2505,1
2022,2,منطقة مكة المكرمة,صنع الفلزات القاعدية,متناهية الصغر,189,76,42,34,391,387,4
2022,2,منطقة مكة المكرمة,صنع الفلزات القاعدية,متوسطة,29,838,661,177,2338,2322,16
2022,2,منطقة نجران,صنع الفلزات القاعدية,صغيرة,4,2,2,0,29,29,0
2022,2,منطقة نجران,صنع الفلزات القاعدية,كبيرة,1,194,192,2,344,343,1
2022,2,منطقة نجران,صنع الفلزات القاعدية,متناهية الصغر,55,4,2,2,138,138,0
2022,2,منطقة نجران,صنع الفلزات القاعدية,متوسطة,1,30,17,13,77,77,0
2022,2,المنطقة الشرقية,صُنع الخشب ومنتجات الخشب والفلين ، باستثناء الأثاث ، صُنع أصناف من القش ومواد الضفر,صغيرة,155,372,194,178,1708,1702,6
2022,2,المنطقة الشرقية,صُنع الخشب ومنتجات الخشب والفلين ، باستثناء الأثاث ، صُنع أصناف من القش ومواد الضفر,كبيرة,1,59,59,0,198,198,0
2022,2,المنطقة الشرقية,صُنع الخشب ومنتجات الخشب والفلين ، باستثناء الأثاث ، صُنع أصناف من القش ومواد الضفر,متناهية الصغر,407,143,63,80,876,876,0
2022,2,المنطقة الشرقية,صُنع الخشب ومنتجات الخشب والفلين ، باستثناء الأثاث ، صُنع أصناف من القش ومواد الضفر,متوسطة,15,361,245,116,1235,1233,2
2022,2,منطقة الباحة,صُنع الخشب ومنتجات الخشب والفلين ، باستثناء الأثاث ، صُنع أصناف من القش ومواد الضفر,صغيرة,11,14,12,2,77,77,0
2022,2,منطقة الباحة,صُنع الخشب ومنتجات الخشب والفلين ، باستثناء الأثاث ، صُنع أصناف من القش ومواد الضفر,متناهية الصغر,71,20,11,9,153,152,1
2022,2,منطقة الجوف,صُنع الخشب ومنتجات الخشب والفلين ، باستثناء الأثاث ، صُنع أصناف من القش ومواد الضفر,صغيرة,8,8,6,2,58,58,0
2022,2,منطقة الجوف,صُنع الخشب ومنتجات الخشب والفلين ، باستثناء الأثاث ، صُنع أصناف من القش ومواد الضفر,متناهية الصغر,70,9,6,3,143,143,0
2022,2,منطقة الحدود الشمالية,صُنع الخشب ومنتجات الخشب والفلين ، باستثناء الأثاث ، صُنع أصناف من القش ومواد الضفر,صغيرة,3,4,3,1,15,15,0
2022,2,منطقة الحدود الشمالية,صُنع الخشب ومنتجات الخشب والفلين ، باستثناء الأثاث ، صُنع أصناف من القش ومواد الضفر,متناهية الصغر,46,7,3,4,98,98,0
2022,2,منطقة الرياض,صُنع الخشب ومنتجات الخشب والفلين ، باستثناء الأثاث ، صُنع أصناف من القش ومواد الضفر,صغيرة,269,643,256,387,3159,3143,16
2022,2,منطقة الرياض,صُنع الخشب ومنتجات الخشب والفلين ، باستثناء الأثاث ، صُنع أصناف من القش ومواد الضفر,متناهية الصغر,809,254,112,142,1833,1826,7
2022,2,منطقة الرياض,صُنع الخشب ومنتجات الخشب والفلين ، باستثناء الأثاث ، صُنع أصناف من القش ومواد الضفر,متوسطة,24,589,229,360,1910,1838,72
2022,2,منطقة القصيم,صُنع الخشب ومنتجات الخشب والفلين ، باستثناء الأثاث ، صُنع أصناف من القش ومواد الضفر,صغيرة,30,57,30,27,359,355,4
2022,2,منطقة القصيم,صُنع الخشب ومنتجات الخشب والفلين ، باستثناء الأثاث ، صُنع أصناف من القش ومواد الضفر,كبيرة,1,63,44,19,199,199,0
2022,2,منطقة القصيم,صُنع الخشب ومنتجات الخشب والفلين ، باستثناء الأثاث ، صُنع أصناف من القش ومواد الضفر,متناهية الصغر,234,55,25,30,578,574,4
2022,2,منطقة المدينة المنورة,صُنع الخشب ومنتجات الخشب والفلين ، باستثناء الأثاث ، صُنع أصناف من القش ومواد الضفر,صغيرة,26,38,22,16,195,195,0
2022,2,منطقة المدينة المنورة,صُنع الخشب ومنتجات الخشب والفلين ، باستثناء الأثاث ، صُنع أصناف من القش ومواد الضفر,متناهية الصغر,144,41,23,18,334,334,0
2022,2,منطقة المدينة المنورة,صُنع الخشب ومنتجات الخشب والفلين ، باستثناء الأثاث ، صُنع أصناف من القش ومواد الضفر,متوسطة,2,21,16,5,84,84,0
2022,2,منطقة تبوك,صُنع الخشب ومنتجات الخشب والفلين ، باستثناء الأثاث ، صُنع أصناف من القش ومواد الضفر,صغيرة,14,15,9,6,82,82,0
2022,2,منطقة تبوك,صُنع الخشب ومنتجات الخشب والفلين ، باستثناء الأثاث ، صُنع أصناف من القش ومواد الضفر,متناهية الصغر,76,8,2,6,177,177,0
2022,2,منطقة جازان,صُنع الخشب ومنتجات الخشب والفلين ، باستثناء الأثاث ، صُنع أصناف من القش ومواد الضفر,صغيرة,17,28,14,14,136,135,1
2022,2,منطقة جازان,صُنع الخشب ومنتجات الخشب والفلين ، باستثناء الأثاث ، صُنع أصناف من القش ومواد الضفر,متناهية الصغر,177,34,22,12,431,431,0
2022,2,منطقة جازان,صُنع الخشب ومنتجات الخشب والفلين ، باستثناء الأثاث ، صُنع أصناف من القش ومواد الضفر,متوسطة,1,21,2,19,68,68,0
2022,2,منطقة حائل,صُنع الخشب ومنتجات الخشب والفلين ، باستثناء الأثاث ، صُنع أصناف من القش ومواد الضفر,صغيرة,10,27,9,18,126,126,0
2022,2,منطقة حائل,صُنع الخشب ومنتجات الخشب والفلين ، باستثناء الأثاث ، صُنع أصناف من القش ومواد الضفر,متناهية الصغر,53,15,8,7,117,117,0
2022,2,منطقة عسير,صُنع الخشب ومنتجات الخشب والفلين ، باستثناء الأثاث ، صُنع أصناف من القش ومواد الضفر,صغيرة,42,69,49,20,386,386,0
2022,2,منطقة عسير,صُنع الخشب ومنتجات الخشب والفلين ، باستثناء الأثاث ، صُنع أصناف من القش ومواد الضفر,متناهية الصغر,264,69,35,34,615,614,1
2022,2,منطقة عسير,صُنع الخشب ومنتجات الخشب والفلين ، باستثناء الأثاث ، صُنع أصناف من القش ومواد الضفر,متوسطة,1,11,5,6,47,47,0
2022,2,منطقة مكة المكرمة,صُنع الخشب ومنتجات الخشب والفلين ، باستثناء الأثاث ، صُنع أصناف من القش ومواد الضفر,صغيرة,109,247,102,145,1144,1142,2
2022,2,منطقة مكة المكرمة,صُنع الخشب ومنتجات الخشب والفلين ، باستثناء الأثاث ، صُنع أصناف من القش ومواد الضفر,كبيرة,2,228,197,31,764,764,0
2022,2,منطقة مكة المكرمة,صُنع الخشب ومنتجات الخشب والفلين ، باستثناء الأثاث ، صُنع أصناف من القش ومواد الضفر,متناهية الصغر,628,134,74,60,1428,1419,9
2022,2,منطقة مكة المكرمة,صُنع الخشب ومنتجات الخشب والفلين ، باستثناء الأثاث ، صُنع أصناف من القش ومواد الضفر,متوسطة,13,271,162,109,970,962,8
2022,2,منطقة نجران,صُنع الخشب ومنتجات الخشب والفلين ، باستثناء الأثاث ، صُنع أصناف من القش ومواد الضفر,صغيرة,5,5,3,2,35,35,0
2022,2,منطقة نجران,صُنع الخشب ومنتجات الخشب والفلين ، باستثناء الأثاث ، صُنع أصناف من القش ومواد الضفر,متناهية الصغر,80,8,3,5,178,178,0
2022,2,المنطقة الشرقية,صنع الحواسيب والمنتجات الإلكترونية والبصرية,صغيرة,23,120,87,33,239,239,0
2022,2,المنطقة الشرقية,صنع الحواسيب والمنتجات الإلكترونية والبصرية,متناهية الصغر,73,34,24,10,140,137,3
2022,2,المنطقة الشرقية,صنع الحواسيب والمنتجات الإلكترونية والبصرية,متوسطة,4,120,92,28,277,276,1
2022,2,منطقة الباحة,صنع الحواسيب والمنتجات الإلكترونية والبصرية,صغيرة,1,3,3,0,4,4,0
2022,2,منطقة الباحة,صنع الحواسيب والمنتجات الإلكترونية والبصرية,متناهية الصغر,8,7,7,0,16,16,0
2022,2,منطقة الجوف,صنع الحواسيب والمنتجات الإلكترونية والبصرية,متناهية الصغر,4,1,0,1,13,13,0
2022,2,منطقة الحدود الشمالية,صنع الحواسيب والمنتجات الإلكترونية والبصرية,متناهية الصغر,5,0,0,0,9,9,0
2022,2,منطقة الرياض,صنع الحواسيب والمنتجات الإلكترونية والبصرية,صغيرة,24,89,55,34,333,333,0
2022,2,منطقة الرياض,صنع الحواسيب والمنتجات الإلكترونية والبصرية,متناهية الصغر,78,25,15,10,144,144,0
2022,2,منطقة الرياض,صنع الحواسيب والمنتجات الإلكترونية والبصرية,متوسطة,2,11,3,8,90,86,4
2022,2,منطقة القصيم,صنع الحواسيب والمنتجات الإلكترونية والبصرية,متناهية الصغر,12,3,3,0,22,22,0
2022,2,منطقة المدينة المنورة,صنع الحواسيب والمنتجات الإلكترونية والبصرية,صغيرة,4,8,5,3,37,37,0
2022,2,منطقة المدينة المنورة,صنع الحواسيب والمنتجات الإلكترونية والبصرية,متناهية الصغر,22,5,3,2,50,50,0
2022,2,منطقة تبوك,صنع الحواسيب والمنتجات الإلكترونية والبصرية,صغيرة,3,9,4,5,13,13,0
2022,2,منطقة تبوك,صنع الحواسيب والمنتجات الإلكترونية والبصرية,متناهية الصغر,15,1,0,1,28,28,0
2022,2,منطقة جازان,صنع الحواسيب والمنتجات الإلكترونية والبصرية,صغيرة,4,6,5,1,45,45,0
2022,2,منطقة جازان,صنع الحواسيب والمنتجات الإلكترونية والبصرية,متناهية الصغر,29,2,2,0,75,75,0
2022,2,منطقة حائل,صنع الحواسيب والمنتجات الإلكترونية والبصرية,صغيرة,1,1,0,1,7,7,0
2022,2,منطقة حائل,صنع الحواسيب والمنتجات الإلكترونية والبصرية,متناهية الصغر,14,0,0,0,35,33,2
2022,2,منطقة عسير,صنع الحواسيب والمنتجات الإلكترونية والبصرية,صغيرة,4,4,3,1,24,24,0
2022,2,منطقة عسير,صنع الحواسيب والمنتجات الإلكترونية والبصرية,متناهية الصغر,53,3,3,0,105,105,0
2022,2,منطقة مكة المكرمة,صنع الحواسيب والمنتجات الإلكترونية والبصرية,صغيرة,26,63,44,19,220,205,15
2022,2,منطقة مكة المكرمة,صنع الحواسيب والمنتجات الإلكترونية والبصرية,متناهية الصغر,160,49,30,19,307,306,1
2022,2,منطقة مكة المكرمة,صنع الحواسيب والمنتجات الإلكترونية والبصرية,متوسطة,2,58,43,15,75,72,3
2022,2,منطقة نجران,صنع الحواسيب والمنتجات الإلكترونية والبصرية,متناهية الصغر,9,2,0,2,21,21,0
2022,2,المنطقة الشرقية,صنع الأثاث,صغيرة,156,439,232,207,1924,1916,8
2022,2,المنطقة الشرقية,صنع الأثاث,كبيرة,3,236,147,89,798,796,2
2022,2,المنطقة الشرقية,صنع الأثاث,متناهية الصغر,533,143,68,75,1179,1178,1
2022,2,المنطقة الشرقية,صنع الأثاث,متوسطة,26,548,361,187,2093,2091,2
2022,2,منطقة الباحة,صنع الأثاث,صغيرة,9,15,13,2,66,66,0
2022,2,منطقة الباحة,صنع الأثاث,متناهية الصغر,75,14,8,6,163,163,0
2022,2,منطقة الجوف,صنع الأثاث,صغيرة,10,17,11,6,81,80,1
2022,2,منطقة الجوف,صنع الأثاث,متناهية الصغر,112,19,10,9,244,243,1
2022,2,منطقة الحدود الشمالية,صنع الأثاث,صغيرة,5,5,5,0,31,31,0
2022,2,منطقة الحدود الشمالية,صنع الأثاث,متناهية الصغر,82,19,10,9,216,216,0
2022,2,منطقة الرياض,صنع الأثاث,صغيرة,463,999,413,586,5831,5803,28
2022,2,منطقة الرياض,صنع الأثاث,كبيرة,11,800,395,405,3257,3250,7
2022,2,منطقة الرياض,صنع الأثاث,متناهية الصغر,1269,287,141,146,3018,3008,10
2022,2,منطقة الرياض,صنع الأثاث,متوسطة,67,1296,598,698,4970,4949,21
2022,2,منطقة القصيم,صنع الأثاث,صغيرة,49,103,60,43,701,698,3
2022,2,منطقة القصيم,صنع الأثاث,كبيرة,1,73,23,50,334,334,0
2022,2,منطقة القصيم,صنع الأثاث,متناهية الصغر,222,52,34,18,515,512,3
2022,2,منطقة القصيم,صنع الأثاث,متوسطة,7,109,78,31,475,475,0
2022,2,منطقة المدينة المنورة,صنع الأثاث,صغيرة,35,48,28,20,341,340,1
2022,2,منطقة المدينة المنورة,صنع الأثاث,متناهية الصغر,238,54,34,20,527,524,3
2022,2,منطقة المدينة المنورة,صنع الأثاث,متوسطة,1,14,10,4,67,67,0
2022,2,منطقة تبوك,صنع الأثاث,صغيرة,18,21,6,15,168,168,0
2022,2,منطقة تبوك,صنع الأثاث,متناهية الصغر,186,29,16,13,466,466,0
2022,2,منطقة جازان,صنع الأثاث,صغيرة,16,17,10,7,145,145,0
2022,2,منطقة جازان,صنع الأثاث,متناهية الصغر,313,43,20,23,822,820,2
2022,2,منطقة حائل,صنع الأثاث,صغيرة,22,26,17,9,205,204,1
2022,2,منطقة حائل,صنع الأثاث,متناهية الصغر,150,25,15,10,359,359,0
2022,2,منطقة حائل,صنع الأثاث,متوسطة,1,19,14,5,69,69,0
2022,2,منطقة عسير,صنع الأثاث,صغيرة,69,109,78,31,688,685,3
2022,2,منطقة عسير,صنع الأثاث,متناهية الصغر,469,95,58,37,1080,1080,0
2022,2,منطقة عسير,صنع الأثاث,متوسطة,1,14,8,6,40,40,0
2022,2,منطقة مكة المكرمة,صنع الأثاث,صغيرة,136,268,139,129,1528,1509,19
2022,2,منطقة مكة المكرمة,صنع الأثاث,كبيرة,1,79,56,23,280,279,1
2022,2,منطقة مكة المكرمة,صنع الأثاث,متناهية الصغر,667,143,76,67,1518,1508,10
2022,2,منطقة مكة المكرمة,صنع الأثاث,متوسطة,21,561,254,307,2029,2024,5
2022,2,منطقة نجران,صنع الأثاث,صغيرة,25,24,7,17,242,242,0
2022,2,منطقة نجران,صنع الأثاث,متناهية الصغر,106,22,7,15,258,258,0
2022,2,منطقة نجران,صنع الأثاث,متوسطة,2,12,10,2,164,164,0
2022,2,المنطقة الشرقية,صناعة معدات النقل الأخرى,صغيرة,8,43,27,16,120,120,0
2022,2,المنطقة الشرقية,صناعة معدات النقل الأخرى,كبيرة,2,2164,2131,33,755,754,1
2022,2,المنطقة الشرقية,صناعة معدات النقل الأخرى,متناهية الصغر,13,7,6,1,22,22,0
2022,2,المنطقة الشرقية,صناعة معدات النقل الأخرى,متوسطة,2,137,132,5,274,274,0
2022,2,منطقة الباحة,صناعة معدات النقل الأخرى,متناهية الصغر,1,0,0,0,1,1,0
2022,2,منطقة الجوف,صناعة معدات النقل الأخرى,صغيرة,1,0,0,0,40,40,0
2022,2,منطقة الجوف,صناعة معدات النقل الأخرى,متناهية الصغر,2,0,0,0,6,6,0
2022,2,منطقة الحدود الشمالية,صناعة معدات النقل الأخرى,متناهية الصغر,2,0,0,0,6,6,0
2022,2,منطقة الرياض,صناعة معدات النقل الأخرى,صغيرة,17,77,59,18,197,196,1
2022,2,منطقة الرياض,صناعة معدات النقل الأخرى,كبيرة,1,1313,1286,27,639,639,0
2022,2,منطقة الرياض,صناعة معدات النقل الأخرى,متناهية الصغر,75,29,16,13,178,178,0
2022,2,منطقة الرياض,صناعة معدات النقل الأخرى,متوسطة,6,451,372,79,486,486,0
2022,2,منطقة القصيم,صناعة معدات النقل الأخرى,متناهية الصغر,4,0,0,0,6,5,1
2022,2,منطقة المدينة المنورة,صناعة معدات النقل الأخرى,صغيرة,1,0,0,0,12,12,0
2022,2,منطقة المدينة المنورة,صناعة معدات النقل الأخرى,متناهية الصغر,6,1,0,1,9,9,0
2022,2,منطقة تبوك,صناعة معدات النقل الأخرى,صغيرة,1,1,0,1,5,5,0
2022,2,منطقة جازان,صناعة معدات النقل الأخرى,صغيرة,2,6,5,1,28,28,0
2022,2,منطقة جازان,صناعة معدات النقل الأخرى,متناهية الصغر,6,0,0,0,16,16,0
2022,2,منطقة حائل,صناعة معدات النقل الأخرى,متناهية الصغر,1,0,0,0,3,3,0
2022,2,منطقة عسير,صناعة معدات النقل الأخرى,صغيرة,1,0,0,0,10,10,0
2022,2,منطقة عسير,صناعة معدات النقل الأخرى,متناهية الصغر,4,0,0,0,10,10,0
2022,2,منطقة مكة المكرمة,صناعة معدات النقل الأخرى,صغيرة,6,14,8,6,67,66,1
2022,2,منطقة مكة المكرمة,صناعة معدات النقل الأخرى,متناهية الصغر,33,10,6,4,62,61,1
2022,2,منطقة مكة المكرمة,صناعة معدات النقل الأخرى,متوسطة,2,32,26,6,92,92,0
2022,2,منطقة نجران,صناعة معدات النقل الأخرى,صغيرة,2,1,0,1,17,17,0
2022,2,منطقة نجران,صناعة معدات النقل الأخرى,متناهية الصغر,5,0,0,0,11,9,2
2022,2,المنطقة الشرقية,صناعة المركبات ذات المحركات والمركبات المقطورة ونصف المقطورة,صغيرة,23,137,91,46,362,362,0
2022,2,المنطقة الشرقية,صناعة المركبات ذات المحركات والمركبات المقطورة ونصف المقطورة,كبيرة,2,334,331,3,462,462,0
2022,2,المنطقة الشرقية,صناعة المركبات ذات المحركات والمركبات المقطورة ونصف المقطورة,متناهية الصغر,38,6,2,4,87,87,0
2022,2,المنطقة الشرقية,صناعة المركبات ذات المحركات والمركبات المقطورة ونصف المقطورة,متوسطة,12,417,349,68,940,939,1
2022,2,منطقة الجوف,صناعة المركبات ذات المحركات والمركبات المقطورة ونصف المقطورة,صغيرة,1,2,2,0,8,8,0
2022,2,منطقة الجوف,صناعة المركبات ذات المحركات والمركبات المقطورة ونصف المقطورة,متناهية الصغر,9,1,1,0,17,17,0
2022,2,منطقة الحدود الشمالية,صناعة المركبات ذات المحركات والمركبات المقطورة ونصف المقطورة,متناهية الصغر,1,0,0,0,2,2,0
2022,2,منطقة الرياض,صناعة المركبات ذات المحركات والمركبات المقطورة ونصف المقطورة,صغيرة,31,131,70,61,531,531,0
2022,2,منطقة الرياض,صناعة المركبات ذات المحركات والمركبات المقطورة ونصف المقطورة,كبيرة,2,92,37,55,1629,1622,7
2022,2,منطقة الرياض,صناعة المركبات ذات المحركات والمركبات المقطورة ونصف المقطورة,متناهية الصغر,61,19,10,9,126,125,1
2022,2,منطقة الرياض,صناعة المركبات ذات المحركات والمركبات المقطورة ونصف المقطورة,متوسطة,11,168,83,85,625,617,8
2022,2,منطقة القصيم,صناعة المركبات ذات المحركات والمركبات المقطورة ونصف المقطورة,صغيرة,4,10,6,4,48,48,0
2022,2,منطقة القصيم,صناعة المركبات ذات المحركات والمركبات المقطورة ونصف المقطورة,كبيرة,1,104,85,19,262,262,0
2022,2,منطقة القصيم,صناعة المركبات ذات المحركات والمركبات المقطورة ونصف المقطورة,متناهية الصغر,14,8,3,5,19,19,0
2022,2,منطقة المدينة المنورة,صناعة المركبات ذات المحركات والمركبات المقطورة ونصف المقطورة,صغيرة,1,3,3,0,16,16,0
2022,2,منطقة المدينة المنورة,صناعة المركبات ذات المحركات والمركبات المقطورة ونصف المقطورة,متناهية الصغر,13,1,1,0,27,27,0
2022,2,منطقة تبوك,صناعة المركبات ذات المحركات والمركبات المقطورة ونصف المقطورة,متناهية الصغر,6,1,1,0,19,19,0
2022,2,منطقة تبوك,صناعة المركبات ذات المحركات والمركبات المقطورة ونصف المقطورة,متوسطة,1,41,21,20,179,179,0
2022,2,منطقة جازان,صناعة المركبات ذات المحركات والمركبات المقطورة ونصف المقطورة,صغيرة,1,10,2,8,22,22,0
2022,2,منطقة جازان,صناعة المركبات ذات المحركات والمركبات المقطورة ونصف المقطورة,متناهية الصغر,18,1,1,0,51,51,0
2022,2,منطقة حائل,صناعة المركبات ذات المحركات والمركبات المقطورة ونصف المقطورة,صغيرة,1,0,0,0,14,14,0
2022,2,منطقة حائل,صناعة المركبات ذات المحركات والمركبات المقطورة ونصف المقطورة,متناهية الصغر,9,2,2,0,23,23,0
2022,2,منطقة عسير,صناعة المركبات ذات المحركات والمركبات المقطورة ونصف المقطورة,صغيرة,1,2,1,1,7,7,0
2022,2,منطقة عسير,صناعة المركبات ذات المحركات والمركبات المقطورة ونصف المقطورة,متناهية الصغر,12,4,4,0,27,27,0
2022,2,منطقة مكة المكرمة,صناعة المركبات ذات المحركات والمركبات المقطورة ونصف المقطورة,صغيرة,11,46,37,9,140,140,0
2022,2,منطقة مكة المكرمة,صناعة المركبات ذات المحركات والمركبات المقطورة ونصف المقطورة,متناهية الصغر,39,7,4,3,100,100,0
2022,2,منطقة مكة المكرمة,صناعة المركبات ذات المحركات والمركبات المقطورة ونصف المقطورة,متوسطة,10,379,253,126,886,886,0
2022,2,منطقة نجران,صناعة المركبات ذات المحركات والمركبات المقطورة ونصف المقطورة,صغيرة,1,0,0,0,7,7,0
2022,2,منطقة نجران,صناعة المركبات ذات المحركات والمركبات المقطورة ونصف المقطورة,متناهية الصغر,10,1,0,1,25,25,0
2022,2,المنطقة الشرقية,صناعة الآلات والمعدات غير المصنفة في موضع أخر,صغيرة,67,481,396,85,908,906,2
2022,2,المنطقة الشرقية,صناعة الآلات والمعدات غير المصنفة في موضع أخر,كبيرة,7,1484,1383,101,1993,1991,2
2022,2,المنطقة الشرقية,صناعة الآلات والمعدات غير المصنفة في موضع أخر,متناهية الصغر,71,47,35,12,127,125,2
2022,2,المنطقة الشرقية,صناعة الآلات والمعدات غير المصنفة في موضع أخر,متوسطة,32,1422,1231,191,2269,2263,6
2022,2,منطقة الباحة,صناعة الآلات والمعدات غير المصنفة في موضع أخر,متناهية الصغر,3,3,2,1,8,8,0
2022,2,منطقة الجوف,صناعة الآلات والمعدات غير المصنفة في موضع أخر,متناهية الصغر,3,0,0,0,3,3,0
2022,2,منطقة الحدود الشمالية,صناعة الآلات والمعدات غير المصنفة في موضع أخر,متناهية الصغر,4,0,0,0,12,12,0
2022,2,منطقة الرياض,صناعة الآلات والمعدات غير المصنفة في موضع أخر,صغيرة,85,289,169,120,1325,1321,4
2022,2,منطقة الرياض,صناعة الآلات والمعدات غير المصنفة في موضع أخر,كبيرة,3,148,80,68,738,737,1
2022,2,منطقة الرياض,صناعة الآلات والمعدات غير المصنفة في موضع أخر,متناهية الصغر,268,63,29,34,598,596,2
2022,2,منطقة الرياض,صناعة الآلات والمعدات غير المصنفة في موضع أخر,متوسطة,21,727,437,290,2100,2094,6
2022,2,منطقة القصيم,صناعة الآلات والمعدات غير المصنفة في موضع أخر,صغيرة,4,3,2,1,21,21,0
2022,2,منطقة القصيم,صناعة الآلات والمعدات غير المصنفة في موضع أخر,متناهية الصغر,34,4,2,2,61,61,0
2022,2,منطقة القصيم,صناعة الآلات والمعدات غير المصنفة في موضع أخر,متوسطة,3,68,34,34,217,217,0
2022,2,منطقة المدينة المنورة,صناعة الآلات والمعدات غير المصنفة في موضع أخر,صغيرة,7,27,22,5,117,117,0
2022,2,منطقة المدينة المنورة,صناعة الآلات والمعدات غير المصنفة في موضع أخر,متناهية الصغر,18,2,0,2,43,43,0
2022,2,منطقة المدينة المنورة,صناعة الآلات والمعدات غير المصنفة في موضع أخر,متوسطة,2,30,24,6,106,106,0
2022,2,منطقة تبوك,صناعة الآلات والمعدات غير المصنفة في موضع أخر,متناهية الصغر,5,0,0,0,16,16,0
2022,2,منطقة جازان,صناعة الآلات والمعدات غير المصنفة في موضع أخر,صغيرة,5,8,6,2,45,45,0
2022,2,منطقة جازان,صناعة الآلات والمعدات غير المصنفة في موضع أخر,متناهية الصغر,21,3,2,1,48,48,0
2022,2,منطقة حائل,صناعة الآلات والمعدات غير المصنفة في موضع أخر,صغيرة,1,19,19,0,0,0,0
2022,2,منطقة حائل,صناعة الآلات والمعدات غير المصنفة في موضع أخر,متناهية الصغر,12,3,1,2,29,29,0
2022,2,منطقة عسير,صناعة الآلات والمعدات غير المصنفة في موضع أخر,صغيرة,3,30,29,1,46,46,0
2022,2,منطقة عسير,صناعة الآلات والمعدات غير المصنفة في موضع أخر,متناهية الصغر,15,5,3,2,37,37,0
2022,2,منطقة عسير,صناعة الآلات والمعدات غير المصنفة في موضع أخر,متوسطة,1,41,41,0,162,162,0
2022,2,منطقة مكة المكرمة,صناعة الآلات والمعدات غير المصنفة في موضع أخر,صغيرة,39,136,69,67,580,579,1
2022,2,منطقة مكة المكرمة,صناعة الآلات والمعدات غير المصنفة في موضع أخر,كبيرة,3,788,781,7,1644,1642,2
2022,2,منطقة مكة المكرمة,صناعة الآلات والمعدات غير المصنفة في موضع أخر,متناهية الصغر,79,29,17,12,157,157,0
2022,2,منطقة مكة المكرمة,صناعة الآلات والمعدات غير المصنفة في موضع أخر,متوسطة,11,310,230,80,880,879,1
2022,2,منطقة نجران,صناعة الآلات والمعدات غير المصنفة في موضع أخر,صغيرة,1,0,0,0,7,7,0
2022,2,منطقة نجران,صناعة الآلات والمعدات غير المصنفة في موضع أخر,متناهية الصغر,9,1,1,0,20,20,0
2022,2,منطقة نجران,صناعة الآلات والمعدات غير المصنفة في موضع أخر,متوسطة,1,0,0,0,118,118,0
2022,2,المنطقة الشرقية,توصيل الكهرباء والغاز والبخار وتكييف الهواء,صغيرة,49,294,208,86,537,536,1
2022,2,المنطقة الشرقية,توصيل الكهرباء والغاز والبخار وتكييف الهواء,كبيرة,1,6347,6342,5,462,462,0
2022,2,المنطقة الشرقية,توصيل الكهرباء والغاز والبخار وتكييف الهواء,متناهية الصغر,56,23,13,10,85,85,0
2022,2,المنطقة الشرقية,توصيل الكهرباء والغاز والبخار وتكييف الهواء,متوسطة,5,208,191,17,194,193,1
2022,2,منطقة الباحة,توصيل الكهرباء والغاز والبخار وتكييف الهواء,متناهية الصغر,2,2,2,0,4,4,0
2022,2,منطقة الجوف,توصيل الكهرباء والغاز والبخار وتكييف الهواء,صغيرة,1,0,0,0,6,6,0
2022,2,منطقة الجوف,توصيل الكهرباء والغاز والبخار وتكييف الهواء,متناهية الصغر,6,1,1,0,9,9,0
2022,2,منطقة الحدود الشمالية,توصيل الكهرباء والغاز والبخار وتكييف الهواء,صغيرة,1,1,0,1,5,5,0
2022,2,منطقة الحدود الشمالية,توصيل الكهرباء والغاز والبخار وتكييف الهواء,متناهية الصغر,2,0,0,0,3,3,0
2022,2,منطقة الرياض,توصيل الكهرباء والغاز والبخار وتكييف الهواء,صغيرة,64,305,179,126,665,664,1
2022,2,منطقة الرياض,توصيل الكهرباء والغاز والبخار وتكييف الهواء,كبيرة,2,11228,10980,248,1574,1572,2
2022,2,منطقة الرياض,توصيل الكهرباء والغاز والبخار وتكييف الهواء,متناهية الصغر,102,62,40,22,175,175,0
2022,2,منطقة الرياض,توصيل الكهرباء والغاز والبخار وتكييف الهواء,متوسطة,7,533,475,58,216,215,1
2022,2,منطقة القصيم,توصيل الكهرباء والغاز والبخار وتكييف الهواء,صغيرة,3,23,20,3,76,76,0
2022,2,منطقة القصيم,توصيل الكهرباء والغاز والبخار وتكييف الهواء,متناهية الصغر,14,3,2,1,37,37,0
2022,2,منطقة المدينة المنورة,توصيل الكهرباء والغاز والبخار وتكييف الهواء,صغيرة,3,33,32,1,25,25,0
2022,2,منطقة المدينة المنورة,توصيل الكهرباء والغاز والبخار وتكييف الهواء,متناهية الصغر,16,7,6,1,41,41,0
2022,2,منطقة تبوك,توصيل الكهرباء والغاز والبخار وتكييف الهواء,صغيرة,3,8,4,4,25,25,0
2022,2,منطقة تبوك,توصيل الكهرباء والغاز والبخار وتكييف الهواء,متناهية الصغر,14,3,2,1,32,32,0
2022,2,منطقة جازان,توصيل الكهرباء والغاز والبخار وتكييف الهواء,صغيرة,5,19,10,9,88,88,0
2022,2,منطقة جازان,توصيل الكهرباء والغاز والبخار وتكييف الهواء,متناهية الصغر,15,5,4,1,29,29,0
2022,2,منطقة حائل,توصيل الكهرباء والغاز والبخار وتكييف الهواء,صغيرة,2,2,0,2,13,13,0
2022,2,منطقة حائل,توصيل الكهرباء والغاز والبخار وتكييف الهواء,متناهية الصغر,9,2,1,1,22,22,0
2022,2,منطقة عسير,توصيل الكهرباء والغاز والبخار وتكييف الهواء,صغيرة,7,43,36,7,42,42,0
2022,2,منطقة عسير,توصيل الكهرباء والغاز والبخار وتكييف الهواء,كبيرة,1,4657,4657,0,264,264,0
2022,2,منطقة عسير,توصيل الكهرباء والغاز والبخار وتكييف الهواء,متناهية الصغر,19,3,3,0,36,36,0
2022,2,منطقة عسير,توصيل الكهرباء والغاز والبخار وتكييف الهواء,متوسطة,2,15,15,0,204,204,0
2022,2,منطقة مكة المكرمة,توصيل الكهرباء والغاز والبخار وتكييف الهواء,صغيرة,34,197,135,62,467,466,1
2022,2,منطقة مكة المكرمة,توصيل الكهرباء والغاز والبخار وتكييف الهواء,كبيرة,1,9445,9443,2,536,536,0
2022,2,منطقة مكة المكرمة,توصيل الكهرباء والغاز والبخار وتكييف الهواء,متناهية الصغر,59,24,14,10,104,104,0
2022,2,منطقة مكة المكرمة,توصيل الكهرباء والغاز والبخار وتكييف الهواء,متوسطة,6,98,44,54,390,389,1
2022,2,منطقة نجران,توصيل الكهرباء والغاز والبخار وتكييف الهواء,صغيرة,2,11,6,5,27,19,8
2022,2,منطقة نجران,توصيل الكهرباء والغاز والبخار وتكييف الهواء,متناهية الصغر,6,1,1,0,13,13,0
2022,2,المنطقة الشرقية,تمويل التأمين وإعادة التأمين وصناديق المعاشات التقاعدية باستثناء الضمان الاجتماعي الإلزامي,صغيرة,3,23,19,4,8,8,0
2022,2,المنطقة الشرقية,تمويل التأمين وإعادة التأمين وصناديق المعاشات التقاعدية باستثناء الضمان الاجتماعي الإلزامي,كبيرة,2,582,419,163,160,151,9
2022,2,المنطقة الشرقية,تمويل التأمين وإعادة التأمين وصناديق المعاشات التقاعدية باستثناء الضمان الاجتماعي الإلزامي,متناهية الصغر,1,3,1,2,1,1,0
2022,2,المنطقة الشرقية,تمويل التأمين وإعادة التأمين وصناديق المعاشات التقاعدية باستثناء الضمان الاجتماعي الإلزامي,متوسطة,2,132,89,43,47,44,3
2022,2,منطقة الجوف,تمويل التأمين وإعادة التأمين وصناديق المعاشات التقاعدية باستثناء الضمان الاجتماعي الإلزامي,متناهية الصغر,1,2,1,1,0,0,0
2022,2,منطقة الرياض,تمويل التأمين وإعادة التأمين وصناديق المعاشات التقاعدية باستثناء الضمان الاجتماعي الإلزامي,صغيرة,4,78,60,18,18,17,1
2022,2,منطقة الرياض,تمويل التأمين وإعادة التأمين وصناديق المعاشات التقاعدية باستثناء الضمان الاجتماعي الإلزامي,كبيرة,5,2297,1369,928,660,628,32
2022,2,منطقة الرياض,تمويل التأمين وإعادة التأمين وصناديق المعاشات التقاعدية باستثناء الضمان الاجتماعي الإلزامي,متناهية الصغر,26,22,9,13,16,16,0
2022,2,منطقة الرياض,تمويل التأمين وإعادة التأمين وصناديق المعاشات التقاعدية باستثناء الضمان الاجتماعي الإلزامي,متوسطة,6,633,492,141,234,232,2
2022,2,منطقة المدينة المنورة,تمويل التأمين وإعادة التأمين وصناديق المعاشات التقاعدية باستثناء الضمان الاجتماعي الإلزامي,متناهية الصغر,2,0,0,0,3,3,0
2022,2,منطقة جازان,تمويل التأمين وإعادة التأمين وصناديق المعاشات التقاعدية باستثناء الضمان الاجتماعي الإلزامي,متناهية الصغر,1,0,0,0,4,4,0
2022,2,منطقة عسير,تمويل التأمين وإعادة التأمين وصناديق المعاشات التقاعدية باستثناء الضمان الاجتماعي الإلزامي,متناهية الصغر,2,0,0,0,3,3,0
2022,2,منطقة عسير,تمويل التأمين وإعادة التأمين وصناديق المعاشات التقاعدية باستثناء الضمان الاجتماعي الإلزامي,متوسطة,1,98,96,2,21,21,0
2022,2,منطقة مكة المكرمة,تمويل التأمين وإعادة التأمين وصناديق المعاشات التقاعدية باستثناء الضمان الاجتماعي الإلزامي,صغيرة,6,88,44,44,33,31,2
2022,2,منطقة مكة المكرمة,تمويل التأمين وإعادة التأمين وصناديق المعاشات التقاعدية باستثناء الضمان الاجتماعي الإلزامي,كبيرة,1,1143,665,478,392,320,72
2022,2,منطقة مكة المكرمة,تمويل التأمين وإعادة التأمين وصناديق المعاشات التقاعدية باستثناء الضمان الاجتماعي الإلزامي,متناهية الصغر,7,1,1,0,9,8,1
2022,2,منطقة مكة المكرمة,تمويل التأمين وإعادة التأمين وصناديق المعاشات التقاعدية باستثناء الضمان الاجتماعي الإلزامي,متوسطة,4,564,342,222,148,140,8
2022,2,منطقة نجران,تمويل التأمين وإعادة التأمين وصناديق المعاشات التقاعدية باستثناء الضمان الاجتماعي الإلزامي,متناهية الصغر,2,1,1,0,7,7,0
2022,2,المنطقة الشرقية,تعدين ركازات الفلزات,صغيرة,15,18,12,6,135,135,0
2022,2,المنطقة الشرقية,تعدين ركازات الفلزات,متناهية الصغر,90,14,7,7,184,184,0
2022,2,المنطقة الشرقية,تعدين ركازات الفلزات,متوسطة,3,134,90,44,236,235,1
2022,2,منطقة الباحة,تعدين ركازات الفلزات,متناهية الصغر,4,0,0,0,9,9,0
2022,2,منطقة الجوف,تعدين ركازات الفلزات,متناهية الصغر,3,0,0,0,6,6,0
2022,2,منطقة الحدود الشمالية,تعدين ركازات الفلزات,متناهية الصغر,5,1,1,0,14,14,0
2022,2,منطقة الرياض,تعدين ركازات الفلزات,صغيرة,12,43,26,17,159,158,1
2022,2,منطقة الرياض,تعدين ركازات الفلزات,متناهية الصغر,31,15,8,7,58,58,0
2022,2,منطقة الرياض,تعدين ركازات الفلزات,متوسطة,1,0,0,0,65,65,0
2022,2,منطقة القصيم,تعدين ركازات الفلزات,صغيرة,1,2,2,0,5,5,0
2022,2,منطقة القصيم,تعدين ركازات الفلزات,متناهية الصغر,16,3,3,0,44,44,0
2022,2,منطقة القصيم,تعدين ركازات الفلزات,متوسطة,1,89,89,0,0,0,0
2022,2,منطقة المدينة المنورة,تعدين ركازات الفلزات,صغيرة,2,3,2,1,15,15,0
2022,2,منطقة المدينة المنورة,تعدين ركازات الفلزات,متناهية الصغر,9,2,1,1,17,17,0
2022,2,منطقة تبوك,تعدين ركازات الفلزات,صغيرة,1,1,1,0,7,7,0
2022,2,منطقة تبوك,تعدين ركازات الفلزات,متناهية الصغر,1,0,0,0,1,1,0
2022,2,منطقة جازان,تعدين ركازات الفلزات,متناهية الصغر,11,0,0,0,36,36,0
2022,2,منطقة حائل,تعدين ركازات الفلزات,متناهية الصغر,3,0,0,0,5,5,0
2022,2,منطقة عسير,تعدين ركازات الفلزات,صغيرة,11,23,14,9,93,93,0
2022,2,منطقة عسير,تعدين ركازات الفلزات,متناهية الصغر,45,4,2,2,97,96,1
2022,2,منطقة مكة المكرمة,تعدين ركازات الفلزات,صغيرة,7,62,43,19,105,103,2
2022,2,منطقة مكة المكرمة,تعدين ركازات الفلزات,متناهية الصغر,39,11,6,5,79,79,0
2022,2,منطقة مكة المكرمة,تعدين ركازات الفلزات,متوسطة,2,227,227,0,0,0,0
2022,2,منطقة نجران,تعدين ركازات الفلزات,صغيرة,1,0,0,0,10,10,0
2022,2,منطقة نجران,تعدين ركازات الفلزات,متناهية الصغر,8,0,0,0,19,19,0
2022,2,المنطقة الشرقية,تعدين الفحم والليغنيت,صغيرة,2,8,8,0,14,14,0
2022,2,المنطقة الشرقية,تعدين الفحم والليغنيت,متناهية الصغر,4,3,2,1,7,7,0
2022,2,منطقة الرياض,تعدين الفحم والليغنيت,صغيرة,2,3,2,1,16,16,0
2022,2,منطقة الرياض,تعدين الفحم والليغنيت,متناهية الصغر,11,5,4,1,32,32,0
2022,2,منطقة القصيم,تعدين الفحم والليغنيت,صغيرة,1,4,0,4,15,15,0
2022,2,منطقة القصيم,تعدين الفحم والليغنيت,متناهية الصغر,3,2,0,2,6,6,0
2022,2,منطقة المدينة المنورة,تعدين الفحم والليغنيت,متناهية الصغر,1,0,0,0,1,1,0
2022,2,منطقة حائل,تعدين الفحم والليغنيت,متناهية الصغر,1,0,0,0,4,4,0
2022,2,منطقة مكة المكرمة,تعدين الفحم والليغنيت,صغيرة,1,3,1,2,15,15,0
2022,2,منطقة مكة المكرمة,تعدين الفحم والليغنيت,متناهية الصغر,8,2,1,1,17,17,0
2022,2,منطقة نجران,تعدين الفحم والليغنيت,متناهية الصغر,1,0,0,0,4,4,0
2022,2,المنطقة الشرقية,تشييد المباني,صغيرة,5144,11478,6354,5124,69658,69445,213
2022,2,المنطقة الشرقية,تشييد المباني,كبيرة,138,22464,16712,5752,119535,118478,1057
2022,2,المنطقة الشرقية,تشييد المباني,متناهية الصغر,11648,3315,1769,1546,26831,26744,87
2022,2,المنطقة الشرقية,تشييد المباني,متوسطة,725,10792,6894,3898,60310,60195,115
2022,2,منطقة الباحة,تشييد المباني,صغيرة,302,517,374,143,2971,2964,7
2022,2,منطقة الباحة,تشييد المباني,متناهية الصغر,1156,238,138,100,2790,2787,3
2022,2,منطقة الباحة,تشييد المباني,متوسطة,8,130,96,34,624,624,0
2022,2,منطقة الجوف,تشييد المباني,صغيرة,299,458,296,162,3207,3202,5
2022,2,منطقة الجوف,تشييد المباني,كبيرة,1,248,183,65,435,360,75
2022,2,منطقة الجوف,تشييد المباني,متناهية الصغر,1454,256,188,68,3600,3594,6
2022,2,منطقة الجوف,تشييد المباني,متوسطة,16,234,158,76,1145,1132,13
2022,2,منطقة الحدود الشمالية,تشييد المباني,صغيرة,226,339,189,150,2378,2369,9
2022,2,منطقة الحدود الشمالية,تشييد المباني,كبيرة,3,295,137,158,1419,1388,31
2022,2,منطقة الحدود الشمالية,تشييد المباني,متناهية الصغر,1545,223,123,100,3988,3977,11
2022,2,منطقة الحدود الشمالية,تشييد المباني,متوسطة,14,140,85,55,802,802,0
2022,2,منطقة الرياض,تشييد المباني,صغيرة,7659,14766,6728,8038,96873,96071,802
2022,2,منطقة الرياض,تشييد المباني,كبيرة,298,21125,12286,8839,190316,188922,1394
2022,2,منطقة الرياض,تشييد المباني,متناهية الصغر,22441,5621,2725,2896,50170,49789,381
2022,2,منطقة الرياض,تشييد المباني,متوسطة,1084,14179,6874,7305,98715,98088,627
2022,2,منطقة القصيم,تشييد المباني,صغيرة,1802,2366,1429,937,21343,21252,91
2022,2,منطقة القصيم,تشييد المباني,كبيرة,24,308,151,157,9647,9631,16
2022,2,منطقة القصيم,تشييد المباني,متناهية الصغر,9775,1367,755,612,23688,23616,72
2022,2,منطقة القصيم,تشييد المباني,متوسطة,175,1324,879,445,16078,16057,21
2022,2,منطقة المدينة المنورة,تشييد المباني,صغيرة,1429,2472,1450,1022,16175,16092,83
2022,2,منطقة المدينة المنورة,تشييد المباني,كبيرة,10,2452,1476,976,5462,5018,444
2022,2,منطقة المدينة المنورة,تشييد المباني,متناهية الصغر,5539,1161,650,511,13508,13453,55
2022,2,منطقة المدينة المنورة,تشييد المباني,متوسطة,93,1314,823,491,6781,6761,20
2022,2,منطقة تبوك,تشييد المباني,صغيرة,396,673,412,261,3905,3892,13
2022,2,منطقة تبوك,تشييد المباني,كبيرة,1,14,9,5,262,258,4
2022,2,منطقة تبوك,تشييد المباني,متناهية الصغر,2713,491,257,234,6878,6870,8
2022,2,منطقة تبوك,تشييد المباني,متوسطة,14,139,77,62,958,958,0
2022,2,منطقة جازان,تشييد المباني,صغيرة,481,853,419,434,4880,4867,13
2022,2,منطقة جازان,تشييد المباني,متناهية الصغر,3653,613,352,261,9291,9259,32
2022,2,منطقة جازان,تشييد المباني,متوسطة,19,251,151,100,1428,1423,5
2022,2,منطقة حائل,تشييد المباني,صغيرة,552,774,374,400,5981,5959,22
2022,2,منطقة حائل,تشييد المباني,كبيرة,2,112,85,27,612,612,0
2022,2,منطقة حائل,تشييد المباني,متناهية الصغر,3252,490,271,219,7845,7819,26
2022,2,منطقة حائل,تشييد المباني,متوسطة,37,453,300,153,3044,3040,4
2022,2,منطقة عسير,تشييد المباني,صغيرة,1451,2531,1604,927,14775,14731,44
2022,2,منطقة عسير,تشييد المباني,كبيرة,2,181,178,3,1723,1723,0
2022,2,منطقة عسير,تشييد المباني,متناهية الصغر,8003,1422,856,566,19341,19319,22
2022,2,منطقة عسير,تشييد المباني,متوسطة,71,1240,839,401,5378,5297,81
2022,2,منطقة مكة المكرمة,تشييد المباني,صغيرة,6058,10750,5444,5306,71693,71163,530
2022,2,منطقة مكة المكرمة,تشييد المباني,كبيرة,82,11488,8636,2852,85243,84616,627
2022,2,منطقة مكة المكرمة,تشييد المباني,متناهية الصغر,20165,4571,2309,2262,49378,48972,406
2022,2,منطقة مكة المكرمة,تشييد المباني,متوسطة,498,7787,4581,3206,40065,39732,333
2022,2,منطقة نجران,تشييد المباني,صغيرة,529,729,383,346,5809,5784,25
2022,2,منطقة نجران,تشييد المباني,كبيرة,12,969,701,268,3661,3643,18
2022,2,منطقة نجران,تشييد المباني,متناهية الصغر,2911,392,215,177,7052,7013,39
2022,2,منطقة نجران,تشييد المباني,متوسطة,47,791,480,311,4338,4332,6
2022,2,المنطقة الشرقية,تجميع المياه ومعالجتها وتوصيلها,صغيرة,37,181,134,47,418,418,0
2022,2,المنطقة الشرقية,تجميع المياه ومعالجتها وتوصيلها,كبيرة,2,1643,1635,8,456,456,0
2022,2,المنطقة الشرقية,تجميع المياه ومعالجتها وتوصيلها,متناهية الصغر,58,19,17,2,115,115,0
2022,2,المنطقة الشرقية,تجميع المياه ومعالجتها وتوصيلها,متوسطة,2,143,140,3,155,155,0
2022,2,منطقة الباحة,تجميع المياه ومعالجتها وتوصيلها,صغيرة,2,3,3,0,12,12,0
2022,2,منطقة الباحة,تجميع المياه ومعالجتها وتوصيلها,متناهية الصغر,19,3,0,3,39,39,0
2022,2,منطقة الجوف,تجميع المياه ومعالجتها وتوصيلها,صغيرة,3,13,8,5,39,39,0
2022,2,منطقة الجوف,تجميع المياه ومعالجتها وتوصيلها,متناهية الصغر,13,3,1,2,27,27,0
2022,2,منطقة الجوف,تجميع المياه ومعالجتها وتوصيلها,متوسطة,1,19,13,6,37,37,0
2022,2,منطقة الحدود الشمالية,تجميع المياه ومعالجتها وتوصيلها,صغيرة,5,7,6,1,31,31,0
2022,2,منطقة الحدود الشمالية,تجميع المياه ومعالجتها وتوصيلها,متناهية الصغر,17,2,1,1,42,42,0
2022,2,منطقة الرياض,تجميع المياه ومعالجتها وتوصيلها,صغيرة,57,213,127,86,649,649,0
2022,2,منطقة الرياض,تجميع المياه ومعالجتها وتوصيلها,كبيرة,2,85,46,39,535,535,0
2022,2,منطقة الرياض,تجميع المياه ومعالجتها وتوصيلها,متناهية الصغر,166,56,26,30,361,359,2
2022,2,منطقة الرياض,تجميع المياه ومعالجتها وتوصيلها,متوسطة,10,522,366,156,629,626,3
2022,2,منطقة القصيم,تجميع المياه ومعالجتها وتوصيلها,صغيرة,13,33,15,18,142,142,0
2022,2,منطقة القصيم,تجميع المياه ومعالجتها وتوصيلها,متناهية الصغر,51,15,8,7,110,110,0
2022,2,منطقة القصيم,تجميع المياه ومعالجتها وتوصيلها,متوسطة,1,45,45,0,164,164,0
2022,2,منطقة المدينة المنورة,تجميع المياه ومعالجتها وتوصيلها,صغيرة,7,33,27,6,83,83,0
2022,2,منطقة المدينة المنورة,تجميع المياه ومعالجتها وتوصيلها,كبيرة,1,350,350,0,1,1,0
2022,2,منطقة المدينة المنورة,تجميع المياه ومعالجتها وتوصيلها,متناهية الصغر,45,20,9,11,72,72,0
2022,2,منطقة المدينة المنورة,تجميع المياه ومعالجتها وتوصيلها,متوسطة,1,30,16,14,75,75,0
2022,2,منطقة تبوك,تجميع المياه ومعالجتها وتوصيلها,صغيرة,5,8,7,1,67,67,0
2022,2,منطقة تبوك,تجميع المياه ومعالجتها وتوصيلها,متناهية الصغر,42,11,6,5,86,86,0
2022,2,منطقة تبوك,تجميع المياه ومعالجتها وتوصيلها,متوسطة,1,19,13,6,81,81,0
2022,2,منطقة جازان,تجميع المياه ومعالجتها وتوصيلها,صغيرة,8,64,58,6,51,51,0
2022,2,منطقة جازان,تجميع المياه ومعالجتها وتوصيلها,متناهية الصغر,70,13,6,7,137,137,0
2022,2,منطقة جازان,تجميع المياه ومعالجتها وتوصيلها,متوسطة,1,55,53,2,26,26,0
2022,2,منطقة حائل,تجميع المياه ومعالجتها وتوصيلها,متناهية الصغر,28,2,0,2,64,64,0
2022,2,منطقة حائل,تجميع المياه ومعالجتها وتوصيلها,متوسطة,3,63,46,17,284,284,0
2022,2,منطقة عسير,تجميع المياه ومعالجتها وتوصيلها,صغيرة,20,54,26,28,206,206,0
2022,2,منطقة عسير,تجميع المياه ومعالجتها وتوصيلها,متناهية الصغر,128,23,8,15,243,243,0
2022,2,منطقة مكة المكرمة,تجميع المياه ومعالجتها وتوصيلها,صغيرة,67,261,200,61,496,495,1
2022,2,منطقة مكة المكرمة,تجميع المياه ومعالجتها وتوصيلها,كبيرة,1,111,99,12,528,528,0
2022,2,منطقة مكة المكرمة,تجميع المياه ومعالجتها وتوصيلها,متناهية الصغر,350,76,42,34,710,708,2
2022,2,منطقة مكة المكرمة,تجميع المياه ومعالجتها وتوصيلها,متوسطة,13,726,640,86,771,770,1
2022,2,منطقة نجران,تجميع المياه ومعالجتها وتوصيلها,صغيرة,3,5,2,3,21,21,0
2022,2,منطقة نجران,تجميع المياه ومعالجتها وتوصيلها,كبيرة,1,120,102,18,187,184,3
2022,2,منطقة نجران,تجميع المياه ومعالجتها وتوصيلها,متناهية الصغر,26,7,3,4,49,49,0
2022,2,منطقة نجران,تجميع المياه ومعالجتها وتوصيلها,متوسطة,2,29,25,4,103,103,0
2022,2,المنطقة الشرقية,تجارة الجملة والتجزئة ، وإصلاح المركبات ذات المحركات والدراجات النارية,صغيرة,1704,4137,2664,1473,16356,16334,22
2022,2,المنطقة الشرقية,تجارة الجملة والتجزئة ، وإصلاح المركبات ذات المحركات والدراجات النارية,كبيرة,10,2183,1972,211,4064,4059,5
2022,2,المنطقة الشرقية,تجارة الجملة والتجزئة ، وإصلاح المركبات ذات المحركات والدراجات النارية,متناهية الصغر,6508,2227,1332,895,14141,14119,22
2022,2,المنطقة الشرقية,تجارة الجملة والتجزئة ، وإصلاح المركبات ذات المحركات والدراجات النارية,متوسطة,60,1259,920,339,3627,3624,3
2022,2,منطقة الباحة,تجارة الجملة والتجزئة ، وإصلاح المركبات ذات المحركات والدراجات النارية,صغيرة,81,153,117,36,618,618,0
2022,2,منطقة الباحة,تجارة الجملة والتجزئة ، وإصلاح المركبات ذات المحركات والدراجات النارية,متناهية الصغر,543,125,102,23,1150,1147,3
2022,2,منطقة الباحة,تجارة الجملة والتجزئة ، وإصلاح المركبات ذات المحركات والدراجات النارية,متوسطة,2,33,24,9,117,117,0
2022,2,منطقة الجوف,تجارة الجملة والتجزئة ، وإصلاح المركبات ذات المحركات والدراجات النارية,صغيرة,136,206,150,56,1198,1197,1
2022,2,منطقة الجوف,تجارة الجملة والتجزئة ، وإصلاح المركبات ذات المحركات والدراجات النارية,متناهية الصغر,897,212,173,39,1993,1992,1
2022,2,منطقة الحدود الشمالية,تجارة الجملة والتجزئة ، وإصلاح المركبات ذات المحركات والدراجات النارية,صغيرة,81,119,79,40,663,660,3
2022,2,منطقة الحدود الشمالية,تجارة الجملة والتجزئة ، وإصلاح المركبات ذات المحركات والدراجات النارية,متناهية الصغر,637,113,81,32,1455,1453,2
2022,2,منطقة الحدود الشمالية,تجارة الجملة والتجزئة ، وإصلاح المركبات ذات المحركات والدراجات النارية,متوسطة,1,16,10,6,48,48,0
2022,2,منطقة الرياض,تجارة الجملة والتجزئة ، وإصلاح المركبات ذات المحركات والدراجات النارية,صغيرة,2772,7118,3597,3521,27469,27356,113
2022,2,منطقة الرياض,تجارة الجملة والتجزئة ، وإصلاح المركبات ذات المحركات والدراجات النارية,كبيرة,10,1546,1296,250,4309,4304,5
2022,2,منطقة الرياض,تجارة الجملة والتجزئة ، وإصلاح المركبات ذات المحركات والدراجات النارية,متناهية الصغر,13409,3379,1784,1595,31174,31047,127
2022,2,منطقة الرياض,تجارة الجملة والتجزئة ، وإصلاح المركبات ذات المحركات والدراجات النارية,متوسطة,129,2780,1674,1106,9445,9416,29
2022,2,منطقة القصيم,تجارة الجملة والتجزئة ، وإصلاح المركبات ذات المحركات والدراجات النارية,صغيرة,536,1042,722,320,5076,5053,23
2022,2,منطقة القصيم,تجارة الجملة والتجزئة ، وإصلاح المركبات ذات المحركات والدراجات النارية,متناهية الصغر,3216,671,435,236,7429,7421,8
2022,2,منطقة القصيم,تجارة الجملة والتجزئة ، وإصلاح المركبات ذات المحركات والدراجات النارية,متوسطة,21,281,190,91,1371,1371,0
2022,2,منطقة المدينة المنورة,تجارة الجملة والتجزئة ، وإصلاح المركبات ذات المحركات والدراجات النارية,صغيرة,387,777,527,250,3110,3098,12
2022,2,منطقة المدينة المنورة,تجارة الجملة والتجزئة ، وإصلاح المركبات ذات المحركات والدراجات النارية,متناهية الصغر,3034,729,471,258,6867,6855,12
2022,2,منطقة المدينة المنورة,تجارة الجملة والتجزئة ، وإصلاح المركبات ذات المحركات والدراجات النارية,متوسطة,10,110,89,21,542,542,0
2022,2,منطقة تبوك,تجارة الجملة والتجزئة ، وإصلاح المركبات ذات المحركات والدراجات النارية,صغيرة,187,395,257,138,1584,1581,3
2022,2,منطقة تبوك,تجارة الجملة والتجزئة ، وإصلاح المركبات ذات المحركات والدراجات النارية,متناهية الصغر,1492,325,213,112,3444,3439,5
2022,2,منطقة تبوك,تجارة الجملة والتجزئة ، وإصلاح المركبات ذات المحركات والدراجات النارية,متوسطة,2,77,69,8,206,206,0
2022,2,منطقة جازان,تجارة الجملة والتجزئة ، وإصلاح المركبات ذات المحركات والدراجات النارية,صغيرة,192,412,287,125,1667,1663,4
2022,2,منطقة جازان,تجارة الجملة والتجزئة ، وإصلاح المركبات ذات المحركات والدراجات النارية,كبيرة,1,0,0,0,299,299,0
2022,2,منطقة جازان,تجارة الجملة والتجزئة ، وإصلاح المركبات ذات المحركات والدراجات النارية,متناهية الصغر,2394,401,282,119,5648,5643,5
2022,2,منطقة جازان,تجارة الجملة والتجزئة ، وإصلاح المركبات ذات المحركات والدراجات النارية,متوسطة,5,73,56,17,329,328,1
2022,2,منطقة حائل,تجارة الجملة والتجزئة ، وإصلاح المركبات ذات المحركات والدراجات النارية,صغيرة,217,434,255,179,1936,1934,2
2022,2,منطقة حائل,تجارة الجملة والتجزئة ، وإصلاح المركبات ذات المحركات والدراجات النارية,متناهية الصغر,1228,243,154,89,2829,2825,4
2022,2,منطقة حائل,تجارة الجملة والتجزئة ، وإصلاح المركبات ذات المحركات والدراجات النارية,متوسطة,4,53,40,13,214,214,0
2022,2,منطقة عسير,تجارة الجملة والتجزئة ، وإصلاح المركبات ذات المحركات والدراجات النارية,صغيرة,514,1135,753,382,4602,4598,4
2022,2,منطقة عسير,تجارة الجملة والتجزئة ، وإصلاح المركبات ذات المحركات والدراجات النارية,متناهية الصغر,3534,811,549,262,7868,7849,19
2022,2,منطقة عسير,تجارة الجملة والتجزئة ، وإصلاح المركبات ذات المحركات والدراجات النارية,متوسطة,13,317,276,41,985,984,1
2022,2,منطقة مكة المكرمة,تجارة الجملة والتجزئة ، وإصلاح المركبات ذات المحركات والدراجات النارية,صغيرة,1669,3991,2485,1506,15631,15539,92
2022,2,منطقة مكة المكرمة,تجارة الجملة والتجزئة ، وإصلاح المركبات ذات المحركات والدراجات النارية,كبيرة,15,4864,4182,682,9509,9476,33
2022,2,منطقة مكة المكرمة,تجارة الجملة والتجزئة ، وإصلاح المركبات ذات المحركات والدراجات النارية,متناهية الصغر,10057,2521,1523,998,23019,22905,114
2022,2,منطقة مكة المكرمة,تجارة الجملة والتجزئة ، وإصلاح المركبات ذات المحركات والدراجات النارية,متوسطة,66,1658,1246,412,4504,4492,12
2022,2,منطقة نجران,تجارة الجملة والتجزئة ، وإصلاح المركبات ذات المحركات والدراجات النارية,صغيرة,120,242,153,89,1254,1248,6
2022,2,منطقة نجران,تجارة الجملة والتجزئة ، وإصلاح المركبات ذات المحركات والدراجات النارية,متناهية الصغر,847,150,91,59,1970,1965,5
2022,2,منطقة نجران,تجارة الجملة والتجزئة ، وإصلاح المركبات ذات المحركات والدراجات النارية,متوسطة,3,84,71,13,196,196,0
2022,2,المنطقة الشرقية,تجارة الجملة ، باستثناء المركبات ذات المحركات والدراجات النارية,صغيرة,2223,8602,5008,3594,22589,22460,129
2022,2,المنطقة الشرقية,تجارة الجملة ، باستثناء المركبات ذات المحركات والدراجات النارية,كبيرة,28,5928,4040,1888,10622,10531,91
2022,2,المنطقة الشرقية,تجارة الجملة ، باستثناء المركبات ذات المحركات والدراجات النارية,متناهية الصغر,6029,3308,1862,1446,11419,11354,65
2022,2,المنطقة الشرقية,تجارة الجملة ، باستثناء المركبات ذات المحركات والدراجات النارية,متوسطة,190,6039,3853,2186,12552,12449,103
2022,2,منطقة الباحة,تجارة الجملة ، باستثناء المركبات ذات المحركات والدراجات النارية,صغيرة,108,289,215,74,931,931,0
2022,2,منطقة الباحة,تجارة الجملة ، باستثناء المركبات ذات المحركات والدراجات النارية,متناهية الصغر,421,200,147,53,799,796,3
2022,2,منطقة الباحة,تجارة الجملة ، باستثناء المركبات ذات المحركات والدراجات النارية,متوسطة,3,81,63,18,161,161,0
2022,2,منطقة الجوف,تجارة الجملة ، باستثناء المركبات ذات المحركات والدراجات النارية,صغيرة,138,388,283,105,1309,1306,3
2022,2,منطقة الجوف,تجارة الجملة ، باستثناء المركبات ذات المحركات والدراجات النارية,متناهية الصغر,575,187,133,54,1137,1130,7
2022,2,منطقة الجوف,تجارة الجملة ، باستثناء المركبات ذات المحركات والدراجات النارية,متوسطة,1,68,18,50,128,126,2
2022,2,منطقة الحدود الشمالية,تجارة الجملة ، باستثناء المركبات ذات المحركات والدراجات النارية,صغيرة,59,141,75,66,563,558,5
2022,2,منطقة الحدود الشمالية,تجارة الجملة ، باستثناء المركبات ذات المحركات والدراجات النارية,متناهية الصغر,361,118,71,47,817,817,0
2022,2,منطقة الحدود الشمالية,تجارة الجملة ، باستثناء المركبات ذات المحركات والدراجات النارية,متوسطة,3,19,10,9,230,230,0
2022,2,منطقة الرياض,تجارة الجملة ، باستثناء المركبات ذات المحركات والدراجات النارية,صغيرة,5675,21322,9966,11356,59661,58950,711
2022,2,منطقة الرياض,تجارة الجملة ، باستثناء المركبات ذات المحركات والدراجات النارية,كبيرة,67,17668,12823,4845,23347,23142,205
2022,2,منطقة الرياض,تجارة الجملة ، باستثناء المركبات ذات المحركات والدراجات النارية,متناهية الصغر,15916,6833,3385,3448,31752,31288,464
2022,2,منطقة الرياض,تجارة الجملة ، باستثناء المركبات ذات المحركات والدراجات النارية,متوسطة,497,15665,8175,7490,32206,31644,562
2022,2,منطقة القصيم,تجارة الجملة ، باستثناء المركبات ذات المحركات والدراجات النارية,صغيرة,441,1415,901,514,4435,4401,34
2022,2,منطقة القصيم,تجارة الجملة ، باستثناء المركبات ذات المحركات والدراجات النارية,كبيرة,3,832,292,540,762,762,0
2022,2,منطقة القصيم,تجارة الجملة ، باستثناء المركبات ذات المحركات والدراجات النارية,متناهية الصغر,2105,757,496,261,4329,4311,18
2022,2,منطقة القصيم,تجارة الجملة ، باستثناء المركبات ذات المحركات والدراجات النارية,متوسطة,26,492,312,180,1804,1795,9
2022,2,منطقة المدينة المنورة,تجارة الجملة ، باستثناء المركبات ذات المحركات والدراجات النارية,صغيرة,642,1951,1224,727,5938,5903,35
2022,2,منطقة المدينة المنورة,تجارة الجملة ، باستثناء المركبات ذات المحركات والدراجات النارية,كبيرة,1,91,71,20,218,216,2
2022,2,منطقة المدينة المنورة,تجارة الجملة ، باستثناء المركبات ذات المحركات والدراجات النارية,متناهية الصغر,2806,1059,664,395,5771,5727,44
2022,2,منطقة المدينة المنورة,تجارة الجملة ، باستثناء المركبات ذات المحركات والدراجات النارية,متوسطة,29,795,555,240,2192,2086,106
2022,2,منطقة تبوك,تجارة الجملة ، باستثناء المركبات ذات المحركات والدراجات النارية,صغيرة,156,515,298,217,1565,1558,7
2022,2,منطقة تبوك,تجارة الجملة ، باستثناء المركبات ذات المحركات والدراجات النارية,كبيرة,1,99,64,35,269,269,0
2022,2,منطقة تبوك,تجارة الجملة ، باستثناء المركبات ذات المحركات والدراجات النارية,متناهية الصغر,834,317,181,136,1640,1631,9
2022,2,منطقة تبوك,تجارة الجملة ، باستثناء المركبات ذات المحركات والدراجات النارية,متوسطة,10,166,70,96,604,602,2
2022,2,منطقة جازان,تجارة الجملة ، باستثناء المركبات ذات المحركات والدراجات النارية,صغيرة,295,745,419,326,2774,2765,9
2022,2,منطقة جازان,تجارة الجملة ، باستثناء المركبات ذات المحركات والدراجات النارية,متناهية الصغر,1651,431,263,168,3664,3644,20
2022,2,منطقة جازان,تجارة الجملة ، باستثناء المركبات ذات المحركات والدراجات النارية,متوسطة,10,231,131,100,832,799,33
2022,2,منطقة حائل,تجارة الجملة ، باستثناء المركبات ذات المحركات والدراجات النارية,صغيرة,152,436,278,158,1466,1460,6
2022,2,منطقة حائل,تجارة الجملة ، باستثناء المركبات ذات المحركات والدراجات النارية,متناهية الصغر,743,251,139,112,1623,1617,6
2022,2,منطقة حائل,تجارة الجملة ، باستثناء المركبات ذات المحركات والدراجات النارية,متوسطة,6,97,43,54,272,272,0
2022,2,منطقة عسير,تجارة الجملة ، باستثناء المركبات ذات المحركات والدراجات النارية,صغيرة,473,1552,1027,525,4455,4435,20
2022,2,منطقة عسير,تجارة الجملة ، باستثناء المركبات ذات المحركات والدراجات النارية,كبيرة,2,250,151,99,483,469,14
2022,2,منطقة عسير,تجارة الجملة ، باستثناء المركبات ذات المحركات والدراجات النارية,متناهية الصغر,2030,781,516,265,4114,4094,20
2022,2,منطقة عسير,تجارة الجملة ، باستثناء المركبات ذات المحركات والدراجات النارية,متوسطة,28,685,433,252,1757,1751,6
2022,2,منطقة مكة المكرمة,تجارة الجملة ، باستثناء المركبات ذات المحركات والدراجات النارية,صغيرة,5119,18032,8778,9254,52848,52190,658
2022,2,منطقة مكة المكرمة,تجارة الجملة ، باستثناء المركبات ذات المحركات والدراجات النارية,كبيرة,60,11089,7510,3579,19371,19113,258
2022,2,منطقة مكة المكرمة,تجارة الجملة ، باستثناء المركبات ذات المحركات والدراجات النارية,متناهية الصغر,14043,5518,2817,2701,29092,28574,518
2022,2,منطقة مكة المكرمة,تجارة الجملة ، باستثناء المركبات ذات المحركات والدراجات النارية,متوسطة,378,11896,6518,5378,24379,24114,265
2022,2,منطقة نجران,تجارة الجملة ، باستثناء المركبات ذات المحركات والدراجات النارية,صغيرة,118,349,223,126,1132,1128,4
2022,2,منطقة نجران,تجارة الجملة ، باستثناء المركبات ذات المحركات والدراجات النارية,متناهية الصغر,580,178,108,70,1339,1329,10
2022,2,منطقة نجران,تجارة الجملة ، باستثناء المركبات ذات المحركات والدراجات النارية,متوسطة,6,191,99,92,398,398,0
2022,2,المنطقة الشرقية,تجارة التجزئة، باستثناء المركبات ذات المحركات والدراجات النارية,صغيرة,3145,10624,5548,5076,29333,29123,210
2022,2,المنطقة الشرقية,تجارة التجزئة، باستثناء المركبات ذات المحركات والدراجات النارية,كبيرة,34,8339,4203,4136,14277,13505,772
2022,2,المنطقة الشرقية,تجارة التجزئة، باستثناء المركبات ذات المحركات والدراجات النارية,متناهية الصغر,15183,6914,3626,3288,28774,28620,154
2022,2,المنطقة الشرقية,تجارة التجزئة، باستثناء المركبات ذات المحركات والدراجات النارية,متوسطة,238,7533,3833,3700,16042,15738,304
2022,2,منطقة الباحة,تجارة التجزئة، باستثناء المركبات ذات المحركات والدراجات النارية,صغيرة,235,650,444,206,1945,1939,6
2022,2,منطقة الباحة,تجارة التجزئة، باستثناء المركبات ذات المحركات والدراجات النارية,متناهية الصغر,1334,572,381,191,2393,2376,17
2022,2,منطقة الباحة,تجارة التجزئة، باستثناء المركبات ذات المحركات والدراجات النارية,متوسطة,6,99,83,16,262,262,0
2022,2,منطقة الجوف,تجارة التجزئة، باستثناء المركبات ذات المحركات والدراجات النارية,صغيرة,299,708,481,227,2408,2395,13
2022,2,منطقة الجوف,تجارة التجزئة، باستثناء المركبات ذات المحركات والدراجات النارية,متناهية الصغر,2209,706,463,243,4145,4125,20
2022,2,منطقة الجوف,تجارة التجزئة، باستثناء المركبات ذات المحركات والدراجات النارية,متوسطة,8,199,55,144,482,481,1
2022,2,منطقة الحدود الشمالية,تجارة التجزئة، باستثناء المركبات ذات المحركات والدراجات النارية,صغيرة,167,384,216,168,1345,1328,17
2022,2,منطقة الحدود الشمالية,تجارة التجزئة، باستثناء المركبات ذات المحركات والدراجات النارية,متناهية الصغر,1668,448,260,188,3347,3332,15
2022,2,منطقة الحدود الشمالية,تجارة التجزئة، باستثناء المركبات ذات المحركات والدراجات النارية,متوسطة,8,130,94,36,485,465,20
2022,2,منطقة الرياض,تجارة التجزئة، باستثناء المركبات ذات المحركات والدراجات النارية,صغيرة,6741,24628,11321,13307,67933,67019,914
2022,2,منطقة الرياض,تجارة التجزئة، باستثناء المركبات ذات المحركات والدراجات النارية,كبيرة,132,46433,25668,20765,80605,79699,906
2022,2,منطقة الرياض,تجارة التجزئة، باستثناء المركبات ذات المحركات والدراجات النارية,متناهية الصغر,30762,11735,5866,5869,62006,61239,767
2022,2,منطقة الرياض,تجارة التجزئة، باستثناء المركبات ذات المحركات والدراجات النارية,متوسطة,645,18022,8448,9574,44739,43993,746
2022,2,منطقة القصيم,تجارة التجزئة، باستثناء المركبات ذات المحركات والدراجات النارية,صغيرة,1055,3241,2104,1137,10060,9987,73
2022,2,منطقة القصيم,تجارة التجزئة، باستثناء المركبات ذات المحركات والدراجات النارية,كبيرة,2,290,41,249,408,408,0
2022,2,منطقة القصيم,تجارة التجزئة، باستثناء المركبات ذات المحركات والدراجات النارية,متناهية الصغر,5709,2068,1366,702,11234,11169,65
2022,2,منطقة القصيم,تجارة التجزئة، باستثناء المركبات ذات المحركات والدراجات النارية,متوسطة,72,1430,973,457,5361,5357,4
2022,2,منطقة المدينة المنورة,تجارة التجزئة، باستثناء المركبات ذات المحركات والدراجات النارية,صغيرة,1314,3685,2246,1439,11331,11261,70
2022,2,منطقة المدينة المنورة,تجارة التجزئة، باستثناء المركبات ذات المحركات والدراجات النارية,كبيرة,4,382,156,226,1200,1174,26
2022,2,منطقة المدينة المنورة,تجارة التجزئة، باستثناء المركبات ذات المحركات والدراجات النارية,متناهية الصغر,8876,2917,1859,1058,17927,17761,166
2022,2,منطقة المدينة المنورة,تجارة التجزئة، باستثناء المركبات ذات المحركات والدراجات النارية,متوسطة,59,1508,698,810,3329,3290,39
2022,2,منطقة تبوك,تجارة التجزئة، باستثناء المركبات ذات المحركات والدراجات النارية,صغيرة,391,1122,604,518,3076,3054,22
2022,2,منطقة تبوك,تجارة التجزئة، باستثناء المركبات ذات المحركات والدراجات النارية,كبيرة,1,116,94,22,136,136,0
2022,2,منطقة تبوك,تجارة التجزئة، باستثناء المركبات ذات المحركات والدراجات النارية,متناهية الصغر,3380,1121,677,444,6536,6514,22
2022,2,منطقة تبوك,تجارة التجزئة، باستثناء المركبات ذات المحركات والدراجات النارية,متوسطة,8,336,101,235,679,649,30
2022,2,منطقة جازان,تجارة التجزئة، باستثناء المركبات ذات المحركات والدراجات النارية,صغيرة,727,2008,1062,946,6376,6313,63
2022,2,منطقة جازان,تجارة التجزئة، باستثناء المركبات ذات المحركات والدراجات النارية,كبيرة,1,130,118,12,250,250,0
2022,2,منطقة جازان,تجارة التجزئة، باستثناء المركبات ذات المحركات والدراجات النارية,متناهية الصغر,6228,1755,1057,698,12793,12714,79
2022,2,منطقة جازان,تجارة التجزئة، باستثناء المركبات ذات المحركات والدراجات النارية,متوسطة,21,606,253,353,1485,1457,28
2022,2,منطقة حائل,تجارة التجزئة، باستثناء المركبات ذات المحركات والدراجات النارية,صغيرة,405,1062,570,492,3672,3638,34
2022,2,منطقة حائل,تجارة التجزئة، باستثناء المركبات ذات المحركات والدراجات النارية,كبيرة,2,360,149,211,473,473,0
2022,2,منطقة حائل,تجارة التجزئة، باستثناء المركبات ذات المحركات والدراجات النارية,متناهية الصغر,2914,961,539,422,5812,5774,38
2022,2,منطقة حائل,تجارة التجزئة، باستثناء المركبات ذات المحركات والدراجات النارية,متوسطة,14,334,114,220,765,735,30
2022,2,منطقة عسير,تجارة التجزئة، باستثناء المركبات ذات المحركات والدراجات النارية,صغيرة,1123,3286,1874,1412,9879,9819,60
2022,2,منطقة عسير,تجارة التجزئة، باستثناء المركبات ذات المحركات والدراجات النارية,كبيرة,3,882,236,646,839,835,4
2022,2,منطقة عسير,تجارة التجزئة، باستثناء المركبات ذات المحركات والدراجات النارية,متناهية الصغر,7860,2870,1836,1034,15049,14974,75
2022,2,منطقة عسير,تجارة التجزئة، باستثناء المركبات ذات المحركات والدراجات النارية,متوسطة,40,978,471,507,2284,2213,71
2022,2,منطقة مكة المكرمة,تجارة التجزئة، باستثناء المركبات ذات المحركات والدراجات النارية,صغيرة,5838,19281,9319,9962,56807,55982,825
2022,2,منطقة مكة المكرمة,تجارة التجزئة، باستثناء المركبات ذات المحركات والدراجات النارية,كبيرة,62,19313,9805,9508,24483,23844,639
2022,2,منطقة مكة المكرمة,تجارة التجزئة، باستثناء المركبات ذات المحركات والدراجات النارية,متناهية الصغر,29471,10302,5587,4715,60391,59488,903
2022,2,منطقة مكة المكرمة,تجارة التجزئة، باستثناء المركبات ذات المحركات والدراجات النارية,متوسطة,387,13303,6575,6728,25034,24541,493
2022,2,منطقة نجران,تجارة التجزئة، باستثناء المركبات ذات المحركات والدراجات النارية,صغيرة,357,935,469,466,3365,3331,34
2022,2,منطقة نجران,تجارة التجزئة، باستثناء المركبات ذات المحركات والدراجات النارية,متناهية الصغر,2397,667,379,288,5007,4979,28
2022,2,منطقة نجران,تجارة التجزئة، باستثناء المركبات ذات المحركات والدراجات النارية,متوسطة,17,326,141,185,1186,1180,6
2022,2,المنطقة الشرقية,أنشطة زراعة المحاصيل والإنتاج الحيواني والصيد والخدمات المتصلة,صغيرة,264,500,307,193,3065,3061,4
2022,2,المنطقة الشرقية,أنشطة زراعة المحاصيل والإنتاج الحيواني والصيد والخدمات المتصلة,كبيرة,4,2887,2755,132,2500,2500,0
2022,2,المنطقة الشرقية,أنشطة زراعة المحاصيل والإنتاج الحيواني والصيد والخدمات المتصلة,متناهية الصغر,1866,240,137,103,2689,2683,6
2022,2,المنطقة الشرقية,أنشطة زراعة المحاصيل والإنتاج الحيواني والصيد والخدمات المتصلة,متوسطة,15,214,129,85,1049,1048,1
2022,2,منطقة الباحة,أنشطة زراعة المحاصيل والإنتاج الحيواني والصيد والخدمات المتصلة,صغيرة,4,7,3,4,35,35,0
2022,2,منطقة الباحة,أنشطة زراعة المحاصيل والإنتاج الحيواني والصيد والخدمات المتصلة,متناهية الصغر,132,6,5,1,175,175,0
2022,2,منطقة الجوف,أنشطة زراعة المحاصيل والإنتاج الحيواني والصيد والخدمات المتصلة,صغيرة,32,42,34,8,380,373,7
2022,2,منطقة الجوف,أنشطة زراعة المحاصيل والإنتاج الحيواني والصيد والخدمات المتصلة,كبيرة,1,131,124,7,841,838,3
2022,2,منطقة الجوف,أنشطة زراعة المحاصيل والإنتاج الحيواني والصيد والخدمات المتصلة,متناهية الصغر,604,37,29,8,845,840,5
2022,2,منطقة الجوف,أنشطة زراعة المحاصيل والإنتاج الحيواني والصيد والخدمات المتصلة,متوسطة,1,9,4,5,111,111,0
2022,2,منطقة الحدود الشمالية,أنشطة زراعة المحاصيل والإنتاج الحيواني والصيد والخدمات المتصلة,صغيرة,4,3,1,2,39,39,0
2022,2,منطقة الحدود الشمالية,أنشطة زراعة المحاصيل والإنتاج الحيواني والصيد والخدمات المتصلة,متناهية الصغر,87,3,3,0,125,125,0
2022,2,منطقة الرياض,أنشطة زراعة المحاصيل والإنتاج الحيواني والصيد والخدمات المتصلة,صغيرة,520,857,416,441,6701,6674,27
2022,2,منطقة الرياض,أنشطة زراعة المحاصيل والإنتاج الحيواني والصيد والخدمات المتصلة,كبيرة,17,7440,6904,536,28685,28663,22
2022,2,منطقة الرياض,أنشطة زراعة المحاصيل والإنتاج الحيواني والصيد والخدمات المتصلة,متناهية الصغر,6591,548,266,282,12591,12521,70
2022,2,منطقة الرياض,أنشطة زراعة المحاصيل والإنتاج الحيواني والصيد والخدمات المتصلة,متوسطة,78,835,458,377,6949,6944,5
2022,2,منطقة القصيم,أنشطة زراعة المحاصيل والإنتاج الحيواني والصيد والخدمات المتصلة,صغيرة,111,202,116,86,1401,1394,7
2022,2,منطقة القصيم,أنشطة زراعة المحاصيل والإنتاج الحيواني والصيد والخدمات المتصلة,كبيرة,4,1566,1136,430,5095,5094,1
2022,2,منطقة القصيم,أنشطة زراعة المحاصيل والإنتاج الحيواني والصيد والخدمات المتصلة,متناهية الصغر,999,147,95,52,1674,1666,8
2022,2,منطقة القصيم,أنشطة زراعة المحاصيل والإنتاج الحيواني والصيد والخدمات المتصلة,متوسطة,15,178,106,72,1154,1150,4
2022,2,منطقة المدينة المنورة,أنشطة زراعة المحاصيل والإنتاج الحيواني والصيد والخدمات المتصلة,صغيرة,63,118,70,48,702,700,2
2022,2,منطقة المدينة المنورة,أنشطة زراعة المحاصيل والإنتاج الحيواني والصيد والخدمات المتصلة,متناهية الصغر,713,66,42,24,1003,996,7
2022,2,منطقة المدينة المنورة,أنشطة زراعة المحاصيل والإنتاج الحيواني والصيد والخدمات المتصلة,متوسطة,4,80,55,25,318,317,1
2022,2,منطقة تبوك,أنشطة زراعة المحاصيل والإنتاج الحيواني والصيد والخدمات المتصلة,صغيرة,38,63,25,38,458,458,0
2022,2,منطقة تبوك,أنشطة زراعة المحاصيل والإنتاج الحيواني والصيد والخدمات المتصلة,كبيرة,2,270,173,97,1332,1331,1
2022,2,منطقة تبوك,أنشطة زراعة المحاصيل والإنتاج الحيواني والصيد والخدمات المتصلة,متناهية الصغر,775,64,40,24,1077,1075,2
2022,2,منطقة تبوك,أنشطة زراعة المحاصيل والإنتاج الحيواني والصيد والخدمات المتصلة,متوسطة,4,120,56,64,166,165,1
2022,2,منطقة جازان,أنشطة زراعة المحاصيل والإنتاج الحيواني والصيد والخدمات المتصلة,صغيرة,34,32,18,14,312,310,2
2022,2,منطقة جازان,أنشطة زراعة المحاصيل والإنتاج الحيواني والصيد والخدمات المتصلة,متناهية الصغر,518,28,21,7,849,844,5
2022,2,منطقة جازان,أنشطة زراعة المحاصيل والإنتاج الحيواني والصيد والخدمات المتصلة,متوسطة,3,20,9,11,197,196,1
2022,2,منطقة حائل,أنشطة زراعة المحاصيل والإنتاج الحيواني والصيد والخدمات المتصلة,صغيرة,67,49,22,27,665,663,2
2022,2,منطقة حائل,أنشطة زراعة المحاصيل والإنتاج الحيواني والصيد والخدمات المتصلة,كبيرة,1,477,420,57,2222,2221,1
2022,2,منطقة حائل,أنشطة زراعة المحاصيل والإنتاج الحيواني والصيد والخدمات المتصلة,متناهية الصغر,1285,76,47,29,2616,2610,6
2022,2,منطقة حائل,أنشطة زراعة المحاصيل والإنتاج الحيواني والصيد والخدمات المتصلة,متوسطة,6,86,76,10,460,458,2
2022,2,منطقة عسير,أنشطة زراعة المحاصيل والإنتاج الحيواني والصيد والخدمات المتصلة,صغيرة,50,92,64,28,585,583,2
2022,2,منطقة عسير,أنشطة زراعة المحاصيل والإنتاج الحيواني والصيد والخدمات المتصلة,متناهية الصغر,845,62,34,28,1158,1154,4
2022,2,منطقة عسير,أنشطة زراعة المحاصيل والإنتاج الحيواني والصيد والخدمات المتصلة,متوسطة,5,30,19,11,461,461,0
2022,2,منطقة مكة المكرمة,أنشطة زراعة المحاصيل والإنتاج الحيواني والصيد والخدمات المتصلة,صغيرة,105,146,79,67,1115,1109,6
2022,2,منطقة مكة المكرمة,أنشطة زراعة المحاصيل والإنتاج الحيواني والصيد والخدمات المتصلة,كبيرة,2,592,408,184,2960,2959,1
2022,2,منطقة مكة المكرمة,أنشطة زراعة المحاصيل والإنتاج الحيواني والصيد والخدمات المتصلة,متناهية الصغر,1580,114,63,51,2356,2338,18
2022,2,منطقة مكة المكرمة,أنشطة زراعة المحاصيل والإنتاج الحيواني والصيد والخدمات المتصلة,متوسطة,10,220,133,87,841,764,77
2022,2,منطقة نجران,أنشطة زراعة المحاصيل والإنتاج الحيواني والصيد والخدمات المتصلة,صغيرة,23,22,17,5,216,215,1
2022,2,منطقة نجران,أنشطة زراعة المحاصيل والإنتاج الحيواني والصيد والخدمات المتصلة,متناهية الصغر,491,22,15,7,798,796,2
2022,2,منطقة نجران,أنشطة زراعة المحاصيل والإنتاج الحيواني والصيد والخدمات المتصلة,متوسطة,1,4,4,0,140,140,0
2022,2,المنطقة الشرقية,أنشطة خدمات دعم التعدين,صغيرة,58,444,363,81,535,528,7
2022,2,المنطقة الشرقية,أنشطة خدمات دعم التعدين,كبيرة,26,25539,24483,1056,10562,10550,12
2022,2,المنطقة الشرقية,أنشطة خدمات دعم التعدين,متناهية الصغر,71,69,55,14,96,95,1
2022,2,المنطقة الشرقية,أنشطة خدمات دعم التعدين,متوسطة,25,1376,1212,164,1300,1295,5
2022,2,منطقة الباحة,أنشطة خدمات دعم التعدين,متناهية الصغر,3,0,0,0,7,7,0
2022,2,منطقة الجوف,أنشطة خدمات دعم التعدين,متناهية الصغر,5,0,0,0,13,13,0
2022,2,منطقة الحدود الشمالية,أنشطة خدمات دعم التعدين,صغيرة,1,2,1,1,17,17,0
2022,2,منطقة الرياض,أنشطة خدمات دعم التعدين,صغيرة,14,86,67,19,110,110,0
2022,2,منطقة الرياض,أنشطة خدمات دعم التعدين,كبيرة,1,510,423,87,93,93,0
2022,2,منطقة الرياض,أنشطة خدمات دعم التعدين,متناهية الصغر,41,56,43,13,32,31,1
2022,2,منطقة الرياض,أنشطة خدمات دعم التعدين,متوسطة,3,119,93,26,103,100,3
2022,2,منطقة القصيم,أنشطة خدمات دعم التعدين,صغيرة,1,1,1,0,6,6,0
2022,2,منطقة القصيم,أنشطة خدمات دعم التعدين,متناهية الصغر,2,2,1,1,8,8,0
2022,2,منطقة المدينة المنورة,أنشطة خدمات دعم التعدين,صغيرة,4,22,10,12,43,43,0
2022,2,منطقة المدينة المنورة,أنشطة خدمات دعم التعدين,متناهية الصغر,6,1,0,1,11,11,0
2022,2,منطقة تبوك,أنشطة خدمات دعم التعدين,صغيرة,1,3,2,1,19,19,0
2022,2,منطقة تبوك,أنشطة خدمات دعم التعدين,متناهية الصغر,1,0,0,0,4,4,0
2022,2,منطقة جازان,أنشطة خدمات دعم التعدين,صغيرة,1,0,0,0,22,22,0
2022,2,منطقة جازان,أنشطة خدمات دعم التعدين,متناهية الصغر,5,1,1,0,14,14,0
2022,2,منطقة حائل,أنشطة خدمات دعم التعدين,صغيرة,2,0,0,0,17,17,0
2022,2,منطقة حائل,أنشطة خدمات دعم التعدين,متناهية الصغر,4,0,0,0,10,10,0
2022,2,منطقة عسير,أنشطة خدمات دعم التعدين,صغيرة,2,12,11,1,26,26,0
2022,2,منطقة عسير,أنشطة خدمات دعم التعدين,متناهية الصغر,14,3,2,1,33,33,0
2022,2,منطقة مكة المكرمة,أنشطة خدمات دعم التعدين,صغيرة,9,37,28,9,81,80,1
2022,2,منطقة مكة المكرمة,أنشطة خدمات دعم التعدين,كبيرة,2,315,183,132,605,601,4
2022,2,منطقة مكة المكرمة,أنشطة خدمات دعم التعدين,متناهية الصغر,30,11,8,3,56,55,1
2022,2,منطقة مكة المكرمة,أنشطة خدمات دعم التعدين,متوسطة,3,82,74,8,352,352,0
2022,2,منطقة نجران,أنشطة خدمات دعم التعدين,متناهية الصغر,1,1,1,0,0,0,0
2022,2,المنطقة الشرقية,أنشطة خدمات المعلومات,صغيرة,14,71,45,26,95,94,1
2022,2,المنطقة الشرقية,أنشطة خدمات المعلومات,كبيرة,1,342,230,112,26,24,2
2022,2,المنطقة الشرقية,أنشطة خدمات المعلومات,متناهية الصغر,50,49,22,27,62,61,1
2022,2,المنطقة الشرقية,أنشطة خدمات المعلومات,متوسطة,5,287,116,171,137,133,4
2022,2,منطقة الباحة,أنشطة خدمات المعلومات,صغيرة,1,19,13,6,7,7,0
2022,2,منطقة الجوف,أنشطة خدمات المعلومات,صغيرة,3,2,1,1,19,19,0
2022,2,منطقة الجوف,أنشطة خدمات المعلومات,متناهية الصغر,5,3,2,1,7,7,0
2022,2,منطقة الحدود الشمالية,أنشطة خدمات المعلومات,متناهية الصغر,2,1,1,0,5,5,0
2022,2,منطقة الرياض,أنشطة خدمات المعلومات,صغيرة,175,1281,648,633,1502,1451,51
2022,2,منطقة الرياض,أنشطة خدمات المعلومات,كبيرة,10,8555,5277,3278,3160,3064,96
2022,2,منطقة الرياض,أنشطة خدمات المعلومات,متناهية الصغر,312,306,169,137,404,382,22
2022,2,منطقة الرياض,أنشطة خدمات المعلومات,متوسطة,39,2389,1299,1090,1990,1926,64
2022,2,منطقة القصيم,أنشطة خدمات المعلومات,صغيرة,1,4,3,1,17,17,0
2022,2,منطقة القصيم,أنشطة خدمات المعلومات,متناهية الصغر,8,6,1,5,11,11,0
2022,2,منطقة المدينة المنورة,أنشطة خدمات المعلومات,صغيرة,4,4,0,4,22,22,0
2022,2,منطقة المدينة المنورة,أنشطة خدمات المعلومات,متناهية الصغر,15,9,4,5,30,29,1
2022,2,منطقة المدينة المنورة,أنشطة خدمات المعلومات,متوسطة,1,60,18,42,3,2,1
2022,2,منطقة تبوك,أنشطة خدمات المعلومات,صغيرة,1,1,1,0,5,5,0
2022,2,منطقة تبوك,أنشطة خدمات المعلومات,متناهية الصغر,6,3,1,2,7,7,0
2022,2,منطقة جازان,أنشطة خدمات المعلومات,متناهية الصغر,7,2,1,1,18,18,0
2022,2,منطقة حائل,أنشطة خدمات المعلومات,صغيرة,1,10,10,0,6,6,0
2022,2,منطقة حائل,أنشطة خدمات المعلومات,متناهية الصغر,4,1,0,1,11,11,0
2022,2,منطقة عسير,أنشطة خدمات المعلومات,متناهية الصغر,8,7,5,2,13,13,0
2022,2,منطقة مكة المكرمة,أنشطة خدمات المعلومات,صغيرة,41,243,113,130,348,336,12
2022,2,منطقة مكة المكرمة,أنشطة خدمات المعلومات,متناهية الصغر,118,79,36,43,177,172,5
2022,2,منطقة مكة المكرمة,أنشطة خدمات المعلومات,متوسطة,2,181,55,126,93,83,10
2022,2,منطقة نجران,أنشطة خدمات المعلومات,متناهية الصغر,1,0,0,0,1,1,0
2022,2,المنطقة الشرقية,أنشطة خدمات الأطعمة والمشروبات,صغيرة,3094,8638,4226,4412,32271,32141,130
2022,2,المنطقة الشرقية,أنشطة خدمات الأطعمة والمشروبات,كبيرة,26,4153,2825,1328,10466,10403,63
2022,2,المنطقة الشرقية,أنشطة خدمات الأطعمة والمشروبات,متناهية الصغر,8664,3503,1673,1830,17953,17868,85
2022,2,المنطقة الشرقية,أنشطة خدمات الأطعمة والمشروبات,متوسطة,202,4596,2046,2550,15360,15324,36
2022,2,منطقة الباحة,أنشطة خدمات الأطعمة والمشروبات,صغيرة,181,434,336,98,1845,1843,2
2022,2,منطقة الباحة,أنشطة خدمات الأطعمة والمشروبات,متناهية الصغر,771,290,198,92,1576,1567,9
2022,2,منطقة الباحة,أنشطة خدمات الأطعمة والمشروبات,متوسطة,4,83,55,28,309,308,1
2022,2,منطقة الجوف,أنشطة خدمات الأطعمة والمشروبات,صغيرة,208,483,338,145,1936,1935,1
2022,2,منطقة الجوف,أنشطة خدمات الأطعمة والمشروبات,متناهية الصغر,1094,293,198,95,2373,2358,15
2022,2,منطقة الجوف,أنشطة خدمات الأطعمة والمشروبات,متوسطة,5,77,52,25,273,273,0
2022,2,منطقة الحدود الشمالية,أنشطة خدمات الأطعمة والمشروبات,صغيرة,144,279,162,117,1430,1426,4
2022,2,منطقة الحدود الشمالية,أنشطة خدمات الأطعمة والمشروبات,متناهية الصغر,1027,210,125,85,2568,2560,8
2022,2,منطقة الحدود الشمالية,أنشطة خدمات الأطعمة والمشروبات,متوسطة,3,52,19,33,177,171,6
2022,2,منطقة الرياض,أنشطة خدمات الأطعمة والمشروبات,صغيرة,4166,12806,5387,7419,46237,45815,422
2022,2,منطقة الرياض,أنشطة خدمات الأطعمة والمشروبات,كبيرة,75,15687,10600,5087,43052,42592,460
2022,2,منطقة الرياض,أنشطة خدمات الأطعمة والمشروبات,متناهية الصغر,12986,4377,1962,2415,28033,27796,237
2022,2,منطقة الرياض,أنشطة خدمات الأطعمة والمشروبات,متوسطة,450,10530,4366,6164,32063,31658,405
2022,2,منطقة القصيم,أنشطة خدمات الأطعمة والمشروبات,صغيرة,926,1995,1240,755,9000,8979,21
2022,2,منطقة القصيم,أنشطة خدمات الأطعمة والمشروبات,كبيرة,3,160,85,75,772,772,0
2022,2,منطقة القصيم,أنشطة خدمات الأطعمة والمشروبات,متناهية الصغر,3803,984,591,393,9182,9151,31
2022,2,منطقة القصيم,أنشطة خدمات الأطعمة والمشروبات,متوسطة,49,834,498,336,3234,3226,8
2022,2,منطقة المدينة المنورة,أنشطة خدمات الأطعمة والمشروبات,صغيرة,1061,2657,1482,1175,10376,10320,56
2022,2,منطقة المدينة المنورة,أنشطة خدمات الأطعمة والمشروبات,كبيرة,2,213,182,31,445,444,1
2022,2,منطقة المدينة المنورة,أنشطة خدمات الأطعمة والمشروبات,متناهية الصغر,4868,1490,903,587,10331,10250,81
2022,2,منطقة المدينة المنورة,أنشطة خدمات الأطعمة والمشروبات,متوسطة,41,681,416,265,2792,2781,11
2022,2,منطقة تبوك,أنشطة خدمات الأطعمة والمشروبات,صغيرة,410,957,466,491,4125,4119,6
2022,2,منطقة تبوك,أنشطة خدمات الأطعمة والمشروبات,كبيرة,1,112,31,81,319,274,45
2022,2,منطقة تبوك,أنشطة خدمات الأطعمة والمشروبات,متناهية الصغر,2195,558,306,252,4833,4816,17
2022,2,منطقة تبوك,أنشطة خدمات الأطعمة والمشروبات,متوسطة,18,300,122,178,1289,1286,3
2022,2,منطقة جازان,أنشطة خدمات الأطعمة والمشروبات,صغيرة,633,1462,753,709,6082,6066,16
2022,2,منطقة جازان,أنشطة خدمات الأطعمة والمشروبات,متناهية الصغر,3956,893,514,379,8804,8780,24
2022,2,منطقة جازان,أنشطة خدمات الأطعمة والمشروبات,متوسطة,16,281,168,113,901,901,0
2022,2,منطقة حائل,أنشطة خدمات الأطعمة والمشروبات,صغيرة,304,629,391,238,3032,3013,19
2022,2,منطقة حائل,أنشطة خدمات الأطعمة والمشروبات,كبيرة,2,174,77,97,505,500,5
2022,2,منطقة حائل,أنشطة خدمات الأطعمة والمشروبات,متناهية الصغر,1909,411,234,177,4412,4397,15
2022,2,منطقة حائل,أنشطة خدمات الأطعمة والمشروبات,متوسطة,15,258,172,86,910,909,1
2022,2,منطقة عسير,أنشطة خدمات الأطعمة والمشروبات,صغيرة,1134,2552,1495,1057,10938,10903,35
2022,2,منطقة عسير,أنشطة خدمات الأطعمة والمشروبات,كبيرة,3,170,124,46,645,644,1
2022,2,منطقة عسير,أنشطة خدمات الأطعمة والمشروبات,متناهية الصغر,5508,1658,931,727,12100,12053,47
2022,2,منطقة عسير,أنشطة خدمات الأطعمة والمشروبات,متوسطة,56,1090,691,399,3833,3831,2
2022,2,منطقة مكة المكرمة,أنشطة خدمات الأطعمة والمشروبات,صغيرة,3791,10563,5016,5547,40868,40435,433
2022,2,منطقة مكة المكرمة,أنشطة خدمات الأطعمة والمشروبات,كبيرة,32,7850,5476,2374,19780,19560,220
2022,2,منطقة مكة المكرمة,أنشطة خدمات الأطعمة والمشروبات,متناهية الصغر,15391,4864,2441,2423,31963,31558,405
2022,2,منطقة مكة المكرمة,أنشطة خدمات الأطعمة والمشروبات,متوسطة,310,6173,3104,3069,20770,20484,286
2022,2,منطقة نجران,أنشطة خدمات الأطعمة والمشروبات,صغيرة,248,536,247,289,2579,2574,5
2022,2,منطقة نجران,أنشطة خدمات الأطعمة والمشروبات,كبيرة,2,232,130,102,693,688,5
2022,2,منطقة نجران,أنشطة خدمات الأطعمة والمشروبات,متناهية الصغر,1484,315,142,173,3405,3386,19
2022,2,منطقة نجران,أنشطة خدمات الأطعمة والمشروبات,متوسطة,11,182,94,88,840,837,3
2022,2,المنطقة الشرقية,أنشطة جمع النفايات ومعالجتها وتصريفها ، واسترجاع المواد,صغيرة,38,130,64,66,547,546,1
2022,2,المنطقة الشرقية,أنشطة جمع النفايات ومعالجتها وتصريفها ، واسترجاع المواد,كبيرة,3,1074,710,364,6621,5104,1517
2022,2,المنطقة الشرقية,أنشطة جمع النفايات ومعالجتها وتصريفها ، واسترجاع المواد,متناهية الصغر,39,36,24,12,60,60,0
2022,2,المنطقة الشرقية,أنشطة جمع النفايات ومعالجتها وتصريفها ، واسترجاع المواد,متوسطة,11,294,225,69,1197,1191,6
2022,2,منطقة الباحة,أنشطة جمع النفايات ومعالجتها وتصريفها ، واسترجاع المواد,متناهية الصغر,2,0,0,0,3,3,0
2022,2,منطقة الجوف,أنشطة جمع النفايات ومعالجتها وتصريفها ، واسترجاع المواد,صغيرة,1,2,1,1,17,17,0
2022,2,منطقة الجوف,أنشطة جمع النفايات ومعالجتها وتصريفها ، واسترجاع المواد,متناهية الصغر,3,2,0,2,4,4,0
2022,2,منطقة الرياض,أنشطة جمع النفايات ومعالجتها وتصريفها ، واسترجاع المواد,صغيرة,39,115,50,65,518,514,4
2022,2,منطقة الرياض,أنشطة جمع النفايات ومعالجتها وتصريفها ، واسترجاع المواد,كبيرة,12,5690,3129,2561,33438,31488,1950
2022,2,منطقة الرياض,أنشطة جمع النفايات ومعالجتها وتصريفها ، واسترجاع المواد,متناهية الصغر,77,43,24,19,171,167,4
2022,2,منطقة الرياض,أنشطة جمع النفايات ومعالجتها وتصريفها ، واسترجاع المواد,متوسطة,12,232,169,63,1061,1059,2
2022,2,منطقة القصيم,أنشطة جمع النفايات ومعالجتها وتصريفها ، واسترجاع المواد,صغيرة,7,46,21,25,109,109,0
2022,2,منطقة القصيم,أنشطة جمع النفايات ومعالجتها وتصريفها ، واسترجاع المواد,متناهية الصغر,11,4,2,2,23,23,0
2022,2,منطقة القصيم,أنشطة جمع النفايات ومعالجتها وتصريفها ، واسترجاع المواد,متوسطة,1,10,9,1,50,50,0
2022,2,منطقة المدينة المنورة,أنشطة جمع النفايات ومعالجتها وتصريفها ، واسترجاع المواد,صغيرة,3,10,5,5,27,27,0
2022,2,منطقة المدينة المنورة,أنشطة جمع النفايات ومعالجتها وتصريفها ، واسترجاع المواد,كبيرة,2,137,59,78,992,991,1
2022,2,منطقة المدينة المنورة,أنشطة جمع النفايات ومعالجتها وتصريفها ، واسترجاع المواد,متناهية الصغر,8,4,0,4,18,17,1
2022,2,منطقة المدينة المنورة,أنشطة جمع النفايات ومعالجتها وتصريفها ، واسترجاع المواد,متوسطة,3,82,60,22,278,277,1
2022,2,منطقة تبوك,أنشطة جمع النفايات ومعالجتها وتصريفها ، واسترجاع المواد,متناهية الصغر,3,2,1,1,3,3,0
2022,2,منطقة جازان,أنشطة جمع النفايات ومعالجتها وتصريفها ، واسترجاع المواد,صغيرة,4,37,23,14,67,67,0
2022,2,منطقة جازان,أنشطة جمع النفايات ومعالجتها وتصريفها ، واسترجاع المواد,متناهية الصغر,4,0,0,0,8,8,0
2022,2,منطقة حائل,أنشطة جمع النفايات ومعالجتها وتصريفها ، واسترجاع المواد,صغيرة,1,2,1,1,8,7,1
2022,2,منطقة حائل,أنشطة جمع النفايات ومعالجتها وتصريفها ، واسترجاع المواد,متناهية الصغر,6,2,2,0,12,12,0
2022,2,منطقة عسير,أنشطة جمع النفايات ومعالجتها وتصريفها ، واسترجاع المواد,صغيرة,2,2,1,1,11,11,0
2022,2,منطقة عسير,أنشطة جمع النفايات ومعالجتها وتصريفها ، واسترجاع المواد,متناهية الصغر,10,2,2,0,21,21,0
2022,2,منطقة عسير,أنشطة جمع النفايات ومعالجتها وتصريفها ، واسترجاع المواد,متوسطة,3,214,143,71,296,296,0
2022,2,منطقة مكة المكرمة,أنشطة جمع النفايات ومعالجتها وتصريفها ، واسترجاع المواد,صغيرة,39,145,76,69,511,501,10
2022,2,منطقة مكة المكرمة,أنشطة جمع النفايات ومعالجتها وتصريفها ، واسترجاع المواد,كبيرة,4,1686,732,954,7754,7698,56
2022,2,منطقة مكة المكرمة,أنشطة جمع النفايات ومعالجتها وتصريفها ، واسترجاع المواد,متناهية الصغر,67,40,21,19,114,112,2
2022,2,منطقة مكة المكرمة,أنشطة جمع النفايات ومعالجتها وتصريفها ، واسترجاع المواد,متوسطة,1,10,10,0,40,40,0
2022,2,منطقة نجران,أنشطة جمع النفايات ومعالجتها وتصريفها ، واسترجاع المواد,صغيرة,4,5,3,2,28,28,0
2022,2,منطقة نجران,أنشطة جمع النفايات ومعالجتها وتصريفها ، واسترجاع المواد,متناهية الصغر,9,2,1,1,25,25,0
2022,2,المنطقة الشرقية,أنشطة تقديم الخدمات للمباني وتجميل المواقع,صغيرة,536,1841,1059,782,6756,6684,72
2022,2,المنطقة الشرقية,أنشطة تقديم الخدمات للمباني وتجميل المواقع,كبيرة,62,12982,9139,3843,43717,42589,1128
2022,2,المنطقة الشرقية,أنشطة تقديم الخدمات للمباني وتجميل المواقع,متناهية الصغر,1270,441,218,223,2668,2652,16
2022,2,المنطقة الشرقية,أنشطة تقديم الخدمات للمباني وتجميل المواقع,متوسطة,142,3271,2166,1105,12258,12069,189
2022,2,منطقة الباحة,أنشطة تقديم الخدمات للمباني وتجميل المواقع,صغيرة,10,35,30,5,115,115,0
2022,2,منطقة الباحة,أنشطة تقديم الخدمات للمباني وتجميل المواقع,متناهية الصغر,54,15,9,6,106,106,0
2022,2,منطقة الباحة,أنشطة تقديم الخدمات للمباني وتجميل المواقع,متوسطة,2,44,34,10,95,94,1
2022,2,منطقة الجوف,أنشطة تقديم الخدمات للمباني وتجميل المواقع,صغيرة,36,64,46,18,342,341,1
2022,2,منطقة الجوف,أنشطة تقديم الخدمات للمباني وتجميل المواقع,متناهية الصغر,206,36,21,15,473,471,2
2022,2,منطقة الجوف,أنشطة تقديم الخدمات للمباني وتجميل المواقع,متوسطة,6,107,35,72,256,256,0
2022,2,منطقة الحدود الشمالية,أنشطة تقديم الخدمات للمباني وتجميل المواقع,صغيرة,11,35,11,24,100,100,0
2022,2,منطقة الحدود الشمالية,أنشطة تقديم الخدمات للمباني وتجميل المواقع,كبيرة,1,210,110,100,539,519,20
2022,2,منطقة الحدود الشمالية,أنشطة تقديم الخدمات للمباني وتجميل المواقع,متناهية الصغر,85,12,7,5,203,203,0
2022,2,منطقة الحدود الشمالية,أنشطة تقديم الخدمات للمباني وتجميل المواقع,متوسطة,2,63,49,14,164,164,0
2022,2,منطقة الرياض,أنشطة تقديم الخدمات للمباني وتجميل المواقع,صغيرة,1420,4042,1976,2066,19338,19014,324
2022,2,منطقة الرياض,أنشطة تقديم الخدمات للمباني وتجميل المواقع,كبيرة,158,35529,21323,14206,163084,151931,11153
2022,2,منطقة الرياض,أنشطة تقديم الخدمات للمباني وتجميل المواقع,متناهية الصغر,3775,1173,574,599,8094,8006,88
2022,2,منطقة الرياض,أنشطة تقديم الخدمات للمباني وتجميل المواقع,متوسطة,444,8836,4543,4293,40163,39317,846
2022,2,منطقة القصيم,أنشطة تقديم الخدمات للمباني وتجميل المواقع,صغيرة,209,389,200,189,3402,3387,15
2022,2,منطقة القصيم,أنشطة تقديم الخدمات للمباني وتجميل المواقع,كبيرة,28,1727,773,954,11427,11089,338
2022,2,منطقة القصيم,أنشطة تقديم الخدمات للمباني وتجميل المواقع,متناهية الصغر,1093,200,111,89,2717,2702,15
2022,2,منطقة القصيم,أنشطة تقديم الخدمات للمباني وتجميل المواقع,متوسطة,124,1530,853,677,14237,14094,143
2022,2,منطقة المدينة المنورة,أنشطة تقديم الخدمات للمباني وتجميل المواقع,صغيرة,170,449,283,166,1943,1922,21
2022,2,منطقة المدينة المنورة,أنشطة تقديم الخدمات للمباني وتجميل المواقع,كبيرة,3,123,60,63,1099,1081,18
2022,2,منطقة المدينة المنورة,أنشطة تقديم الخدمات للمباني وتجميل المواقع,متناهية الصغر,722,154,97,57,1626,1609,17
2022,2,منطقة المدينة المنورة,أنشطة تقديم الخدمات للمباني وتجميل المواقع,متوسطة,26,659,523,136,1876,1872,4
2022,2,منطقة تبوك,أنشطة تقديم الخدمات للمباني وتجميل المواقع,صغيرة,40,131,59,72,371,371,0
2022,2,منطقة تبوك,أنشطة تقديم الخدمات للمباني وتجميل المواقع,كبيرة,2,1618,1551,67,1607,1556,51
2022,2,منطقة تبوك,أنشطة تقديم الخدمات للمباني وتجميل المواقع,متناهية الصغر,288,61,33,28,696,693,3
2022,2,منطقة تبوك,أنشطة تقديم الخدمات للمباني وتجميل المواقع,متوسطة,9,169,56,113,794,793,1
2022,2,منطقة جازان,أنشطة تقديم الخدمات للمباني وتجميل المواقع,صغيرة,42,130,61,69,438,426,12
2022,2,منطقة جازان,أنشطة تقديم الخدمات للمباني وتجميل المواقع,متناهية الصغر,316,57,33,24,814,812,2
2022,2,منطقة جازان,أنشطة تقديم الخدمات للمباني وتجميل المواقع,متوسطة,4,84,40,44,496,483,13
2022,2,منطقة حائل,أنشطة تقديم الخدمات للمباني وتجميل المواقع,صغيرة,44,106,52,54,540,534,6
2022,2,منطقة حائل,أنشطة تقديم الخدمات للمباني وتجميل المواقع,كبيرة,2,807,549,258,1278,1183,95
2022,2,منطقة حائل,أنشطة تقديم الخدمات للمباني وتجميل المواقع,متناهية الصغر,308,60,31,29,712,710,2
2022,2,منطقة حائل,أنشطة تقديم الخدمات للمباني وتجميل المواقع,متوسطة,13,229,130,99,988,962,26
2022,2,منطقة عسير,أنشطة تقديم الخدمات للمباني وتجميل المواقع,صغيرة,81,252,159,93,979,952,27
2022,2,منطقة عسير,أنشطة تقديم الخدمات للمباني وتجميل المواقع,كبيرة,5,1670,1363,307,4717,4662,55
2022,2,منطقة عسير,أنشطة تقديم الخدمات للمباني وتجميل المواقع,متناهية الصغر,496,106,58,48,1188,1182,6
2022,2,منطقة عسير,أنشطة تقديم الخدمات للمباني وتجميل المواقع,متوسطة,12,215,140,75,1115,1109,6
2022,2,منطقة مكة المكرمة,أنشطة تقديم الخدمات للمباني وتجميل المواقع,صغيرة,916,2767,1417,1350,11879,11631,248
2022,2,منطقة مكة المكرمة,أنشطة تقديم الخدمات للمباني وتجميل المواقع,كبيرة,48,7503,5093,2410,33096,32173,923
2022,2,منطقة مكة المكرمة,أنشطة تقديم الخدمات للمباني وتجميل المواقع,متناهية الصغر,2800,870,471,399,6543,6440,103
2022,2,منطقة مكة المكرمة,أنشطة تقديم الخدمات للمباني وتجميل المواقع,متوسطة,214,5318,2869,2449,18455,17901,554
2022,2,منطقة نجران,أنشطة تقديم الخدمات للمباني وتجميل المواقع,صغيرة,47,103,63,40,762,760,2
2022,2,منطقة نجران,أنشطة تقديم الخدمات للمباني وتجميل المواقع,كبيرة,8,1602,1070,532,8054,7996,58
2022,2,منطقة نجران,أنشطة تقديم الخدمات للمباني وتجميل المواقع,متناهية الصغر,193,41,23,18,425,414,11
2022,2,منطقة نجران,أنشطة تقديم الخدمات للمباني وتجميل المواقع,متوسطة,16,401,316,85,1189,1162,27
2022,2,المنطقة الشرقية,أنشطة النشر,صغيرة,26,118,71,47,204,202,2
2022,2,المنطقة الشرقية,أنشطة النشر,متناهية الصغر,66,43,20,23,119,117,2
2022,2,المنطقة الشرقية,أنشطة النشر,متوسطة,2,120,104,16,139,139,0
2022,2,منطقة الباحة,أنشطة النشر,صغيرة,1,4,3,1,13,13,0
2022,2,منطقة الباحة,أنشطة النشر,متناهية الصغر,6,3,3,0,13,13,0
2022,2,منطقة الجوف,أنشطة النشر,متناهية الصغر,2,0,0,0,3,3,0
2022,2,منطقة الحدود الشمالية,أنشطة النشر,متناهية الصغر,3,1,0,1,3,3,0
2022,2,منطقة الرياض,أنشطة النشر,صغيرة,52,341,159,182,447,441,6
2022,2,منطقة الرياض,أنشطة النشر,كبيرة,3,650,247,403,1289,1268,21
2022,2,منطقة الرياض,أنشطة النشر,متناهية الصغر,166,123,58,65,228,227,1
2022,2,منطقة الرياض,أنشطة النشر,متوسطة,12,483,272,211,669,651,18
2022,2,منطقة القصيم,أنشطة النشر,صغيرة,2,3,2,1,17,17,0
2022,2,منطقة القصيم,أنشطة النشر,متناهية الصغر,5,0,0,0,10,10,0
2022,2,منطقة القصيم,أنشطة النشر,متوسطة,1,0,0,0,105,105,0
2022,2,منطقة المدينة المنورة,أنشطة النشر,صغيرة,4,8,4,4,18,18,0
2022,2,منطقة المدينة المنورة,أنشطة النشر,متناهية الصغر,14,4,3,1,24,24,0
2022,2,منطقة تبوك,أنشطة النشر,متناهية الصغر,2,0,0,0,4,4,0
2022,2,منطقة جازان,أنشطة النشر,متناهية الصغر,6,1,0,1,8,8,0
2022,2,منطقة حائل,أنشطة النشر,صغيرة,1,4,1,3,10,10,0
2022,2,منطقة حائل,أنشطة النشر,متناهية الصغر,31,2,1,1,92,92,0
2022,2,منطقة عسير,أنشطة النشر,صغيرة,2,1,1,0,12,12,0
2022,2,منطقة عسير,أنشطة النشر,متناهية الصغر,8,4,4,0,17,17,0
2022,2,منطقة عسير,أنشطة النشر,متوسطة,1,25,15,10,63,63,0
2022,2,منطقة مكة المكرمة,أنشطة النشر,صغيرة,16,70,34,36,214,212,2
2022,2,منطقة مكة المكرمة,أنشطة النشر,متناهية الصغر,92,51,23,28,159,158,1
2022,2,منطقة مكة المكرمة,أنشطة النشر,متوسطة,3,94,73,21,192,183,9
2022,2,منطقة نجران,أنشطة النشر,متناهية الصغر,4,1,1,0,10,10,0
2022,2,منطقة نجران,أنشطة النشر,متوسطة,1,0,0,0,137,137,0
2022,2,المنطقة الشرقية,أنشطة المنظمات ذات العضوية,صغيرة,23,216,82,134,136,136,0
2022,2,المنطقة الشرقية,أنشطة المنظمات ذات العضوية,متناهية الصغر,68,61,34,27,96,91,5
2022,2,المنطقة الشرقية,أنشطة المنظمات ذات العضوية,متوسطة,2,142,69,73,54,53,1
2022,2,منطقة الباحة,أنشطة المنظمات ذات العضوية,صغيرة,1,9,9,0,0,0,0
2022,2,منطقة الباحة,أنشطة المنظمات ذات العضوية,متناهية الصغر,12,18,15,3,4,4,0
2022,2,منطقة الجوف,أنشطة المنظمات ذات العضوية,صغيرة,5,47,41,6,26,25,1
2022,2,منطقة الجوف,أنشطة المنظمات ذات العضوية,متناهية الصغر,25,29,17,12,29,29,0
2022,2,منطقة الحدود الشمالية,أنشطة المنظمات ذات العضوية,صغيرة,1,29,25,4,15,12,3
2022,2,منطقة الحدود الشمالية,أنشطة المنظمات ذات العضوية,متناهية الصغر,6,7,6,1,4,4,0
2022,2,منطقة الرياض,أنشطة المنظمات ذات العضوية,صغيرة,104,807,468,339,690,674,16
2022,2,منطقة الرياض,أنشطة المنظمات ذات العضوية,كبيرة,10,11991,7605,4386,2098,1140,958
2022,2,منطقة الرياض,أنشطة المنظمات ذات العضوية,متناهية الصغر,2005,336,183,153,4109,4052,57
2022,2,منطقة الرياض,أنشطة المنظمات ذات العضوية,متوسطة,21,2407,1647,760,315,260,55
2022,2,منطقة القصيم,أنشطة المنظمات ذات العضوية,صغيرة,12,104,74,30,45,43,2
2022,2,منطقة القصيم,أنشطة المنظمات ذات العضوية,متناهية الصغر,71,60,48,12,114,114,0
2022,2,منطقة المدينة المنورة,أنشطة المنظمات ذات العضوية,صغيرة,8,44,40,4,60,59,1
2022,2,منطقة المدينة المنورة,أنشطة المنظمات ذات العضوية,كبيرة,1,278,266,12,15,15,0
2022,2,منطقة المدينة المنورة,أنشطة المنظمات ذات العضوية,متناهية الصغر,64,25,18,7,115,112,3
2022,2,منطقة المدينة المنورة,أنشطة المنظمات ذات العضوية,متوسطة,1,42,22,20,42,41,1
2022,2,منطقة تبوك,أنشطة المنظمات ذات العضوية,صغيرة,7,98,48,50,21,20,1
2022,2,منطقة تبوك,أنشطة المنظمات ذات العضوية,متناهية الصغر,16,13,7,6,13,13,0
2022,2,منطقة تبوك,أنشطة المنظمات ذات العضوية,متوسطة,2,103,49,54,103,102,1
2022,2,منطقة جازان,أنشطة المنظمات ذات العضوية,صغيرة,8,109,49,60,26,25,1
2022,2,منطقة جازان,أنشطة المنظمات ذات العضوية,متناهية الصغر,111,44,26,18,179,174,5
2022,2,منطقة جازان,أنشطة المنظمات ذات العضوية,متوسطة,1,37,35,2,13,13,0
2022,2,منطقة حائل,أنشطة المنظمات ذات العضوية,صغيرة,4,23,12,11,16,16,0
2022,2,منطقة حائل,أنشطة المنظمات ذات العضوية,متناهية الصغر,19,14,6,8,24,24,0
2022,2,منطقة حائل,أنشطة المنظمات ذات العضوية,متوسطة,1,75,63,12,0,0,0
2022,2,منطقة عسير,أنشطة المنظمات ذات العضوية,صغيرة,7,50,25,25,36,31,5
2022,2,منطقة عسير,أنشطة المنظمات ذات العضوية,متناهية الصغر,43,51,39,12,38,37,1
2022,2,منطقة عسير,أنشطة المنظمات ذات العضوية,متوسطة,1,48,12,36,30,29,1
2022,2,منطقة مكة المكرمة,أنشطة المنظمات ذات العضوية,صغيرة,39,228,153,75,319,316,3
2022,2,منطقة مكة المكرمة,أنشطة المنظمات ذات العضوية,كبيرة,1,410,189,221,76,76,0
2022,2,منطقة مكة المكرمة,أنشطة المنظمات ذات العضوية,متناهية الصغر,251,180,118,62,365,353,12
2022,2,منطقة مكة المكرمة,أنشطة المنظمات ذات العضوية,متوسطة,4,527,354,173,34,26,8
2022,2,منطقة نجران,أنشطة المنظمات ذات العضوية,صغيرة,1,45,43,2,4,4,0
2022,2,منطقة نجران,أنشطة المنظمات ذات العضوية,متناهية الصغر,34,21,13,8,55,54,1
2022,2,المنطقة الشرقية,أنشطة المكتبات والمحفوظات والمتاحف والأنشطة الثقافية الأخرى,صغيرة,10,31,17,14,103,102,1
2022,2,المنطقة الشرقية,أنشطة المكتبات والمحفوظات والمتاحف والأنشطة الثقافية الأخرى,متناهية الصغر,34,9,5,4,57,56,1
2022,2,منطقة الباحة,أنشطة المكتبات والمحفوظات والمتاحف والأنشطة الثقافية الأخرى,متناهية الصغر,4,1,0,1,8,8,0
2022,2,منطقة الجوف,أنشطة المكتبات والمحفوظات والمتاحف والأنشطة الثقافية الأخرى,متناهية الصغر,1,0,0,0,1,1,0
2022,2,منطقة الحدود الشمالية,أنشطة المكتبات والمحفوظات والمتاحف والأنشطة الثقافية الأخرى,متناهية الصغر,4,0,0,0,6,6,0
2022,2,منطقة الرياض,أنشطة المكتبات والمحفوظات والمتاحف والأنشطة الثقافية الأخرى,صغيرة,7,29,15,14,61,59,2
2022,2,منطقة الرياض,أنشطة المكتبات والمحفوظات والمتاحف والأنشطة الثقافية الأخرى,متناهية الصغر,26,13,4,9,44,43,1
2022,2,منطقة الرياض,أنشطة المكتبات والمحفوظات والمتاحف والأنشطة الثقافية الأخرى,متوسطة,1,70,47,23,0,0,0
2022,2,منطقة القصيم,أنشطة المكتبات والمحفوظات والمتاحف والأنشطة الثقافية الأخرى,صغيرة,3,6,5,1,14,14,0
2022,2,منطقة القصيم,أنشطة المكتبات والمحفوظات والمتاحف والأنشطة الثقافية الأخرى,متناهية الصغر,9,2,1,1,17,17,0
2022,2,منطقة المدينة المنورة,أنشطة المكتبات والمحفوظات والمتاحف والأنشطة الثقافية الأخرى,صغيرة,5,13,10,3,34,34,0
2022,2,منطقة المدينة المنورة,أنشطة المكتبات والمحفوظات والمتاحف والأنشطة الثقافية الأخرى,متناهية الصغر,34,18,12,6,67,67,0
2022,2,منطقة تبوك,أنشطة المكتبات والمحفوظات والمتاحف والأنشطة الثقافية الأخرى,صغيرة,3,6,4,2,20,20,0
2022,2,منطقة تبوك,أنشطة المكتبات والمحفوظات والمتاحف والأنشطة الثقافية الأخرى,متناهية الصغر,9,3,3,0,23,23,0
2022,2,منطقة جازان,أنشطة المكتبات والمحفوظات والمتاحف والأنشطة الثقافية الأخرى,صغيرة,2,2,1,1,19,19,0
2022,2,منطقة جازان,أنشطة المكتبات والمحفوظات والمتاحف والأنشطة الثقافية الأخرى,متناهية الصغر,13,0,0,0,31,31,0
2022,2,منطقة حائل,أنشطة المكتبات والمحفوظات والمتاحف والأنشطة الثقافية الأخرى,متناهية الصغر,4,0,0,0,5,5,0
2022,2,منطقة عسير,أنشطة المكتبات والمحفوظات والمتاحف والأنشطة الثقافية الأخرى,صغيرة,3,8,8,0,18,18,0
2022,2,منطقة عسير,أنشطة المكتبات والمحفوظات والمتاحف والأنشطة الثقافية الأخرى,متناهية الصغر,14,4,2,2,20,20,0
2022,2,منطقة مكة المكرمة,أنشطة المكتبات والمحفوظات والمتاحف والأنشطة الثقافية الأخرى,صغيرة,9,13,8,5,86,84,2
2022,2,منطقة مكة المكرمة,أنشطة المكتبات والمحفوظات والمتاحف والأنشطة الثقافية الأخرى,متناهية الصغر,90,27,17,10,164,159,5
2022,2,منطقة مكة المكرمة,أنشطة المكتبات والمحفوظات والمتاحف والأنشطة الثقافية الأخرى,متوسطة,1,17,10,7,86,86,0
2022,2,منطقة نجران,أنشطة المكتبات والمحفوظات والمتاحف والأنشطة الثقافية الأخرى,متناهية الصغر,6,0,0,0,18,18,0
2022,2,المنطقة الشرقية,أنشطة المكاتب الرئيسية، والأنشطة الاستشارية في مجال الإدارة,صغيرة,38,227,128,99,350,341,9
2022,2,المنطقة الشرقية,أنشطة المكاتب الرئيسية، والأنشطة الاستشارية في مجال الإدارة,متناهية الصغر,108,105,63,42,136,130,6
2022,2,المنطقة الشرقية,أنشطة المكاتب الرئيسية، والأنشطة الاستشارية في مجال الإدارة,متوسطة,7,260,166,94,305,294,11
2022,2,منطقة الباحة,أنشطة المكاتب الرئيسية، والأنشطة الاستشارية في مجال الإدارة,صغيرة,1,2,2,0,6,6,0
2022,2,منطقة الباحة,أنشطة المكاتب الرئيسية، والأنشطة الاستشارية في مجال الإدارة,متناهية الصغر,2,1,0,1,3,3,0
2022,2,منطقة الجوف,أنشطة المكاتب الرئيسية، والأنشطة الاستشارية في مجال الإدارة,كبيرة,1,69,9,60,190,140,50
2022,2,منطقة الجوف,أنشطة المكاتب الرئيسية، والأنشطة الاستشارية في مجال الإدارة,متناهية الصغر,1,1,1,0,1,1,0
2022,2,منطقة الحدود الشمالية,أنشطة المكاتب الرئيسية، والأنشطة الاستشارية في مجال الإدارة,صغيرة,1,6,4,2,6,6,0
2022,2,منطقة الحدود الشمالية,أنشطة المكاتب الرئيسية، والأنشطة الاستشارية في مجال الإدارة,متناهية الصغر,3,1,0,1,6,6,0
2022,2,منطقة الرياض,أنشطة المكاتب الرئيسية، والأنشطة الاستشارية في مجال الإدارة,صغيرة,208,1580,851,729,1689,1539,150
2022,2,منطقة الرياض,أنشطة المكاتب الرئيسية، والأنشطة الاستشارية في مجال الإدارة,كبيرة,12,10449,6349,4100,3442,3271,171
2022,2,منطقة الرياض,أنشطة المكاتب الرئيسية، والأنشطة الاستشارية في مجال الإدارة,متناهية الصغر,623,592,291,301,870,825,45
2022,2,منطقة الرياض,أنشطة المكاتب الرئيسية، والأنشطة الاستشارية في مجال الإدارة,متوسطة,28,1669,1045,624,1645,1579,66
2022,2,منطقة القصيم,أنشطة المكاتب الرئيسية، والأنشطة الاستشارية في مجال الإدارة,صغيرة,4,11,8,3,45,45,0
2022,2,منطقة القصيم,أنشطة المكاتب الرئيسية، والأنشطة الاستشارية في مجال الإدارة,كبيرة,1,395,283,112,886,886,0
2022,2,منطقة القصيم,أنشطة المكاتب الرئيسية، والأنشطة الاستشارية في مجال الإدارة,متناهية الصغر,16,11,8,3,24,24,0
2022,2,منطقة المدينة المنورة,أنشطة المكاتب الرئيسية، والأنشطة الاستشارية في مجال الإدارة,صغيرة,4,9,6,3,20,20,0
2022,2,منطقة المدينة المنورة,أنشطة المكاتب الرئيسية، والأنشطة الاستشارية في مجال الإدارة,متناهية الصغر,30,14,6,8,38,38,0
2022,2,منطقة المدينة المنورة,أنشطة المكاتب الرئيسية، والأنشطة الاستشارية في مجال الإدارة,متوسطة,1,127,91,36,1,1,0
2022,2,منطقة تبوك,أنشطة المكاتب الرئيسية، والأنشطة الاستشارية في مجال الإدارة,متناهية الصغر,3,2,1,1,1,1,0
2022,2,منطقة جازان,أنشطة المكاتب الرئيسية، والأنشطة الاستشارية في مجال الإدارة,صغيرة,1,11,5,6,0,0,0
2022,2,منطقة جازان,أنشطة المكاتب الرئيسية، والأنشطة الاستشارية في مجال الإدارة,متناهية الصغر,6,8,0,8,13,13,0
2022,2,منطقة جازان,أنشطة المكاتب الرئيسية، والأنشطة الاستشارية في مجال الإدارة,متوسطة,1,28,20,8,42,42,0
2022,2,منطقة حائل,أنشطة المكاتب الرئيسية، والأنشطة الاستشارية في مجال الإدارة,متناهية الصغر,8,2,2,0,19,19,0
2022,2,منطقة عسير,أنشطة المكاتب الرئيسية، والأنشطة الاستشارية في مجال الإدارة,متناهية الصغر,16,8,3,5,24,23,1
2022,2,منطقة مكة المكرمة,أنشطة المكاتب الرئيسية، والأنشطة الاستشارية في مجال الإدارة,صغيرة,75,385,214,171,556,524,32
2022,2,منطقة مكة المكرمة,أنشطة المكاتب الرئيسية، والأنشطة الاستشارية في مجال الإدارة,كبيرة,1,644,321,323,864,817,47
2022,2,منطقة مكة المكرمة,أنشطة المكاتب الرئيسية، والأنشطة الاستشارية في مجال الإدارة,متناهية الصغر,228,184,96,88,313,295,18
2022,2,منطقة مكة المكرمة,أنشطة المكاتب الرئيسية، والأنشطة الاستشارية في مجال الإدارة,متوسطة,3,98,61,37,249,229,20
2022,2,منطقة نجران,أنشطة المكاتب الرئيسية، والأنشطة الاستشارية في مجال الإدارة,متناهية الصغر,4,2,0,2,15,15,0
2022,2,المنطقة الشرقية,أنشطة المعمارية والهندسية ، والاختبارات الفنية والتحليل,صغيرة,237,1452,939,513,2216,2184,32
2022,2,المنطقة الشرقية,أنشطة المعمارية والهندسية ، والاختبارات الفنية والتحليل,كبيرة,24,5302,4356,946,6803,6782,21
2022,2,المنطقة الشرقية,أنشطة المعمارية والهندسية ، والاختبارات الفنية والتحليل,متناهية الصغر,438,359,201,158,704,698,6
2022,2,المنطقة الشرقية,أنشطة المعمارية والهندسية ، والاختبارات الفنية والتحليل,متوسطة,69,2701,2057,644,4368,4347,21
2022,2,منطقة الباحة,أنشطة المعمارية والهندسية ، والاختبارات الفنية والتحليل,صغيرة,16,50,28,22,165,165,0
2022,2,منطقة الباحة,أنشطة المعمارية والهندسية ، والاختبارات الفنية والتحليل,متناهية الصغر,95,20,13,7,195,195,0
2022,2,منطقة الباحة,أنشطة المعمارية والهندسية ، والاختبارات الفنية والتحليل,متوسطة,1,24,15,9,58,58,0
2022,2,منطقة الجوف,أنشطة المعمارية والهندسية ، والاختبارات الفنية والتحليل,صغيرة,17,40,27,13,162,161,1
2022,2,منطقة الجوف,أنشطة المعمارية والهندسية ، والاختبارات الفنية والتحليل,متناهية الصغر,96,38,22,16,174,174,0
2022,2,منطقة الجوف,أنشطة المعمارية والهندسية ، والاختبارات الفنية والتحليل,متوسطة,1,15,12,3,38,38,0
2022,2,منطقة الحدود الشمالية,أنشطة المعمارية والهندسية ، والاختبارات الفنية والتحليل,صغيرة,8,31,15,16,59,59,0
2022,2,منطقة الحدود الشمالية,أنشطة المعمارية والهندسية ، والاختبارات الفنية والتحليل,متناهية الصغر,62,14,6,8,132,131,1
2022,2,منطقة الرياض,أنشطة المعمارية والهندسية ، والاختبارات الفنية والتحليل,صغيرة,474,2615,1539,1076,4476,4395,81
2022,2,منطقة الرياض,أنشطة المعمارية والهندسية ، والاختبارات الفنية والتحليل,كبيرة,24,5250,3860,1390,7023,6961,62
2022,2,منطقة الرياض,أنشطة المعمارية والهندسية ، والاختبارات الفنية والتحليل,متناهية الصغر,2841,918,480,438,5277,5232,45
2022,2,منطقة الرياض,أنشطة المعمارية والهندسية ، والاختبارات الفنية والتحليل,متوسطة,106,4905,3191,1714,7042,6947,95
2022,2,منطقة القصيم,أنشطة المعمارية والهندسية ، والاختبارات الفنية والتحليل,صغيرة,35,142,101,41,369,367,2
2022,2,منطقة القصيم,أنشطة المعمارية والهندسية ، والاختبارات الفنية والتحليل,متناهية الصغر,173,67,49,18,315,315,0
2022,2,منطقة القصيم,أنشطة المعمارية والهندسية ، والاختبارات الفنية والتحليل,متوسطة,6,181,139,42,315,314,1
2022,2,منطقة المدينة المنورة,أنشطة المعمارية والهندسية ، والاختبارات الفنية والتحليل,صغيرة,69,320,181,139,619,614,5
2022,2,منطقة المدينة المنورة,أنشطة المعمارية والهندسية ، والاختبارات الفنية والتحليل,متناهية الصغر,125,57,31,26,223,221,2
2022,2,منطقة المدينة المنورة,أنشطة المعمارية والهندسية ، والاختبارات الفنية والتحليل,متوسطة,5,288,205,83,354,353,1
2022,2,منطقة تبوك,أنشطة المعمارية والهندسية ، والاختبارات الفنية والتحليل,صغيرة,25,106,59,47,207,204,3
2022,2,منطقة تبوك,أنشطة المعمارية والهندسية ، والاختبارات الفنية والتحليل,متناهية الصغر,64,40,27,13,117,117,0
2022,2,منطقة تبوك,أنشطة المعمارية والهندسية ، والاختبارات الفنية والتحليل,متوسطة,1,30,19,11,30,30,0
2022,2,منطقة جازان,أنشطة المعمارية والهندسية ، والاختبارات الفنية والتحليل,صغيرة,15,75,48,27,125,123,2
2022,2,منطقة جازان,أنشطة المعمارية والهندسية ، والاختبارات الفنية والتحليل,متناهية الصغر,103,48,30,18,184,180,4
2022,2,منطقة جازان,أنشطة المعمارية والهندسية ، والاختبارات الفنية والتحليل,متوسطة,1,35,17,18,59,59,0
2022,2,منطقة حائل,أنشطة المعمارية والهندسية ، والاختبارات الفنية والتحليل,صغيرة,14,58,33,25,180,179,1
2022,2,منطقة حائل,أنشطة المعمارية والهندسية ، والاختبارات الفنية والتحليل,متناهية الصغر,148,36,27,9,295,294,1
2022,2,منطقة حائل,أنشطة المعمارية والهندسية ، والاختبارات الفنية والتحليل,متوسطة,1,48,38,10,61,61,0
2022,2,منطقة عسير,أنشطة المعمارية والهندسية ، والاختبارات الفنية والتحليل,صغيرة,48,186,122,64,330,325,5
2022,2,منطقة عسير,أنشطة المعمارية والهندسية ، والاختبارات الفنية والتحليل,متناهية الصغر,205,124,81,43,362,360,2
2022,2,منطقة عسير,أنشطة المعمارية والهندسية ، والاختبارات الفنية والتحليل,متوسطة,2,56,49,7,111,110,1
2022,2,منطقة مكة المكرمة,أنشطة المعمارية والهندسية ، والاختبارات الفنية والتحليل,صغيرة,376,1648,960,688,3250,3208,42
2022,2,منطقة مكة المكرمة,أنشطة المعمارية والهندسية ، والاختبارات الفنية والتحليل,كبيرة,10,1320,874,446,2518,2499,19
2022,2,منطقة مكة المكرمة,أنشطة المعمارية والهندسية ، والاختبارات الفنية والتحليل,متناهية الصغر,870,517,300,217,1478,1449,29
2022,2,منطقة مكة المكرمة,أنشطة المعمارية والهندسية ، والاختبارات الفنية والتحليل,متوسطة,27,840,537,303,1614,1601,13
2022,2,منطقة نجران,أنشطة المعمارية والهندسية ، والاختبارات الفنية والتحليل,صغيرة,13,54,43,11,118,118,0
2022,2,منطقة نجران,أنشطة المعمارية والهندسية ، والاختبارات الفنية والتحليل,متناهية الصغر,139,30,21,9,270,270,0
2022,2,منطقة نجران,أنشطة المعمارية والهندسية ، والاختبارات الفنية والتحليل,متوسطة,1,23,17,6,77,77,0
2022,2,المنطقة الشرقية,أنشطة المعالجة وخدمات إدارة النفايات الأخرى,صغيرة,5,29,21,8,108,108,0
2022,2,المنطقة الشرقية,أنشطة المعالجة وخدمات إدارة النفايات الأخرى,متناهية الصغر,5,4,3,1,6,6,0
2022,2,منطقة الرياض,أنشطة المعالجة وخدمات إدارة النفايات الأخرى,صغيرة,2,31,30,1,22,22,0
2022,2,منطقة الرياض,أنشطة المعالجة وخدمات إدارة النفايات الأخرى,كبيرة,1,2065,1545,520,579,579,0
2022,2,منطقة الرياض,أنشطة المعالجة وخدمات إدارة النفايات الأخرى,متناهية الصغر,3,2,1,1,7,7,0
2022,2,منطقة مكة المكرمة,أنشطة المعالجة وخدمات إدارة النفايات الأخرى,صغيرة,1,4,2,2,19,19,0
2022,2,منطقة مكة المكرمة,أنشطة المعالجة وخدمات إدارة النفايات الأخرى,متناهية الصغر,2,2,1,1,3,3,0
2022,2,منطقة نجران,أنشطة المعالجة وخدمات إدارة النفايات الأخرى,صغيرة,1,1,0,1,18,18,0
2022,2,المنطقة الشرقية,أنشطة العمل الاجتماعي، دون إقامة,صغيرة,154,1667,324,1343,449,373,76
2022,2,المنطقة الشرقية,أنشطة العمل الاجتماعي، دون إقامة,كبيرة,2,293,138,155,357,254,103
2022,2,المنطقة الشرقية,أنشطة العمل الاجتماعي، دون إقامة,متناهية الصغر,190,335,55,280,130,111,19
2022,2,المنطقة الشرقية,أنشطة العمل الاجتماعي، دون إقامة,متوسطة,13,807,269,538,268,190,78
2022,2,منطقة الباحة,أنشطة العمل الاجتماعي، دون إقامة,صغيرة,22,201,119,82,60,56,4
2022,2,منطقة الباحة,أنشطة العمل الاجتماعي، دون إقامة,متناهية الصغر,43,94,75,19,41,41,0
2022,2,منطقة الجوف,أنشطة العمل الاجتماعي، دون إقامة,صغيرة,21,182,102,80,112,106,6
2022,2,منطقة الجوف,أنشطة العمل الاجتماعي، دون إقامة,متناهية الصغر,22,46,24,22,12,12,0
2022,2,منطقة الحدود الشمالية,أنشطة العمل الاجتماعي، دون إقامة,صغيرة,12,104,47,57,34,32,2
2022,2,منطقة الحدود الشمالية,أنشطة العمل الاجتماعي، دون إقامة,متناهية الصغر,22,37,23,14,24,24,0
2022,2,منطقة الرياض,أنشطة العمل الاجتماعي، دون إقامة,صغيرة,263,2463,714,1749,1445,1259,186
2022,2,منطقة الرياض,أنشطة العمل الاجتماعي، دون إقامة,كبيرة,9,3668,2083,1585,1655,1318,337
2022,2,منطقة الرياض,أنشطة العمل الاجتماعي، دون إقامة,متناهية الصغر,407,556,223,333,439,395,44
2022,2,منطقة الرياض,أنشطة العمل الاجتماعي، دون إقامة,متوسطة,33,2688,1482,1206,1065,937,128
2022,2,منطقة القصيم,أنشطة العمل الاجتماعي، دون إقامة,صغيرة,68,696,329,367,328,305,23
2022,2,منطقة القصيم,أنشطة العمل الاجتماعي، دون إقامة,متناهية الصغر,84,136,85,51,91,89,2
2022,2,منطقة القصيم,أنشطة العمل الاجتماعي، دون إقامة,متوسطة,5,316,145,171,176,136,40
2022,2,منطقة المدينة المنورة,أنشطة العمل الاجتماعي، دون إقامة,صغيرة,70,732,376,356,264,215,49
2022,2,منطقة المدينة المنورة,أنشطة العمل الاجتماعي، دون إقامة,كبيرة,1,552,327,225,24,16,8
2022,2,منطقة المدينة المنورة,أنشطة العمل الاجتماعي، دون إقامة,متناهية الصغر,150,282,170,112,121,112,9
2022,2,منطقة المدينة المنورة,أنشطة العمل الاجتماعي، دون إقامة,متوسطة,8,441,256,185,249,227,22
2022,2,منطقة تبوك,أنشطة العمل الاجتماعي، دون إقامة,صغيرة,11,94,45,49,26,22,4
2022,2,منطقة تبوك,أنشطة العمل الاجتماعي، دون إقامة,متناهية الصغر,37,90,59,31,18,18,0
2022,2,منطقة تبوك,أنشطة العمل الاجتماعي، دون إقامة,متوسطة,1,70,61,9,155,154,1
2022,2,منطقة جازان,أنشطة العمل الاجتماعي، دون إقامة,صغيرة,24,179,120,59,56,53,3
2022,2,منطقة جازان,أنشطة العمل الاجتماعي، دون إقامة,متناهية الصغر,63,100,69,31,54,53,1
2022,2,منطقة جازان,أنشطة العمل الاجتماعي، دون إقامة,متوسطة,3,95,31,64,94,89,5
2022,2,منطقة حائل,أنشطة العمل الاجتماعي، دون إقامة,صغيرة,20,234,93,141,58,54,4
2022,2,منطقة حائل,أنشطة العمل الاجتماعي، دون إقامة,متناهية الصغر,66,95,64,31,69,68,1
2022,2,منطقة عسير,أنشطة العمل الاجتماعي، دون إقامة,صغيرة,57,412,203,209,337,308,29
2022,2,منطقة عسير,أنشطة العمل الاجتماعي، دون إقامة,متناهية الصغر,103,210,156,54,62,58,4
2022,2,منطقة عسير,أنشطة العمل الاجتماعي، دون إقامة,متوسطة,2,80,45,35,40,39,1
2022,2,منطقة مكة المكرمة,أنشطة العمل الاجتماعي، دون إقامة,صغيرة,235,2115,751,1364,1226,942,284
2022,2,منطقة مكة المكرمة,أنشطة العمل الاجتماعي، دون إقامة,متناهية الصغر,393,559,243,316,370,325,45
2022,2,منطقة مكة المكرمة,أنشطة العمل الاجتماعي، دون إقامة,متوسطة,22,1289,698,591,898,806,92
2022,2,منطقة نجران,أنشطة العمل الاجتماعي، دون إقامة,صغيرة,7,43,23,20,76,76,0
2022,2,منطقة نجران,أنشطة العمل الاجتماعي، دون إقامة,متناهية الصغر,34,50,32,18,42,42,0
2022,2,المنطقة الشرقية,أنشطة الخدمات المالية ، فيما عدا تمويل التأمين وصناديق المعاشات,صغيرة,84,539,338,201,741,736,5
2022,2,المنطقة الشرقية,أنشطة الخدمات المالية ، فيما عدا تمويل التأمين وصناديق المعاشات,كبيرة,2,712,433,279,143,129,14
2022,2,المنطقة الشرقية,أنشطة الخدمات المالية ، فيما عدا تمويل التأمين وصناديق المعاشات,متناهية الصغر,196,139,86,53,324,317,7
2022,2,المنطقة الشرقية,أنشطة الخدمات المالية ، فيما عدا تمويل التأمين وصناديق المعاشات,متوسطة,26,1283,827,456,1112,1094,18
2022,2,منطقة الباحة,أنشطة الخدمات المالية ، فيما عدا تمويل التأمين وصناديق المعاشات,صغيرة,1,6,3,3,15,15,0
2022,2,منطقة الباحة,أنشطة الخدمات المالية ، فيما عدا تمويل التأمين وصناديق المعاشات,متناهية الصغر,9,3,2,1,15,15,0
2022,2,منطقة الجوف,أنشطة الخدمات المالية ، فيما عدا تمويل التأمين وصناديق المعاشات,متناهية الصغر,9,4,2,2,16,16,0
2022,2,منطقة الحدود الشمالية,أنشطة الخدمات المالية ، فيما عدا تمويل التأمين وصناديق المعاشات,صغيرة,3,1,0,1,62,62,0
2022,2,منطقة الحدود الشمالية,أنشطة الخدمات المالية ، فيما عدا تمويل التأمين وصناديق المعاشات,متناهية الصغر,7,4,0,4,17,17,0
2022,2,منطقة الرياض,أنشطة الخدمات المالية ، فيما عدا تمويل التأمين وصناديق المعاشات,صغيرة,186,1525,968,557,1399,1345,54
2022,2,منطقة الرياض,أنشطة الخدمات المالية ، فيما عدا تمويل التأمين وصناديق المعاشات,كبيرة,7,7446,5548,1898,697,678,19
2022,2,منطقة الرياض,أنشطة الخدمات المالية ، فيما عدا تمويل التأمين وصناديق المعاشات,متناهية الصغر,434,419,269,150,580,567,13
2022,2,منطقة الرياض,أنشطة الخدمات المالية ، فيما عدا تمويل التأمين وصناديق المعاشات,متوسطة,39,2624,1791,833,1519,1422,97
2022,2,منطقة القصيم,أنشطة الخدمات المالية ، فيما عدا تمويل التأمين وصناديق المعاشات,صغيرة,3,39,39,0,14,14,0
2022,2,منطقة القصيم,أنشطة الخدمات المالية ، فيما عدا تمويل التأمين وصناديق المعاشات,متناهية الصغر,25,7,6,1,54,54,0
2022,2,منطقة المدينة المنورة,أنشطة الخدمات المالية ، فيما عدا تمويل التأمين وصناديق المعاشات,صغيرة,6,30,25,5,41,41,0
2022,2,منطقة المدينة المنورة,أنشطة الخدمات المالية ، فيما عدا تمويل التأمين وصناديق المعاشات,متناهية الصغر,45,30,18,12,85,81,4
2022,2,منطقة المدينة المنورة,أنشطة الخدمات المالية ، فيما عدا تمويل التأمين وصناديق المعاشات,متوسطة,1,62,48,14,53,53,0
2022,2,منطقة تبوك,أنشطة الخدمات المالية ، فيما عدا تمويل التأمين وصناديق المعاشات,متناهية الصغر,18,4,2,2,37,37,0
2022,2,منطقة جازان,أنشطة الخدمات المالية ، فيما عدا تمويل التأمين وصناديق المعاشات,صغيرة,2,11,11,0,7,7,0
2022,2,منطقة جازان,أنشطة الخدمات المالية ، فيما عدا تمويل التأمين وصناديق المعاشات,متناهية الصغر,18,1,1,0,46,46,0
2022,2,منطقة حائل,أنشطة الخدمات المالية ، فيما عدا تمويل التأمين وصناديق المعاشات,صغيرة,4,21,15,6,9,9,0
2022,2,منطقة حائل,أنشطة الخدمات المالية ، فيما عدا تمويل التأمين وصناديق المعاشات,متناهية الصغر,22,3,2,1,59,59,0
2022,2,منطقة عسير,أنشطة الخدمات المالية ، فيما عدا تمويل التأمين وصناديق المعاشات,صغيرة,8,58,23,35,86,86,0
2022,2,منطقة عسير,أنشطة الخدمات المالية ، فيما عدا تمويل التأمين وصناديق المعاشات,متناهية الصغر,23,11,6,5,44,44,0
2022,2,منطقة مكة المكرمة,أنشطة الخدمات المالية ، فيما عدا تمويل التأمين وصناديق المعاشات,صغيرة,137,757,455,302,1319,1273,46
2022,2,منطقة مكة المكرمة,أنشطة الخدمات المالية ، فيما عدا تمويل التأمين وصناديق المعاشات,كبيرة,3,11925,10236,1689,420,419,1
2022,2,منطقة مكة المكرمة,أنشطة الخدمات المالية ، فيما عدا تمويل التأمين وصناديق المعاشات,متناهية الصغر,335,202,124,78,619,598,21
2022,2,منطقة مكة المكرمة,أنشطة الخدمات المالية ، فيما عدا تمويل التأمين وصناديق المعاشات,متوسطة,20,1019,676,343,787,776,11
2022,2,منطقة نجران,أنشطة الخدمات المالية ، فيما عدا تمويل التأمين وصناديق المعاشات,صغيرة,1,2,0,2,4,4,0
2022,2,منطقة نجران,أنشطة الخدمات المالية ، فيما عدا تمويل التأمين وصناديق المعاشات,متناهية الصغر,15,3,2,1,36,36,0
2022,2,المنطقة الشرقية,أنشطة الخدمات الشخصية الأخرى,صغيرة,723,1476,407,1069,5977,4299,1678
2022,2,المنطقة الشرقية,أنشطة الخدمات الشخصية الأخرى,كبيرة,1,284,131,153,2219,2219,0
2022,2,المنطقة الشرقية,أنشطة الخدمات الشخصية الأخرى,متناهية الصغر,5713,1331,527,804,12140,11030,1110
2022,2,المنطقة الشرقية,أنشطة الخدمات الشخصية الأخرى,متوسطة,16,381,136,245,1229,1180,49
2022,2,منطقة الباحة,أنشطة الخدمات الشخصية الأخرى,صغيرة,15,17,11,6,90,85,5
2022,2,منطقة الباحة,أنشطة الخدمات الشخصية الأخرى,متناهية الصغر,403,73,49,24,809,769,40
2022,2,منطقة الجوف,أنشطة الخدمات الشخصية الأخرى,صغيرة,44,55,32,23,352,322,30
2022,2,منطقة الجوف,أنشطة الخدمات الشخصية الأخرى,متناهية الصغر,705,113,56,57,1432,1326,106
2022,2,منطقة الجوف,أنشطة الخدمات الشخصية الأخرى,متوسطة,2,16,12,4,107,106,1
2022,2,منطقة الحدود الشمالية,أنشطة الخدمات الشخصية الأخرى,صغيرة,25,34,10,24,203,150,53
2022,2,منطقة الحدود الشمالية,أنشطة الخدمات الشخصية الأخرى,متناهية الصغر,545,75,37,38,1247,1187,60
2022,2,منطقة الرياض,أنشطة الخدمات الشخصية الأخرى,صغيرة,1308,2952,699,2253,11303,7998,3305
2022,2,منطقة الرياض,أنشطة الخدمات الشخصية الأخرى,كبيرة,5,2315,1485,830,1519,1064,455
2022,2,منطقة الرياض,أنشطة الخدمات الشخصية الأخرى,متناهية الصغر,9157,2188,780,1408,19141,16997,2144
2022,2,منطقة الرياض,أنشطة الخدمات الشخصية الأخرى,متوسطة,43,820,183,637,2814,2112,702
2022,2,منطقة القصيم,أنشطة الخدمات الشخصية الأخرى,صغيرة,144,219,55,164,1342,987,355
2022,2,منطقة القصيم,أنشطة الخدمات الشخصية الأخرى,متناهية الصغر,1876,299,148,151,4140,3844,296
2022,2,منطقة القصيم,أنشطة الخدمات الشخصية الأخرى,متوسطة,6,71,33,38,362,301,61
2022,2,منطقة المدينة المنورة,أنشطة الخدمات الشخصية الأخرى,صغيرة,161,342,105,237,1341,975,366
2022,2,منطقة المدينة المنورة,أنشطة الخدمات الشخصية الأخرى,متناهية الصغر,2579,396,186,210,5209,4863,346
2022,2,منطقة المدينة المنورة,أنشطة الخدمات الشخصية الأخرى,متوسطة,1,7,6,1,45,45,0
2022,2,منطقة تبوك,أنشطة الخدمات الشخصية الأخرى,صغيرة,62,92,36,56,555,477,78
2022,2,منطقة تبوك,أنشطة الخدمات الشخصية الأخرى,متناهية الصغر,1292,197,90,107,2673,2550,123
2022,2,منطقة جازان,أنشطة الخدمات الشخصية الأخرى,صغيرة,79,194,79,115,572,440,132
2022,2,منطقة جازان,أنشطة الخدمات الشخصية الأخرى,متناهية الصغر,1772,202,107,95,3943,3789,154
2022,2,منطقة جازان,أنشطة الخدمات الشخصية الأخرى,متوسطة,2,37,36,1,201,201,0
2022,2,منطقة حائل,أنشطة الخدمات الشخصية الأخرى,صغيرة,72,132,37,95,581,449,132
2022,2,منطقة حائل,أنشطة الخدمات الشخصية الأخرى,متناهية الصغر,1047,154,68,86,2301,2132,169
2022,2,منطقة حائل,أنشطة الخدمات الشخصية الأخرى,متوسطة,1,46,3,43,58,8,50
2022,2,منطقة عسير,أنشطة الخدمات الشخصية الأخرى,صغيرة,133,223,109,114,1079,963,116
2022,2,منطقة عسير,أنشطة الخدمات الشخصية الأخرى,متناهية الصغر,2307,381,180,201,4765,4498,267
2022,2,منطقة مكة المكرمة,أنشطة الخدمات الشخصية الأخرى,صغيرة,798,1755,473,1282,6860,4812,2048
2022,2,منطقة مكة المكرمة,أنشطة الخدمات الشخصية الأخرى,كبيرة,2,299,203,96,254,36,218
2022,2,منطقة مكة المكرمة,أنشطة الخدمات الشخصية الأخرى,متناهية الصغر,8256,1731,763,968,17194,15591,1603
2022,2,منطقة مكة المكرمة,أنشطة الخدمات الشخصية الأخرى,متوسطة,16,321,73,248,928,438,490
2022,2,منطقة نجران,أنشطة الخدمات الشخصية الأخرى,صغيرة,32,36,14,22,224,189,35
2022,2,منطقة نجران,أنشطة الخدمات الشخصية الأخرى,متناهية الصغر,786,125,54,71,1798,1675,123
2022,2,المنطقة الشرقية,أنشطة التشييد المتخصصة,صغيرة,1834,4623,2521,2102,22817,22754,63
2022,2,المنطقة الشرقية,أنشطة التشييد المتخصصة,كبيرة,86,15565,12667,2898,76367,76294,73
2022,2,المنطقة الشرقية,أنشطة التشييد المتخصصة,متناهية الصغر,5985,1904,930,974,13462,13441,21
2022,2,المنطقة الشرقية,أنشطة التشييد المتخصصة,متوسطة,240,4663,2997,1666,20562,20517,45
2022,2,منطقة الباحة,أنشطة التشييد المتخصصة,صغيرة,51,94,63,31,477,477,0
2022,2,منطقة الباحة,أنشطة التشييد المتخصصة,متناهية الصغر,449,81,58,23,999,998,1
2022,2,منطقة الباحة,أنشطة التشييد المتخصصة,متوسطة,4,98,61,37,460,460,0
2022,2,منطقة الجوف,أنشطة التشييد المتخصصة,صغيرة,83,160,119,41,920,910,10
2022,2,منطقة الجوف,أنشطة التشييد المتخصصة,متناهية الصغر,691,110,73,37,1534,1527,7
2022,2,منطقة الجوف,أنشطة التشييد المتخصصة,متوسطة,3,30,20,10,236,236,0
2022,2,منطقة الحدود الشمالية,أنشطة التشييد المتخصصة,صغيرة,43,75,52,23,366,366,0
2022,2,منطقة الحدود الشمالية,أنشطة التشييد المتخصصة,متناهية الصغر,419,80,44,36,1013,1013,0
2022,2,منطقة الحدود الشمالية,أنشطة التشييد المتخصصة,متوسطة,1,5,5,0,86,86,0
2022,2,منطقة الرياض,أنشطة التشييد المتخصصة,صغيرة,3026,8102,3628,4474,38519,38215,304
2022,2,منطقة الرياض,أنشطة التشييد المتخصصة,كبيرة,153,32404,24059,8345,114796,112775,2021
2022,2,منطقة الرياض,أنشطة التشييد المتخصصة,متناهية الصغر,11315,3120,1363,1757,25528,25310,218
2022,2,منطقة الرياض,أنشطة التشييد المتخصصة,متوسطة,480,8612,4894,3718,39391,39204,187
2022,2,منطقة القصيم,أنشطة التشييد المتخصصة,صغيرة,412,554,320,234,5105,5089,16
2022,2,منطقة القصيم,أنشطة التشييد المتخصصة,كبيرة,12,814,569,245,7043,6800,243
2022,2,منطقة القصيم,أنشطة التشييد المتخصصة,متناهية الصغر,2704,433,249,184,6411,6392,19
2022,2,منطقة القصيم,أنشطة التشييد المتخصصة,متوسطة,52,368,241,127,4976,4973,3
2022,2,منطقة المدينة المنورة,أنشطة التشييد المتخصصة,صغيرة,368,702,400,302,3895,3880,15
2022,2,منطقة المدينة المنورة,أنشطة التشييد المتخصصة,كبيرة,6,913,625,288,4337,4195,142
2022,2,منطقة المدينة المنورة,أنشطة التشييد المتخصصة,متناهية الصغر,2620,553,313,240,6181,6148,33
2022,2,منطقة المدينة المنورة,أنشطة التشييد المتخصصة,متوسطة,28,487,299,188,2062,2043,19
2022,2,منطقة تبوك,أنشطة التشييد المتخصصة,صغيرة,80,167,85,82,751,751,0
2022,2,منطقة تبوك,أنشطة التشييد المتخصصة,كبيرة,1,85,77,8,571,571,0
2022,2,منطقة تبوك,أنشطة التشييد المتخصصة,متناهية الصغر,1206,223,110,113,2838,2835,3
2022,2,منطقة تبوك,أنشطة التشييد المتخصصة,متوسطة,4,46,25,21,247,247,0
2022,2,منطقة جازان,أنشطة التشييد المتخصصة,صغيرة,106,199,96,103,949,938,11
2022,2,منطقة جازان,أنشطة التشييد المتخصصة,متناهية الصغر,1898,314,190,124,4551,4533,18
2022,2,منطقة جازان,أنشطة التشييد المتخصصة,متوسطة,2,30,28,2,217,217,0
2022,2,منطقة حائل,أنشطة التشييد المتخصصة,صغيرة,128,186,83,103,1271,1269,2
2022,2,منطقة حائل,أنشطة التشييد المتخصصة,كبيرة,2,197,142,55,826,821,5
2022,2,منطقة حائل,أنشطة التشييد المتخصصة,متناهية الصغر,1154,166,89,77,2770,2760,10
2022,2,منطقة حائل,أنشطة التشييد المتخصصة,متوسطة,10,153,121,32,878,868,10
2022,2,منطقة عسير,أنشطة التشييد المتخصصة,صغيرة,338,677,413,264,3233,3209,24
2022,2,منطقة عسير,أنشطة التشييد المتخصصة,كبيرة,4,603,295,308,2865,2865,0
2022,2,منطقة عسير,أنشطة التشييد المتخصصة,متناهية الصغر,2701,484,278,206,5900,5891,9
2022,2,منطقة عسير,أنشطة التشييد المتخصصة,متوسطة,20,439,274,165,1582,1581,1
2022,2,منطقة مكة المكرمة,أنشطة التشييد المتخصصة,صغيرة,1966,4822,2446,2376,22988,22818,170
2022,2,منطقة مكة المكرمة,أنشطة التشييد المتخصصة,كبيرة,49,4998,3529,1469,25200,25067,133
2022,2,منطقة مكة المكرمة,أنشطة التشييد المتخصصة,متناهية الصغر,10010,2453,1214,1239,22157,21929,228
2022,2,منطقة مكة المكرمة,أنشطة التشييد المتخصصة,متوسطة,205,3923,2570,1353,17221,17158,63
2022,2,منطقة نجران,أنشطة التشييد المتخصصة,صغيرة,141,197,109,88,1502,1490,12
2022,2,منطقة نجران,أنشطة التشييد المتخصصة,كبيرة,5,266,168,98,1241,1241,0
2022,2,منطقة نجران,أنشطة التشييد المتخصصة,متناهية الصغر,1165,135,75,60,2589,2574,15
2022,2,منطقة نجران,أنشطة التشييد المتخصصة,متوسطة,10,179,126,53,734,734,0
2022,2,المنطقة الشرقية,أنشطة البريد ونقل الرسائل والطرود بواسطة مندوبين,صغيرة,10,49,24,25,86,86,0
2022,2,المنطقة الشرقية,أنشطة البريد ونقل الرسائل والطرود بواسطة مندوبين,متناهية الصغر,33,30,9,21,44,44,0
2022,2,المنطقة الشرقية,أنشطة البريد ونقل الرسائل والطرود بواسطة مندوبين,متوسطة,2,56,20,36,127,127,0
2022,2,منطقة الجوف,أنشطة البريد ونقل الرسائل والطرود بواسطة مندوبين,متناهية الصغر,2,1,1,0,4,4,0
2022,2,منطقة الرياض,أنشطة البريد ونقل الرسائل والطرود بواسطة مندوبين,صغيرة,95,444,209,235,1047,1028,19
2022,2,منطقة الرياض,أنشطة البريد ونقل الرسائل والطرود بواسطة مندوبين,كبيرة,5,1046,567,479,4752,4724,28
2022,2,منطقة الرياض,أنشطة البريد ونقل الرسائل والطرود بواسطة مندوبين,متناهية الصغر,244,153,90,63,441,427,14
2022,2,منطقة الرياض,أنشطة البريد ونقل الرسائل والطرود بواسطة مندوبين,متوسطة,12,359,236,123,680,666,14
2022,2,منطقة القصيم,أنشطة البريد ونقل الرسائل والطرود بواسطة مندوبين,متناهية الصغر,10,5,1,4,26,26,0
2022,2,منطقة المدينة المنورة,أنشطة البريد ونقل الرسائل والطرود بواسطة مندوبين,صغيرة,2,0,0,0,15,15,0
2022,2,منطقة المدينة المنورة,أنشطة البريد ونقل الرسائل والطرود بواسطة مندوبين,متناهية الصغر,12,4,3,1,25,25,0
2022,2,منطقة تبوك,أنشطة البريد ونقل الرسائل والطرود بواسطة مندوبين,متناهية الصغر,7,1,0,1,16,15,1
2022,2,منطقة جازان,أنشطة البريد ونقل الرسائل والطرود بواسطة مندوبين,متناهية الصغر,3,0,0,0,6,6,0
2022,2,منطقة حائل,أنشطة البريد ونقل الرسائل والطرود بواسطة مندوبين,متناهية الصغر,3,0,0,0,9,9,0
2022,2,منطقة عسير,أنشطة البريد ونقل الرسائل والطرود بواسطة مندوبين,صغيرة,2,30,28,2,12,11,1
2022,2,منطقة عسير,أنشطة البريد ونقل الرسائل والطرود بواسطة مندوبين,متناهية الصغر,11,5,4,1,31,31,0
2022,2,منطقة مكة المكرمة,أنشطة البريد ونقل الرسائل والطرود بواسطة مندوبين,صغيرة,12,77,31,46,191,188,3
2022,2,منطقة مكة المكرمة,أنشطة البريد ونقل الرسائل والطرود بواسطة مندوبين,متناهية الصغر,77,57,28,29,123,119,4
2022,2,منطقة مكة المكرمة,أنشطة البريد ونقل الرسائل والطرود بواسطة مندوبين,متوسطة,1,17,0,17,67,67,0
2022,2,منطقة نجران,أنشطة البريد ونقل الرسائل والطرود بواسطة مندوبين,متناهية الصغر,2,0,0,0,2,2,0
2022,2,المنطقة الشرقية,أنشطة البرمجة والإذاعة,صغيرة,2,7,6,1,17,17,0
2022,2,المنطقة الشرقية,أنشطة البرمجة والإذاعة,متناهية الصغر,10,7,2,5,24,23,1
2022,2,منطقة الجوف,أنشطة البرمجة والإذاعة,متناهية الصغر,1,0,0,0,1,1,0
2022,2,منطقة الرياض,أنشطة البرمجة والإذاعة,صغيرة,13,86,49,37,64,62,2
2022,2,منطقة الرياض,أنشطة البرمجة والإذاعة,متناهية الصغر,54,38,17,21,98,98,0
2022,2,منطقة الرياض,أنشطة البرمجة والإذاعة,متوسطة,2,74,40,34,87,80,7
2022,2,منطقة القصيم,أنشطة البرمجة والإذاعة,متناهية الصغر,2,0,0,0,3,3,0
2022,2,منطقة المدينة المنورة,أنشطة البرمجة والإذاعة,متناهية الصغر,3,1,0,1,9,9,0
2022,2,منطقة تبوك,أنشطة البرمجة والإذاعة,متناهية الصغر,2,0,0,0,8,8,0
2022,2,منطقة جازان,أنشطة البرمجة والإذاعة,متناهية الصغر,1,1,0,1,4,4,0
2022,2,منطقة حائل,أنشطة البرمجة والإذاعة,صغيرة,1,2,1,1,5,5,0
2022,2,منطقة عسير,أنشطة البرمجة والإذاعة,متناهية الصغر,7,1,1,0,14,14,0
2022,2,منطقة مكة المكرمة,أنشطة البرمجة والإذاعة,صغيرة,14,71,43,28,125,120,5
2022,2,منطقة مكة المكرمة,أنشطة البرمجة والإذاعة,متناهية الصغر,20,7,5,2,43,39,4
2022,2,منطقة مكة المكرمة,أنشطة البرمجة والإذاعة,متوسطة,1,55,30,25,70,70,0
2022,2,منطقة نجران,أنشطة البرمجة والإذاعة,متناهية الصغر,2,2,1,1,3,3,0
2022,2,المنطقة الشرقية,أنشطة البرمجة الحاسوبية والخبرة الاستشارية وما يتصل بها من أنشطة,صغيرة,107,723,390,333,962,946,16
2022,2,المنطقة الشرقية,أنشطة البرمجة الحاسوبية والخبرة الاستشارية وما يتصل بها من أنشطة,كبيرة,3,952,836,116,717,710,7
2022,2,المنطقة الشرقية,أنشطة البرمجة الحاسوبية والخبرة الاستشارية وما يتصل بها من أنشطة,متناهية الصغر,260,217,109,108,366,359,7
2022,2,المنطقة الشرقية,أنشطة البرمجة الحاسوبية والخبرة الاستشارية وما يتصل بها من أنشطة,متوسطة,12,518,299,219,447,439,8
2022,2,منطقة الباحة,أنشطة البرمجة الحاسوبية والخبرة الاستشارية وما يتصل بها من أنشطة,متناهية الصغر,2,3,1,2,2,2,0
2022,2,منطقة الجوف,أنشطة البرمجة الحاسوبية والخبرة الاستشارية وما يتصل بها من أنشطة,متناهية الصغر,14,5,4,1,25,25,0
2022,2,منطقة الحدود الشمالية,أنشطة البرمجة الحاسوبية والخبرة الاستشارية وما يتصل بها من أنشطة,متناهية الصغر,6,3,1,2,12,12,0
2022,2,منطقة الرياض,أنشطة البرمجة الحاسوبية والخبرة الاستشارية وما يتصل بها من أنشطة,صغيرة,592,4090,2045,2045,5459,5264,195
2022,2,منطقة الرياض,أنشطة البرمجة الحاسوبية والخبرة الاستشارية وما يتصل بها من أنشطة,كبيرة,25,13957,8820,5137,6912,6613,299
2022,2,منطقة الرياض,أنشطة البرمجة الحاسوبية والخبرة الاستشارية وما يتصل بها من أنشطة,متناهية الصغر,1300,1005,488,517,1935,1877,58
2022,2,منطقة الرياض,أنشطة البرمجة الحاسوبية والخبرة الاستشارية وما يتصل بها من أنشطة,متوسطة,97,4724,2696,2028,4844,4708,136
2022,2,منطقة القصيم,أنشطة البرمجة الحاسوبية والخبرة الاستشارية وما يتصل بها من أنشطة,صغيرة,17,92,49,43,148,140,8
2022,2,منطقة القصيم,أنشطة البرمجة الحاسوبية والخبرة الاستشارية وما يتصل بها من أنشطة,متناهية الصغر,71,23,11,12,148,148,0
2022,2,منطقة المدينة المنورة,أنشطة البرمجة الحاسوبية والخبرة الاستشارية وما يتصل بها من أنشطة,صغيرة,7,27,11,16,46,46,0
2022,2,منطقة المدينة المنورة,أنشطة البرمجة الحاسوبية والخبرة الاستشارية وما يتصل بها من أنشطة,متناهية الصغر,84,43,17,26,138,134,4
2022,2,منطقة المدينة المنورة,أنشطة البرمجة الحاسوبية والخبرة الاستشارية وما يتصل بها من أنشطة,متوسطة,1,34,33,1,17,17,0
2022,2,منطقة تبوك,أنشطة البرمجة الحاسوبية والخبرة الاستشارية وما يتصل بها من أنشطة,متناهية الصغر,19,10,3,7,34,33,1
2022,2,منطقة جازان,أنشطة البرمجة الحاسوبية والخبرة الاستشارية وما يتصل بها من أنشطة,صغيرة,1,3,3,0,6,6,0
2022,2,منطقة جازان,أنشطة البرمجة الحاسوبية والخبرة الاستشارية وما يتصل بها من أنشطة,متناهية الصغر,26,8,3,5,60,60,0
2022,2,منطقة حائل,أنشطة البرمجة الحاسوبية والخبرة الاستشارية وما يتصل بها من أنشطة,صغيرة,3,6,2,4,35,35,0
2022,2,منطقة حائل,أنشطة البرمجة الحاسوبية والخبرة الاستشارية وما يتصل بها من أنشطة,متناهية الصغر,12,4,2,2,23,23,0
2022,2,منطقة عسير,أنشطة البرمجة الحاسوبية والخبرة الاستشارية وما يتصل بها من أنشطة,صغيرة,11,26,16,10,81,80,1
2022,2,منطقة عسير,أنشطة البرمجة الحاسوبية والخبرة الاستشارية وما يتصل بها من أنشطة,متناهية الصغر,48,20,11,9,91,90,1
2022,2,منطقة مكة المكرمة,أنشطة البرمجة الحاسوبية والخبرة الاستشارية وما يتصل بها من أنشطة,صغيرة,148,647,313,334,1267,1221,46
2022,2,منطقة مكة المكرمة,أنشطة البرمجة الحاسوبية والخبرة الاستشارية وما يتصل بها من أنشطة,كبيرة,2,857,828,29,308,305,3
2022,2,منطقة مكة المكرمة,أنشطة البرمجة الحاسوبية والخبرة الاستشارية وما يتصل بها من أنشطة,متناهية الصغر,502,320,149,171,826,792,34
2022,2,منطقة مكة المكرمة,أنشطة البرمجة الحاسوبية والخبرة الاستشارية وما يتصل بها من أنشطة,متوسطة,13,506,252,254,651,605,46
2022,2,منطقة نجران,أنشطة البرمجة الحاسوبية والخبرة الاستشارية وما يتصل بها من أنشطة,متناهية الصغر,13,2,2,0,25,25,0
2022,2,المنطقة الشرقية,أنشطة الأمن والتحقيقات,صغيرة,23,492,439,53,35,35,0
2022,2,المنطقة الشرقية,أنشطة الأمن والتحقيقات,كبيرة,6,3393,3126,267,0,0,0
2022,2,المنطقة الشرقية,أنشطة الأمن والتحقيقات,متناهية الصغر,51,62,54,8,61,61,0
2022,2,المنطقة الشرقية,أنشطة الأمن والتحقيقات,متوسطة,14,1565,1439,126,83,83,0
2022,2,منطقة الجوف,أنشطة الأمن والتحقيقات,صغيرة,2,64,47,17,2,2,0
2022,2,منطقة الجوف,أنشطة الأمن والتحقيقات,متناهية الصغر,1,3,3,0,0,0,0
2022,2,منطقة الحدود الشمالية,أنشطة الأمن والتحقيقات,صغيرة,2,24,18,6,0,0,0
2022,2,منطقة الحدود الشمالية,أنشطة الأمن والتحقيقات,كبيرة,1,0,0,0,336,336,0
2022,2,منطقة الحدود الشمالية,أنشطة الأمن والتحقيقات,متناهية الصغر,1,1,1,0,1,1,0
2022,2,منطقة الرياض,أنشطة الأمن والتحقيقات,صغيرة,47,665,587,78,210,209,1
2022,2,منطقة الرياض,أنشطة الأمن والتحقيقات,كبيرة,17,15616,13911,1705,334,332,2
2022,2,منطقة الرياض,أنشطة الأمن والتحقيقات,متناهية الصغر,118,137,98,39,116,116,0
2022,2,منطقة الرياض,أنشطة الأمن والتحقيقات,متوسطة,22,2932,2573,359,110,105,5
2022,2,منطقة القصيم,أنشطة الأمن والتحقيقات,صغيرة,6,87,81,6,14,14,0
2022,2,منطقة القصيم,أنشطة الأمن والتحقيقات,متناهية الصغر,12,6,6,0,19,19,0
2022,2,منطقة المدينة المنورة,أنشطة الأمن والتحقيقات,صغيرة,5,62,58,4,28,28,0
2022,2,منطقة المدينة المنورة,أنشطة الأمن والتحقيقات,متناهية الصغر,13,13,11,2,11,11,0
2022,2,منطقة المدينة المنورة,أنشطة الأمن والتحقيقات,متوسطة,1,124,124,0,0,0,0
2022,2,منطقة تبوك,أنشطة الأمن والتحقيقات,متناهية الصغر,6,2,2,0,5,5,0
2022,2,منطقة جازان,أنشطة الأمن والتحقيقات,صغيرة,2,24,20,4,11,9,2
2022,2,منطقة جازان,أنشطة الأمن والتحقيقات,متناهية الصغر,9,8,7,1,14,14,0
2022,2,منطقة حائل,أنشطة الأمن والتحقيقات,صغيرة,2,11,10,1,4,4,0
2022,2,منطقة حائل,أنشطة الأمن والتحقيقات,متناهية الصغر,5,5,2,3,7,7,0
2022,2,منطقة حائل,أنشطة الأمن والتحقيقات,متوسطة,1,88,85,3,0,0,0
2022,2,منطقة عسير,أنشطة الأمن والتحقيقات,صغيرة,2,35,34,1,0,0,0
2022,2,منطقة عسير,أنشطة الأمن والتحقيقات,كبيرة,2,1732,1682,50,0,0,0
2022,2,منطقة عسير,أنشطة الأمن والتحقيقات,متناهية الصغر,9,9,5,4,5,5,0
2022,2,منطقة عسير,أنشطة الأمن والتحقيقات,متوسطة,2,153,146,7,0,0,0
2022,2,منطقة مكة المكرمة,أنشطة الأمن والتحقيقات,صغيرة,35,508,417,91,53,52,1
2022,2,منطقة مكة المكرمة,أنشطة الأمن والتحقيقات,كبيرة,6,2529,2307,222,0,0,0
2022,2,منطقة مكة المكرمة,أنشطة الأمن والتحقيقات,متناهية الصغر,51,55,46,9,64,61,3
2022,2,منطقة مكة المكرمة,أنشطة الأمن والتحقيقات,متوسطة,8,919,786,133,2,2,0
2022,2,منطقة نجران,أنشطة الأمن والتحقيقات,كبيرة,1,304,275,29,0,0,0
2022,2,منطقة نجران,أنشطة الأمن والتحقيقات,متناهية الصغر,2,1,1,0,3,3,0
2022,2,المنطقة الشرقية,أنشطة الاسر المعيشية التي تستخدم أفراداً للعمل المنزلي,متناهية الصغر,9,2,2,0,16,15,1
2022,2,منطقة الباحة,أنشطة الاسر المعيشية التي تستخدم أفراداً للعمل المنزلي,متناهية الصغر,1,0,0,0,1,1,0
2022,2,منطقة الرياض,أنشطة الاسر المعيشية التي تستخدم أفراداً للعمل المنزلي,متناهية الصغر,9,1,1,0,15,14,1
2022,2,منطقة القصيم,أنشطة الاسر المعيشية التي تستخدم أفراداً للعمل المنزلي,صغيرة,1,0,0,0,7,7,0
2022,2,منطقة القصيم,أنشطة الاسر المعيشية التي تستخدم أفراداً للعمل المنزلي,متناهية الصغر,6,1,1,0,11,11,0
2022,2,منطقة المدينة المنورة,أنشطة الاسر المعيشية التي تستخدم أفراداً للعمل المنزلي,متناهية الصغر,2,1,0,1,3,3,0
2022,2,منطقة حائل,أنشطة الاسر المعيشية التي تستخدم أفراداً للعمل المنزلي,متناهية الصغر,4,0,0,0,6,6,0
2022,2,منطقة عسير,أنشطة الاسر المعيشية التي تستخدم أفراداً للعمل المنزلي,صغيرة,1,0,0,0,7,7,0
2022,2,منطقة عسير,أنشطة الاسر المعيشية التي تستخدم أفراداً للعمل المنزلي,متناهية الصغر,1,0,0,0,1,1,0
2022,2,منطقة مكة المكرمة,أنشطة الاسر المعيشية التي تستخدم أفراداً للعمل المنزلي,متناهية الصغر,2,0,0,0,2,2,0
2022,2,منطقة نجران,أنشطة الاسر المعيشية التي تستخدم أفراداً للعمل المنزلي,متناهية الصغر,1,0,0,0,1,1,0
2022,2,المنطقة الشرقية,أنشطة الاستخدام,صغيرة,53,207,124,83,346,321,25
2022,2,المنطقة الشرقية,أنشطة الاستخدام,كبيرة,25,596,440,156,42158,32502,9656
2022,2,المنطقة الشرقية,أنشطة الاستخدام,متناهية الصغر,285,321,188,133,394,367,27
2022,2,المنطقة الشرقية,أنشطة الاستخدام,متوسطة,9,51,23,28,1103,271,832
2022,2,منطقة الباحة,أنشطة الاستخدام,متناهية الصغر,13,8,6,2,23,23,0
2022,2,منطقة الجوف,أنشطة الاستخدام,صغيرة,2,12,7,5,12,12,0
2022,2,منطقة الجوف,أنشطة الاستخدام,متناهية الصغر,24,29,10,19,32,32,0
2022,2,منطقة الحدود الشمالية,أنشطة الاستخدام,صغيرة,5,12,3,9,42,13,29
2022,2,منطقة الحدود الشمالية,أنشطة الاستخدام,متناهية الصغر,13,7,5,2,17,17,0
2022,2,منطقة الرياض,أنشطة الاستخدام,صغيرة,170,925,365,560,1188,980,208
2022,2,منطقة الرياض,أنشطة الاستخدام,كبيرة,58,7984,3090,4894,187205,111053,76152
2022,2,منطقة الرياض,أنشطة الاستخدام,متناهية الصغر,725,694,352,342,997,959,38
2022,2,منطقة الرياض,أنشطة الاستخدام,متوسطة,23,942,548,394,2222,1005,1217
2022,2,منطقة القصيم,أنشطة الاستخدام,صغيرة,17,66,25,41,105,79,26
2022,2,منطقة القصيم,أنشطة الاستخدام,متناهية الصغر,67,57,36,21,114,112,2
2022,2,منطقة القصيم,أنشطة الاستخدام,متوسطة,1,6,6,0,44,44,0
2022,2,منطقة المدينة المنورة,أنشطة الاستخدام,صغيرة,11,57,30,27,41,30,11
2022,2,منطقة المدينة المنورة,أنشطة الاستخدام,متناهية الصغر,84,72,43,29,127,123,4
2022,2,منطقة تبوك,أنشطة الاستخدام,صغيرة,5,10,5,5,89,89,0
2022,2,منطقة تبوك,أنشطة الاستخدام,متناهية الصغر,49,37,17,20,81,77,4
2022,2,منطقة جازان,أنشطة الاستخدام,صغيرة,4,7,2,5,27,27,0
2022,2,منطقة جازان,أنشطة الاستخدام,متناهية الصغر,34,13,10,3,62,62,0
2022,2,منطقة حائل,أنشطة الاستخدام,صغيرة,10,49,23,26,83,43,40
2022,2,منطقة حائل,أنشطة الاستخدام,متناهية الصغر,40,33,23,10,66,63,3
2022,2,منطقة عسير,أنشطة الاستخدام,صغيرة,11,15,7,8,77,29,48
2022,2,منطقة عسير,أنشطة الاستخدام,كبيرة,3,121,46,75,15213,10490,4723
2022,2,منطقة عسير,أنشطة الاستخدام,متناهية الصغر,101,72,45,27,152,145,7
2022,2,منطقة عسير,أنشطة الاستخدام,متوسطة,3,102,44,58,387,336,51
2022,2,منطقة مكة المكرمة,أنشطة الاستخدام,صغيرة,54,169,77,92,317,305,12
2022,2,منطقة مكة المكرمة,أنشطة الاستخدام,كبيرة,8,125,48,77,15943,12726,3217
2022,2,منطقة مكة المكرمة,أنشطة الاستخدام,متناهية الصغر,341,286,171,115,498,478,20
2022,2,منطقة مكة المكرمة,أنشطة الاستخدام,متوسطة,7,189,57,132,715,459,256
2022,2,منطقة نجران,أنشطة الاستخدام,صغيرة,13,28,11,17,90,68,22
2022,2,منطقة نجران,أنشطة الاستخدام,متناهية الصغر,41,27,11,16,58,49,9
2022,2,المنطقة الشرقية,الهندسة المدنية,صغيرة,390,1474,870,604,5542,5524,18
2022,2,المنطقة الشرقية,الهندسة المدنية,كبيرة,95,25082,20720,4362,105456,105351,105
2022,2,المنطقة الشرقية,الهندسة المدنية,متناهية الصغر,498,300,164,136,1003,998,5
2022,2,المنطقة الشرقية,الهندسة المدنية,متوسطة,162,3439,2471,968,14976,14959,17
2022,2,منطقة الباحة,الهندسة المدنية,صغيرة,7,15,15,0,62,62,0
2022,2,منطقة الباحة,الهندسة المدنية,كبيرة,1,52,46,6,283,283,0
2022,2,منطقة الباحة,الهندسة المدنية,متناهية الصغر,22,2,1,1,40,39,1
2022,2,منطقة الباحة,الهندسة المدنية,متوسطة,2,51,45,6,96,96,0
2022,2,منطقة الجوف,الهندسة المدنية,صغيرة,16,75,35,40,175,174,1
2022,2,منطقة الجوف,الهندسة المدنية,كبيرة,1,118,80,38,304,274,30
2022,2,منطقة الجوف,الهندسة المدنية,متناهية الصغر,42,16,13,3,88,88,0
2022,2,منطقة الجوف,الهندسة المدنية,متوسطة,6,139,110,29,475,475,0
2022,2,منطقة الحدود الشمالية,الهندسة المدنية,صغيرة,10,30,22,8,132,132,0
2022,2,منطقة الحدود الشمالية,الهندسة المدنية,متناهية الصغر,31,6,3,3,69,69,0
2022,2,منطقة الحدود الشمالية,الهندسة المدنية,متوسطة,2,49,26,23,204,204,0
2022,2,منطقة الرياض,الهندسة المدنية,صغيرة,652,2133,1057,1076,9393,9337,56
2022,2,منطقة الرياض,الهندسة المدنية,كبيرة,123,25320,18213,7107,137981,137171,810
2022,2,منطقة الرياض,الهندسة المدنية,متناهية الصغر,1138,487,212,275,2441,2422,19
2022,2,منطقة الرياض,الهندسة المدنية,متوسطة,205,4530,2874,1656,19493,19439,54
2022,2,منطقة القصيم,الهندسة المدنية,صغيرة,78,257,169,88,1061,1055,6
2022,2,منطقة القصيم,الهندسة المدنية,كبيرة,8,1263,826,437,8080,8077,3
2022,2,منطقة القصيم,الهندسة المدنية,متناهية الصغر,138,46,26,20,316,315,1
2022,2,منطقة القصيم,الهندسة المدنية,متوسطة,21,426,311,115,1879,1876,3
2022,2,منطقة المدينة المنورة,الهندسة المدنية,صغيرة,71,213,139,74,950,949,1
2022,2,منطقة المدينة المنورة,الهندسة المدنية,كبيرة,8,1031,665,366,3394,3385,9
2022,2,منطقة المدينة المنورة,الهندسة المدنية,متناهية الصغر,162,62,32,30,351,349,2
2022,2,منطقة المدينة المنورة,الهندسة المدنية,متوسطة,20,414,308,106,1447,1446,1
2022,2,منطقة تبوك,الهندسة المدنية,صغيرة,19,68,35,33,247,247,0
2022,2,منطقة تبوك,الهندسة المدنية,كبيرة,1,57,45,12,299,299,0
2022,2,منطقة تبوك,الهندسة المدنية,متناهية الصغر,51,15,9,6,118,118,0
2022,2,منطقة تبوك,الهندسة المدنية,متوسطة,4,86,61,25,336,336,0
2022,2,منطقة جازان,الهندسة المدنية,صغيرة,23,49,25,24,323,321,2
2022,2,منطقة جازان,الهندسة المدنية,كبيرة,1,70,53,17,416,416,0
2022,2,منطقة جازان,الهندسة المدنية,متناهية الصغر,86,28,19,9,211,211,0
2022,2,منطقة جازان,الهندسة المدنية,متوسطة,8,206,139,67,875,875,0
2022,2,منطقة حائل,الهندسة المدنية,صغيرة,29,74,38,36,307,301,6
2022,2,منطقة حائل,الهندسة المدنية,كبيرة,1,110,89,21,662,662,0
2022,2,منطقة حائل,الهندسة المدنية,متناهية الصغر,57,20,10,10,117,117,0
2022,2,منطقة حائل,الهندسة المدنية,متوسطة,7,153,118,35,608,606,2
2022,2,منطقة عسير,الهندسة المدنية,صغيرة,60,192,116,76,813,811,2
2022,2,منطقة عسير,الهندسة المدنية,كبيرة,8,703,602,101,3300,3300,0
2022,2,منطقة عسير,الهندسة المدنية,متناهية الصغر,126,50,29,21,272,272,0
2022,2,منطقة عسير,الهندسة المدنية,متوسطة,18,462,354,108,1799,1799,0
2022,2,منطقة مكة المكرمة,الهندسة المدنية,صغيرة,353,1162,612,550,4799,4762,37
2022,2,منطقة مكة المكرمة,الهندسة المدنية,كبيرة,36,7795,5998,1797,38441,38211,230
2022,2,منطقة مكة المكرمة,الهندسة المدنية,متناهية الصغر,554,240,131,109,1222,1204,18
2022,2,منطقة مكة المكرمة,الهندسة المدنية,متوسطة,91,1847,1204,643,8093,8064,29
2022,2,منطقة نجران,الهندسة المدنية,صغيرة,28,107,63,44,335,334,1
2022,2,منطقة نجران,الهندسة المدنية,كبيرة,6,699,560,139,2969,2967,2
2022,2,منطقة نجران,الهندسة المدنية,متناهية الصغر,45,24,13,11,104,104,0
2022,2,منطقة نجران,الهندسة المدنية,متوسطة,10,189,108,81,896,896,0
2022,2,المنطقة الشرقية,النقل المائي,صغيرة,21,161,138,23,129,125,4
2022,2,المنطقة الشرقية,النقل المائي,متناهية الصغر,52,38,33,5,84,84,0
2022,2,المنطقة الشرقية,النقل المائي,متوسطة,12,691,538,153,375,367,8
2022,2,منطقة الباحة,النقل المائي,متناهية الصغر,1,0,0,0,2,2,0
2022,2,منطقة الجوف,النقل المائي,متناهية الصغر,1,1,0,1,0,0,0
2022,2,منطقة الحدود الشمالية,النقل المائي,متناهية الصغر,1,0,0,0,1,1,0
2022,2,منطقة الرياض,النقل المائي,صغيرة,18,151,67,84,169,169,0
2022,2,منطقة الرياض,النقل المائي,متناهية الصغر,119,36,23,13,271,268,3
2022,2,منطقة الرياض,النقل المائي,متوسطة,2,122,109,13,55,55,0
2022,2,منطقة القصيم,النقل المائي,صغيرة,2,0,0,0,20,20,0
2022,2,منطقة القصيم,النقل المائي,متناهية الصغر,6,1,0,1,16,16,0
2022,2,منطقة المدينة المنورة,النقل المائي,صغيرة,7,60,45,15,49,48,1
2022,2,منطقة المدينة المنورة,النقل المائي,متناهية الصغر,21,13,10,3,34,34,0
2022,2,منطقة المدينة المنورة,النقل المائي,متوسطة,1,31,25,6,21,20,1
2022,2,منطقة تبوك,النقل المائي,صغيرة,3,28,21,7,40,28,12
2022,2,منطقة تبوك,النقل المائي,متناهية الصغر,13,6,4,2,13,13,0
2022,2,منطقة جازان,النقل المائي,صغيرة,3,44,26,18,33,33,0
2022,2,منطقة جازان,النقل المائي,متناهية الصغر,5,2,2,0,9,9,0
2022,2,منطقة جازان,النقل المائي,متوسطة,1,13,4,9,50,50,0
2022,2,منطقة عسير,النقل المائي,متناهية الصغر,14,1,0,1,33,33,0
2022,2,منطقة مكة المكرمة,النقل المائي,صغيرة,33,149,96,53,273,268,5
2022,2,منطقة مكة المكرمة,النقل المائي,كبيرة,1,103,78,25,156,155,1
2022,2,منطقة مكة المكرمة,النقل المائي,متناهية الصغر,114,54,28,26,177,174,3
2022,2,منطقة مكة المكرمة,النقل المائي,متوسطة,6,231,146,85,263,263,0
2022,2,منطقة نجران,النقل المائي,صغيرة,1,0,0,0,6,6,0
2022,2,منطقة نجران,النقل المائي,متناهية الصغر,7,0,0,0,12,12,0
2022,2,المنطقة الشرقية,النقل الجوي,صغيرة,26,119,75,44,290,289,1
2022,2,المنطقة الشرقية,النقل الجوي,متناهية الصغر,60,23,14,9,112,110,2
2022,2,منطقة الباحة,النقل الجوي,صغيرة,1,1,1,0,5,5,0
2022,2,منطقة الجوف,النقل الجوي,صغيرة,1,0,0,0,12,12,0
2022,2,منطقة الجوف,النقل الجوي,متناهية الصغر,9,3,2,1,21,21,0
2022,2,منطقة الحدود الشمالية,النقل الجوي,صغيرة,2,12,11,1,28,28,0
2022,2,منطقة الرياض,النقل الجوي,صغيرة,32,197,150,47,340,339,1
2022,2,منطقة الرياض,النقل الجوي,كبيرة,4,2523,2321,202,1583,1104,479
2022,2,منطقة الرياض,النقل الجوي,متناهية الصغر,244,57,30,27,586,578,8
2022,2,منطقة الرياض,النقل الجوي,متوسطة,8,441,379,62,495,491,4
2022,2,منطقة القصيم,النقل الجوي,متناهية الصغر,8,3,1,2,21,21,0
2022,2,منطقة المدينة المنورة,النقل الجوي,صغيرة,3,9,6,3,12,12,0
2022,2,منطقة المدينة المنورة,النقل الجوي,متناهية الصغر,10,2,2,0,19,19,0
2022,2,منطقة تبوك,النقل الجوي,صغيرة,1,4,3,1,6,6,0
2022,2,منطقة تبوك,النقل الجوي,متناهية الصغر,6,2,0,2,14,14,0
2022,2,منطقة تبوك,النقل الجوي,متوسطة,1,20,18,2,49,49,0
2022,2,منطقة جازان,النقل الجوي,صغيرة,1,0,0,0,10,10,0
2022,2,منطقة جازان,النقل الجوي,متناهية الصغر,11,2,1,1,27,27,0
2022,2,منطقة حائل,النقل الجوي,صغيرة,3,10,6,4,31,31,0
2022,2,منطقة حائل,النقل الجوي,متناهية الصغر,16,1,1,0,44,44,0
2022,2,منطقة عسير,النقل الجوي,صغيرة,1,2,2,0,8,8,0
2022,2,منطقة عسير,النقل الجوي,متناهية الصغر,13,5,3,2,32,32,0
2022,2,منطقة مكة المكرمة,النقل الجوي,صغيرة,28,146,102,44,345,341,4
2022,2,منطقة مكة المكرمة,النقل الجوي,كبيرة,2,5659,5077,582,202,121,81
2022,2,منطقة مكة المكرمة,النقل الجوي,متناهية الصغر,72,38,19,19,141,137,4
2022,2,منطقة مكة المكرمة,النقل الجوي,متوسطة,4,135,116,19,204,204,0
2022,2,منطقة نجران,النقل الجوي,صغيرة,1,0,0,0,6,6,0
2022,2,منطقة نجران,النقل الجوي,متناهية الصغر,1,0,0,0,4,4,0
2022,2,المنطقة الشرقية,النقل البري و النقل عبر الأنابيب,صغيرة,748,2489,1424,1065,10915,10903,12
2022,2,المنطقة الشرقية,النقل البري و النقل عبر الأنابيب,كبيرة,48,8976,7427,1549,23257,23246,11
2022,2,المنطقة الشرقية,النقل البري و النقل عبر الأنابيب,متناهية الصغر,2185,629,279,350,4335,4323,12
2022,2,المنطقة الشرقية,النقل البري و النقل عبر الأنابيب,متوسطة,162,4056,2794,1262,12570,12558,12
2022,2,منطقة الباحة,النقل البري و النقل عبر الأنابيب,صغيرة,12,26,14,12,96,96,0
2022,2,منطقة الباحة,النقل البري و النقل عبر الأنابيب,متناهية الصغر,191,27,18,9,374,374,0
2022,2,منطقة الباحة,النقل البري و النقل عبر الأنابيب,متوسطة,3,51,31,20,134,119,15
2022,2,منطقة الجوف,النقل البري و النقل عبر الأنابيب,صغيرة,77,176,117,59,920,920,0
2022,2,منطقة الجوف,النقل البري و النقل عبر الأنابيب,متناهية الصغر,586,73,48,25,1222,1218,4
2022,2,منطقة الجوف,النقل البري و النقل عبر الأنابيب,متوسطة,4,103,47,56,306,306,0
2022,2,منطقة الحدود الشمالية,النقل البري و النقل عبر الأنابيب,صغيرة,56,106,45,61,590,589,1
2022,2,منطقة الحدود الشمالية,النقل البري و النقل عبر الأنابيب,متناهية الصغر,349,55,37,18,677,677,0
2022,2,منطقة الحدود الشمالية,النقل البري و النقل عبر الأنابيب,متوسطة,3,66,49,17,266,266,0
2022,2,منطقة الرياض,النقل البري و النقل عبر الأنابيب,صغيرة,1225,3291,1478,1813,15153,15084,69
2022,2,منطقة الرياض,النقل البري و النقل عبر الأنابيب,كبيرة,43,14076,11731,2345,24259,24232,27
2022,2,منطقة الرياض,النقل البري و النقل عبر الأنابيب,متناهية الصغر,13289,1926,951,975,34345,34185,160
2022,2,منطقة الرياض,النقل البري و النقل عبر الأنابيب,متوسطة,202,4667,2470,2197,16722,16707,15
2022,2,منطقة القصيم,النقل البري و النقل عبر الأنابيب,صغيرة,253,646,368,278,2857,2857,0
2022,2,منطقة القصيم,النقل البري و النقل عبر الأنابيب,كبيرة,4,615,535,80,1896,1896,0
2022,2,منطقة القصيم,النقل البري و النقل عبر الأنابيب,متناهية الصغر,1111,218,131,87,2440,2437,3
2022,2,منطقة القصيم,النقل البري و النقل عبر الأنابيب,متوسطة,28,710,539,171,2356,2355,1
2022,2,منطقة المدينة المنورة,النقل البري و النقل عبر الأنابيب,صغيرة,138,383,235,148,1697,1695,2
2022,2,منطقة المدينة المنورة,النقل البري و النقل عبر الأنابيب,كبيرة,1,93,39,54,320,319,1
2022,2,منطقة المدينة المنورة,النقل البري و النقل عبر الأنابيب,متناهية الصغر,1101,159,76,83,2170,2166,4
2022,2,منطقة المدينة المنورة,النقل البري و النقل عبر الأنابيب,متوسطة,20,345,238,107,1299,1299,0
2022,2,منطقة تبوك,النقل البري و النقل عبر الأنابيب,صغيرة,70,148,73,75,631,631,0
2022,2,منطقة تبوك,النقل البري و النقل عبر الأنابيب,متناهية الصغر,587,100,58,42,1110,1109,1
2022,2,منطقة تبوك,النقل البري و النقل عبر الأنابيب,متوسطة,6,146,123,23,373,373,0
2022,2,منطقة جازان,النقل البري و النقل عبر الأنابيب,صغيرة,44,58,30,28,426,426,0
2022,2,منطقة جازان,النقل البري و النقل عبر الأنابيب,كبيرة,1,969,747,222,581,549,32
2022,2,منطقة جازان,النقل البري و النقل عبر الأنابيب,متناهية الصغر,523,93,55,38,1118,1113,5
2022,2,منطقة جازان,النقل البري و النقل عبر الأنابيب,متوسطة,5,105,73,32,509,508,1
2022,2,منطقة حائل,النقل البري و النقل عبر الأنابيب,صغيرة,54,105,45,60,595,594,1
2022,2,منطقة حائل,النقل البري و النقل عبر الأنابيب,متناهية الصغر,647,84,46,38,1543,1540,3
2022,2,منطقة حائل,النقل البري و النقل عبر الأنابيب,متوسطة,3,31,11,20,175,175,0
2022,2,منطقة عسير,النقل البري و النقل عبر الأنابيب,صغيرة,270,583,334,249,2748,2743,5
2022,2,منطقة عسير,النقل البري و النقل عبر الأنابيب,كبيرة,3,181,137,44,640,640,0
2022,2,منطقة عسير,النقل البري و النقل عبر الأنابيب,متناهية الصغر,1854,307,166,141,3618,3610,8
2022,2,منطقة عسير,النقل البري و النقل عبر الأنابيب,متوسطة,17,313,171,142,1274,1274,0
2022,2,منطقة مكة المكرمة,النقل البري و النقل عبر الأنابيب,صغيرة,868,2601,1339,1262,11257,11214,43
2022,2,منطقة مكة المكرمة,النقل البري و النقل عبر الأنابيب,كبيرة,15,2216,1585,631,7772,7737,35
2022,2,منطقة مكة المكرمة,النقل البري و النقل عبر الأنابيب,متناهية الصغر,3679,827,430,397,7556,7461,95
2022,2,منطقة مكة المكرمة,النقل البري و النقل عبر الأنابيب,متوسطة,127,2556,1551,1005,9549,9504,45
2022,2,منطقة نجران,النقل البري و النقل عبر الأنابيب,صغيرة,101,197,105,92,1152,1150,2
2022,2,منطقة نجران,النقل البري و النقل عبر الأنابيب,متناهية الصغر,1015,117,62,55,2447,2443,4
2022,2,منطقة نجران,النقل البري و النقل عبر الأنابيب,متوسطة,4,76,48,28,256,256,0
2022,2,المنطقة الشرقية,الطباعة واستنساخ وسائط الأعلام المسجّلة,صغيرة,52,262,134,128,545,545,0
2022,2,المنطقة الشرقية,الطباعة واستنساخ وسائط الأعلام المسجّلة,كبيرة,1,1333,1009,324,982,976,6
2022,2,المنطقة الشرقية,الطباعة واستنساخ وسائط الأعلام المسجّلة,متناهية الصغر,88,67,27,40,130,130,0
2022,2,المنطقة الشرقية,الطباعة واستنساخ وسائط الأعلام المسجّلة,متوسطة,4,125,76,49,253,253,0
2022,2,منطقة الباحة,الطباعة واستنساخ وسائط الأعلام المسجّلة,صغيرة,5,16,8,8,31,31,0
2022,2,منطقة الباحة,الطباعة واستنساخ وسائط الأعلام المسجّلة,متناهية الصغر,6,3,1,2,14,14,0
2022,2,منطقة الجوف,الطباعة واستنساخ وسائط الأعلام المسجّلة,صغيرة,1,1,0,1,5,5,0
2022,2,منطقة الجوف,الطباعة واستنساخ وسائط الأعلام المسجّلة,متناهية الصغر,8,3,2,1,16,16,0
2022,2,منطقة الحدود الشمالية,الطباعة واستنساخ وسائط الأعلام المسجّلة,صغيرة,3,7,4,3,29,29,0
2022,2,منطقة الحدود الشمالية,الطباعة واستنساخ وسائط الأعلام المسجّلة,متناهية الصغر,5,0,0,0,6,6,0
2022,2,منطقة الرياض,الطباعة واستنساخ وسائط الأعلام المسجّلة,صغيرة,151,840,326,514,1666,1657,9
2022,2,منطقة الرياض,الطباعة واستنساخ وسائط الأعلام المسجّلة,كبيرة,1,100,100,0,268,268,0
2022,2,منطقة الرياض,الطباعة واستنساخ وسائط الأعلام المسجّلة,متناهية الصغر,259,173,79,94,458,449,9
2022,2,منطقة الرياض,الطباعة واستنساخ وسائط الأعلام المسجّلة,متوسطة,20,600,279,321,1386,1379,7
2022,2,منطقة القصيم,الطباعة واستنساخ وسائط الأعلام المسجّلة,صغيرة,10,60,34,26,117,117,0
2022,2,منطقة القصيم,الطباعة واستنساخ وسائط الأعلام المسجّلة,متناهية الصغر,30,12,6,6,53,53,0
2022,2,منطقة القصيم,الطباعة واستنساخ وسائط الأعلام المسجّلة,متوسطة,2,54,16,38,96,96,0
2022,2,منطقة المدينة المنورة,الطباعة واستنساخ وسائط الأعلام المسجّلة,صغيرة,8,17,5,12,55,55,0
2022,2,منطقة المدينة المنورة,الطباعة واستنساخ وسائط الأعلام المسجّلة,كبيرة,1,864,864,0,110,110,0
2022,2,منطقة المدينة المنورة,الطباعة واستنساخ وسائط الأعلام المسجّلة,متناهية الصغر,49,16,11,5,97,97,0
2022,2,منطقة المدينة المنورة,الطباعة واستنساخ وسائط الأعلام المسجّلة,متوسطة,1,46,37,9,33,33,0
2022,2,منطقة تبوك,الطباعة واستنساخ وسائط الأعلام المسجّلة,صغيرة,4,11,3,8,37,37,0
2022,2,منطقة تبوك,الطباعة واستنساخ وسائط الأعلام المسجّلة,متناهية الصغر,15,12,8,4,27,25,2
2022,2,منطقة جازان,الطباعة واستنساخ وسائط الأعلام المسجّلة,صغيرة,1,6,3,3,14,14,0
2022,2,منطقة جازان,الطباعة واستنساخ وسائط الأعلام المسجّلة,متناهية الصغر,14,5,4,1,33,33,0
2022,2,منطقة حائل,الطباعة واستنساخ وسائط الأعلام المسجّلة,صغيرة,3,18,15,3,44,44,0
2022,2,منطقة حائل,الطباعة واستنساخ وسائط الأعلام المسجّلة,متناهية الصغر,24,15,10,5,46,46,0
2022,2,منطقة عسير,الطباعة واستنساخ وسائط الأعلام المسجّلة,صغيرة,11,49,19,30,125,124,1
2022,2,منطقة عسير,الطباعة واستنساخ وسائط الأعلام المسجّلة,متناهية الصغر,24,16,9,7,44,43,1
2022,2,منطقة مكة المكرمة,الطباعة واستنساخ وسائط الأعلام المسجّلة,صغيرة,92,416,188,228,981,970,11
2022,2,منطقة مكة المكرمة,الطباعة واستنساخ وسائط الأعلام المسجّلة,متناهية الصغر,219,100,55,45,427,418,9
2022,2,منطقة مكة المكرمة,الطباعة واستنساخ وسائط الأعلام المسجّلة,متوسطة,12,338,139,199,697,684,13
2022,2,منطقة نجران,الطباعة واستنساخ وسائط الأعلام المسجّلة,صغيرة,3,8,3,5,26,25,1
2022,2,منطقة نجران,الطباعة واستنساخ وسائط الأعلام المسجّلة,متناهية الصغر,5,0,0,0,13,13,0
2022,2,المنطقة الشرقية,الصناعة التحويلية الأخرى,صغيرة,77,372,290,82,1090,1088,2
2022,2,المنطقة الشرقية,الصناعة التحويلية الأخرى,كبيرة,3,704,681,23,773,770,3
2022,2,المنطقة الشرقية,الصناعة التحويلية الأخرى,متناهية الصغر,97,61,47,14,171,167,4
2022,2,المنطقة الشرقية,الصناعة التحويلية الأخرى,متوسطة,21,645,425,220,1245,1244,1
2022,2,منطقة الباحة,الصناعة التحويلية الأخرى,صغيرة,2,2,0,2,10,9,1
2022,2,منطقة الباحة,الصناعة التحويلية الأخرى,متناهية الصغر,5,1,1,0,11,11,0
2022,2,منطقة الجوف,الصناعة التحويلية الأخرى,صغيرة,1,0,0,0,8,8,0
2022,2,منطقة الجوف,الصناعة التحويلية الأخرى,متناهية الصغر,5,2,2,0,6,6,0
2022,2,منطقة الحدود الشمالية,الصناعة التحويلية الأخرى,متناهية الصغر,2,0,0,0,5,5,0
2022,2,منطقة الرياض,الصناعة التحويلية الأخرى,صغيرة,160,617,281,336,2323,2248,75
2022,2,منطقة الرياض,الصناعة التحويلية الأخرى,كبيرة,7,931,412,519,3381,3354,27
2022,2,منطقة الرياض,الصناعة التحويلية الأخرى,متناهية الصغر,198,101,58,43,384,377,7
2022,2,منطقة الرياض,الصناعة التحويلية الأخرى,متوسطة,46,995,638,357,3268,3256,12
2022,2,منطقة القصيم,الصناعة التحويلية الأخرى,صغيرة,11,69,48,21,120,120,0
2022,2,منطقة القصيم,الصناعة التحويلية الأخرى,متناهية الصغر,19,14,13,1,38,36,2
2022,2,منطقة القصيم,الصناعة التحويلية الأخرى,متوسطة,1,0,0,0,113,113,0
2022,2,منطقة المدينة المنورة,الصناعة التحويلية الأخرى,صغيرة,9,31,19,12,85,83,2
2022,2,منطقة المدينة المنورة,الصناعة التحويلية الأخرى,كبيرة,1,303,299,4,221,221,0
2022,2,منطقة المدينة المنورة,الصناعة التحويلية الأخرى,متناهية الصغر,31,19,14,5,56,56,0
2022,2,منطقة المدينة المنورة,الصناعة التحويلية الأخرى,متوسطة,2,33,22,11,160,160,0
2022,2,منطقة تبوك,الصناعة التحويلية الأخرى,متناهية الصغر,11,5,4,1,23,21,2
2022,2,منطقة جازان,الصناعة التحويلية الأخرى,صغيرة,2,4,4,0,22,22,0
2022,2,منطقة جازان,الصناعة التحويلية الأخرى,متناهية الصغر,19,7,5,2,40,40,0
2022,2,منطقة حائل,الصناعة التحويلية الأخرى,صغيرة,2,5,5,0,8,8,0
2022,2,منطقة حائل,الصناعة التحويلية الأخرى,متناهية الصغر,13,3,2,1,33,32,1
2022,2,منطقة عسير,الصناعة التحويلية الأخرى,صغيرة,14,49,34,15,158,156,2
2022,2,منطقة عسير,الصناعة التحويلية الأخرى,متناهية الصغر,31,15,10,5,63,61,2
2022,2,منطقة مكة المكرمة,الصناعة التحويلية الأخرى,صغيرة,99,471,234,237,1490,1475,15
2022,2,منطقة مكة المكرمة,الصناعة التحويلية الأخرى,كبيرة,6,711,546,165,2353,2341,12
2022,2,منطقة مكة المكرمة,الصناعة التحويلية الأخرى,متناهية الصغر,163,80,39,41,303,290,13
2022,2,منطقة مكة المكرمة,الصناعة التحويلية الأخرى,متوسطة,21,516,332,184,1631,1627,4
2022,2,منطقة نجران,الصناعة التحويلية الأخرى,صغيرة,1,2,1,1,6,6,0
2022,2,منطقة نجران,الصناعة التحويلية الأخرى,متناهية الصغر,3,3,3,0,6,6,0
2022,2,منطقة نجران,الصناعة التحويلية الأخرى,متوسطة,1,31,31,0,116,116,0
2022,2,المنطقة الشرقية,الصرف الصحي,صغيرة,18,62,36,26,241,241,0
2022,2,المنطقة الشرقية,الصرف الصحي,كبيرة,2,322,273,49,1760,1760,0
2022,2,المنطقة الشرقية,الصرف الصحي,متناهية الصغر,27,16,9,7,60,59,1
2022,2,المنطقة الشرقية,الصرف الصحي,متوسطة,2,20,10,10,96,95,1
2022,2,منطقة الباحة,الصرف الصحي,صغيرة,1,0,0,0,10,10,0
2022,2,منطقة الباحة,الصرف الصحي,متناهية الصغر,3,3,1,2,11,11,0
2022,2,منطقة الجوف,الصرف الصحي,متناهية الصغر,7,1,0,1,13,13,0
2022,2,منطقة الحدود الشمالية,الصرف الصحي,متناهية الصغر,3,0,0,0,11,11,0
2022,2,منطقة الرياض,الصرف الصحي,صغيرة,29,62,32,30,400,399,1
2022,2,منطقة الرياض,الصرف الصحي,كبيرة,2,38,17,21,1919,1918,1
2022,2,منطقة الرياض,الصرف الصحي,متناهية الصغر,106,27,11,16,245,243,2
2022,2,منطقة الرياض,الصرف الصحي,متوسطة,5,83,68,15,426,426,0
2022,2,منطقة القصيم,الصرف الصحي,صغيرة,9,12,4,8,63,62,1
2022,2,منطقة القصيم,الصرف الصحي,متناهية الصغر,16,3,2,1,38,38,0
2022,2,منطقة المدينة المنورة,الصرف الصحي,صغيرة,10,11,9,2,89,89,0
2022,2,منطقة المدينة المنورة,الصرف الصحي,متناهية الصغر,10,2,0,2,22,22,0
2022,2,منطقة تبوك,الصرف الصحي,صغيرة,1,1,0,1,8,8,0
2022,2,منطقة تبوك,الصرف الصحي,متناهية الصغر,6,2,2,0,15,15,0
2022,2,منطقة جازان,الصرف الصحي,متناهية الصغر,21,4,4,0,51,51,0
2022,2,منطقة حائل,الصرف الصحي,صغيرة,4,10,6,4,40,40,0
2022,2,منطقة حائل,الصرف الصحي,متناهية الصغر,11,3,3,0,36,36,0
2022,2,منطقة حائل,الصرف الصحي,متوسطة,1,14,13,1,36,36,0
2022,2,منطقة عسير,الصرف الصحي,صغيرة,2,6,4,2,48,48,0
2022,2,منطقة عسير,الصرف الصحي,متناهية الصغر,11,1,0,1,26,26,0
2022,2,منطقة عسير,الصرف الصحي,متوسطة,1,26,20,6,90,90,0
2022,2,منطقة مكة المكرمة,الصرف الصحي,صغيرة,20,36,23,13,219,218,1
2022,2,منطقة مكة المكرمة,الصرف الصحي,كبيرة,1,245,222,23,134,134,0
2022,2,منطقة مكة المكرمة,الصرف الصحي,متناهية الصغر,71,21,9,12,156,155,1
2022,2,منطقة مكة المكرمة,الصرف الصحي,متوسطة,5,33,24,9,275,274,1
2022,2,منطقة نجران,الصرف الصحي,متناهية الصغر,2,0,0,0,5,5,0
2022,2,المنطقة الشرقية,الصحة البشرية,صغيرة,295,2322,517,1805,3683,1887,1796
2022,2,المنطقة الشرقية,الصحة البشرية,كبيرة,49,22818,10452,12366,19526,9134,10392
2022,2,المنطقة الشرقية,الصحة البشرية,متناهية الصغر,233,204,64,140,383,252,131
2022,2,المنطقة الشرقية,الصحة البشرية,متوسطة,116,5204,1565,3639,7580,4220,3360
2022,2,منطقة الباحة,الصحة البشرية,صغيرة,28,216,84,132,377,150,227
2022,2,منطقة الباحة,الصحة البشرية,كبيرة,1,802,669,133,3,2,1
2022,2,منطقة الباحة,الصحة البشرية,متناهية الصغر,25,24,11,13,38,27,11
2022,2,منطقة الباحة,الصحة البشرية,متوسطة,2,201,169,32,71,29,42
2022,2,منطقة الجوف,الصحة البشرية,صغيرة,39,293,120,173,390,220,170
2022,2,منطقة الجوف,الصحة البشرية,كبيرة,3,1342,880,462,1,1,0
2022,2,منطقة الجوف,الصحة البشرية,متناهية الصغر,18,9,3,6,24,18,6
2022,2,منطقة الجوف,الصحة البشرية,متوسطة,14,718,397,321,496,251,245
2022,2,منطقة الحدود الشمالية,الصحة البشرية,صغيرة,28,140,36,104,292,163,129
2022,2,منطقة الحدود الشمالية,الصحة البشرية,متناهية الصغر,20,25,9,16,41,27,14
2022,2,منطقة الحدود الشمالية,الصحة البشرية,متوسطة,10,753,428,325,211,114,97
2022,2,منطقة الرياض,الصحة البشرية,صغيرة,849,6162,2064,4098,11038,5452,5586
2022,2,منطقة الرياض,الصحة البشرية,كبيرة,90,47897,26213,21684,54639,31571,23068
2022,2,منطقة الرياض,الصحة البشرية,متناهية الصغر,669,504,192,312,1074,734,340
2022,2,منطقة الرياض,الصحة البشرية,متوسطة,275,10645,4127,6518,18871,10860,8011
2022,2,منطقة القصيم,الصحة البشرية,صغيرة,106,810,329,481,1383,658,725
2022,2,منطقة القصيم,الصحة البشرية,كبيرة,15,4393,3216,1177,4025,1294,2731
2022,2,منطقة القصيم,الصحة البشرية,متناهية الصغر,66,43,23,20,121,93,28
2022,2,منطقة القصيم,الصحة البشرية,متوسطة,44,1508,868,640,2982,1651,1331
2022,2,منطقة المدينة المنورة,الصحة البشرية,صغيرة,151,1119,417,702,1973,889,1084
2022,2,منطقة المدينة المنورة,الصحة البشرية,كبيرة,24,11263,7825,3438,4960,2377,2583
2022,2,منطقة المدينة المنورة,الصحة البشرية,متناهية الصغر,78,58,27,31,129,85,44
2022,2,منطقة المدينة المنورة,الصحة البشرية,متوسطة,31,947,353,594,1571,732,839
2022,2,منطقة تبوك,الصحة البشرية,صغيرة,53,374,89,285,617,325,292
2022,2,منطقة تبوك,الصحة البشرية,كبيرة,3,4192,2538,1654,2153,939,1214
2022,2,منطقة تبوك,الصحة البشرية,متناهية الصغر,31,31,10,21,52,41,11
2022,2,منطقة تبوك,الصحة البشرية,متوسطة,12,445,202,243,657,357,300
2022,2,منطقة جازان,الصحة البشرية,صغيرة,95,1081,357,724,1200,569,631
2022,2,منطقة جازان,الصحة البشرية,كبيرة,6,3037,1727,1310,1231,372,859
2022,2,منطقة جازان,الصحة البشرية,متناهية الصغر,75,67,19,48,135,106,29
2022,2,منطقة جازان,الصحة البشرية,متوسطة,18,896,303,593,671,370,301
2022,2,منطقة حائل,الصحة البشرية,صغيرة,56,391,137,254,592,328,264
2022,2,منطقة حائل,الصحة البشرية,كبيرة,7,2087,1261,826,1653,480,1173
2022,2,منطقة حائل,الصحة البشرية,متناهية الصغر,50,41,19,22,78,65,13
2022,2,منطقة حائل,الصحة البشرية,متوسطة,17,876,453,423,1108,506,602
2022,2,منطقة عسير,الصحة البشرية,صغيرة,157,1073,304,769,1931,898,1033
2022,2,منطقة عسير,الصحة البشرية,كبيرة,13,4087,2483,1604,4472,2307,2165
2022,2,منطقة عسير,الصحة البشرية,متناهية الصغر,110,85,24,61,190,129,61
2022,2,منطقة عسير,الصحة البشرية,متوسطة,46,2004,785,1219,2923,1316,1607
2022,2,منطقة مكة المكرمة,الصحة البشرية,صغيرة,667,5110,1387,3723,8095,3975,4120
2022,2,منطقة مكة المكرمة,الصحة البشرية,كبيرة,49,21833,12270,9563,20334,9449,10885
2022,2,منطقة مكة المكرمة,الصحة البشرية,متناهية الصغر,439,349,142,207,720,521,199
2022,2,منطقة مكة المكرمة,الصحة البشرية,متوسطة,191,7024,2346,4678,12099,6081,6018
2022,2,منطقة نجران,الصحة البشرية,صغيرة,57,375,195,180,652,313,339
2022,2,منطقة نجران,الصحة البشرية,كبيرة,3,693,637,56,188,106,82
2022,2,منطقة نجران,الصحة البشرية,متناهية الصغر,30,20,11,9,57,36,21
2022,2,منطقة نجران,الصحة البشرية,متوسطة,20,942,705,237,1177,771,406
2022,2,المنطقة الشرقية,الرعاية مع الإقامة,صغيرة,6,80,3,77,38,16,22
2022,2,المنطقة الشرقية,الرعاية مع الإقامة,متناهية الصغر,7,10,4,6,8,4,4
2022,2,المنطقة الشرقية,الرعاية مع الإقامة,متوسطة,1,63,17,46,65,47,18
2022,2,منطقة الجوف,الرعاية مع الإقامة,متناهية الصغر,4,6,1,5,3,3,0
2022,2,منطقة الرياض,الرعاية مع الإقامة,صغيرة,18,125,16,109,107,44,63
2022,2,منطقة الرياض,الرعاية مع الإقامة,متناهية الصغر,26,21,6,15,38,33,5
2022,2,منطقة الرياض,الرعاية مع الإقامة,متوسطة,4,119,26,93,164,106,58
2022,2,منطقة القصيم,الرعاية مع الإقامة,صغيرة,4,42,11,31,49,41,8
2022,2,منطقة القصيم,الرعاية مع الإقامة,متناهية الصغر,3,5,0,5,4,3,1
2022,2,منطقة المدينة المنورة,الرعاية مع الإقامة,صغيرة,3,39,21,18,39,30,9
2022,2,منطقة المدينة المنورة,الرعاية مع الإقامة,متناهية الصغر,7,13,11,2,5,3,2
2022,2,منطقة تبوك,الرعاية مع الإقامة,صغيرة,1,10,1,9,18,16,2
2022,2,منطقة تبوك,الرعاية مع الإقامة,متناهية الصغر,2,4,1,3,2,1,1
2022,2,منطقة جازان,الرعاية مع الإقامة,صغيرة,4,52,16,36,14,8,6
2022,2,منطقة جازان,الرعاية مع الإقامة,متناهية الصغر,1,1,1,0,1,1,0
2022,2,منطقة حائل,الرعاية مع الإقامة,صغيرة,2,26,8,18,5,3,2
2022,2,منطقة حائل,الرعاية مع الإقامة,متناهية الصغر,1,2,0,2,0,0,0
2022,2,منطقة عسير,الرعاية مع الإقامة,صغيرة,4,55,2,53,24,5,19
2022,2,منطقة عسير,الرعاية مع الإقامة,متناهية الصغر,5,4,0,4,7,7,0
2022,2,منطقة مكة المكرمة,الرعاية مع الإقامة,صغيرة,13,143,30,113,109,67,42
2022,2,منطقة مكة المكرمة,الرعاية مع الإقامة,متناهية الصغر,20,26,2,24,32,19,13
2022,2,منطقة مكة المكرمة,الرعاية مع الإقامة,متوسطة,1,44,7,37,19,6,13
2022,2,منطقة نجران,الرعاية مع الإقامة,صغيرة,1,6,0,6,4,0,4
2022,2,المنطقة الشرقية,الحراجة وقطع الأخشاب,متناهية الصغر,3,1,0,1,4,4,0
2022,2,منطقة الرياض,الحراجة وقطع الأخشاب,صغيرة,1,4,2,2,2,2,0
2022,2,منطقة الرياض,الحراجة وقطع الأخشاب,متناهية الصغر,4,0,0,0,7,7,0
2022,2,منطقة القصيم,الحراجة وقطع الأخشاب,متناهية الصغر,1,0,0,0,1,1,0
2022,2,منطقة جازان,الحراجة وقطع الأخشاب,متناهية الصغر,1,1,0,1,0,0,0
2022,2,منطقة مكة المكرمة,الحراجة وقطع الأخشاب,متناهية الصغر,3,0,0,0,9,9,0
2022,2,المنطقة الشرقية,التعليم,صغيرة,276,3185,901,2284,1973,1702,271
2022,2,المنطقة الشرقية,التعليم,كبيرة,17,5110,2609,2501,1652,1304,348
2022,2,المنطقة الشرقية,التعليم,متناهية الصغر,351,361,123,238,418,374,44
2022,2,المنطقة الشرقية,التعليم,متوسطة,93,5509,1891,3618,4275,3610,665
2022,2,منطقة الباحة,التعليم,صغيرة,8,110,43,67,86,80,6
2022,2,منطقة الباحة,التعليم,متناهية الصغر,22,17,6,11,31,27,4
2022,2,منطقة الباحة,التعليم,متوسطة,1,175,103,72,0,0,0
2022,2,منطقة الجوف,التعليم,صغيرة,31,415,141,274,231,199,32
2022,2,منطقة الجوف,التعليم,متناهية الصغر,47,35,15,20,61,54,7
2022,2,منطقة الجوف,التعليم,متوسطة,10,443,228,215,355,348,7
2022,2,منطقة الحدود الشمالية,التعليم,صغيرة,18,191,142,49,163,162,1
2022,2,منطقة الحدود الشمالية,التعليم,كبيرة,1,56,39,17,450,266,184
2022,2,منطقة الحدود الشمالية,التعليم,متناهية الصغر,24,24,3,21,35,34,1
2022,2,منطقة الحدود الشمالية,التعليم,متوسطة,3,183,55,128,63,49,14
2022,2,منطقة الرياض,التعليم,صغيرة,585,5522,1440,4082,4641,3913,728
2022,2,منطقة الرياض,التعليم,كبيرة,56,21969,10488,11481,13747,10905,2842
2022,2,منطقة الرياض,التعليم,متناهية الصغر,4793,1138,473,665,9510,9348,162
2022,2,منطقة الرياض,التعليم,متوسطة,214,14247,5219,9028,10463,8972,1491
2022,2,منطقة القصيم,التعليم,صغيرة,55,706,198,508,424,386,38
2022,2,منطقة القصيم,التعليم,كبيرة,4,666,350,316,1577,972,605
2022,2,منطقة القصيم,التعليم,متناهية الصغر,121,68,21,47,193,184,9
2022,2,منطقة القصيم,التعليم,متوسطة,16,886,451,435,476,396,80
2022,2,منطقة المدينة المنورة,التعليم,صغيرة,91,1161,286,875,477,411,66
2022,2,منطقة المدينة المنورة,التعليم,كبيرة,3,1505,790,715,140,105,35
2022,2,منطقة المدينة المنورة,التعليم,متناهية الصغر,147,120,28,92,213,196,17
2022,2,منطقة المدينة المنورة,التعليم,متوسطة,33,2224,897,1327,1556,1269,287
2022,2,منطقة تبوك,التعليم,صغيرة,41,467,150,317,299,269,30
2022,2,منطقة تبوك,التعليم,كبيرة,3,430,176,254,814,594,220
2022,2,منطقة تبوك,التعليم,متناهية الصغر,43,58,10,48,52,49,3
2022,2,منطقة تبوك,التعليم,متوسطة,15,867,438,429,607,566,41
2022,2,منطقة جازان,التعليم,صغيرة,47,396,145,251,299,271,28
2022,2,منطقة جازان,التعليم,كبيرة,1,29,23,6,1408,745,663
2022,2,منطقة جازان,التعليم,متناهية الصغر,100,65,22,43,158,150,8
2022,2,منطقة جازان,التعليم,متوسطة,3,122,64,58,119,65,54
2022,2,منطقة حائل,التعليم,صغيرة,26,303,63,240,108,92,16
2022,2,منطقة حائل,التعليم,كبيرة,1,31,13,18,811,452,359
2022,2,منطقة حائل,التعليم,متناهية الصغر,100,34,13,21,209,207,2
2022,2,منطقة حائل,التعليم,متوسطة,5,314,215,99,223,221,2
2022,2,منطقة عسير,التعليم,صغيرة,60,787,226,561,406,373,33
2022,2,منطقة عسير,التعليم,كبيرة,1,11,9,2,423,271,152
2022,2,منطقة عسير,التعليم,متناهية الصغر,102,73,23,50,136,127,9
2022,2,منطقة عسير,التعليم,متوسطة,16,1002,527,475,551,487,64
2022,2,منطقة مكة المكرمة,التعليم,صغيرة,357,3977,822,3155,2606,1939,667
2022,2,منطقة مكة المكرمة,التعليم,كبيرة,17,6410,3448,2962,4244,2897,1347
2022,2,منطقة مكة المكرمة,التعليم,متناهية الصغر,594,426,134,292,896,778,118
2022,2,منطقة مكة المكرمة,التعليم,متوسطة,139,7833,3263,4570,6485,5162,1323
2022,2,منطقة نجران,التعليم,صغيرة,19,163,55,108,112,109,3
2022,2,منطقة نجران,التعليم,متناهية الصغر,68,25,5,20,125,123,2
2022,2,منطقة نجران,التعليم,متوسطة,7,252,138,114,211,206,5
2022,2,المنطقة الشرقية,التخزين وأنشطة الدعم للنقل,صغيرة,244,1195,905,290,2279,2268,11
2022,2,المنطقة الشرقية,التخزين وأنشطة الدعم للنقل,كبيرة,10,3185,2850,335,6023,5976,47
2022,2,المنطقة الشرقية,التخزين وأنشطة الدعم للنقل,متناهية الصغر,696,485,355,130,1177,1169,8
2022,2,المنطقة الشرقية,التخزين وأنشطة الدعم للنقل,متوسطة,55,2062,1473,589,3379,3362,17
2022,2,منطقة الباحة,التخزين وأنشطة الدعم للنقل,متناهية الصغر,28,7,4,3,49,48,1
2022,2,منطقة الجوف,التخزين وأنشطة الدعم للنقل,صغيرة,23,90,82,8,242,241,1
2022,2,منطقة الجوف,التخزين وأنشطة الدعم للنقل,متناهية الصغر,106,36,30,6,196,196,0
2022,2,منطقة الحدود الشمالية,التخزين وأنشطة الدعم للنقل,صغيرة,2,4,2,2,19,19,0
2022,2,منطقة الحدود الشمالية,التخزين وأنشطة الدعم للنقل,متناهية الصغر,30,4,4,0,54,54,0
2022,2,منطقة الرياض,التخزين وأنشطة الدعم للنقل,صغيرة,409,1896,1020,876,4837,4792,45
2022,2,منطقة الرياض,التخزين وأنشطة الدعم للنقل,كبيرة,32,11843,8921,2922,11677,11520,157
2022,2,منطقة الرياض,التخزين وأنشطة الدعم للنقل,متناهية الصغر,1446,510,298,212,3012,2999,13
2022,2,منطقة الرياض,التخزين وأنشطة الدعم للنقل,متوسطة,90,2776,1526,1250,6876,6819,57
2022,2,منطقة القصيم,التخزين وأنشطة الدعم للنقل,صغيرة,29,70,49,21,330,330,0
2022,2,منطقة القصيم,التخزين وأنشطة الدعم للنقل,كبيرة,1,18,16,2,356,356,0
2022,2,منطقة القصيم,التخزين وأنشطة الدعم للنقل,متناهية الصغر,148,50,29,21,310,309,1
2022,2,منطقة القصيم,التخزين وأنشطة الدعم للنقل,متوسطة,5,129,82,47,395,395,0
2022,2,منطقة المدينة المنورة,التخزين وأنشطة الدعم للنقل,صغيرة,36,149,106,43,313,310,3
2022,2,منطقة المدينة المنورة,التخزين وأنشطة الدعم للنقل,كبيرة,2,1043,953,90,319,319,0
2022,2,منطقة المدينة المنورة,التخزين وأنشطة الدعم للنقل,متناهية الصغر,223,39,24,15,441,441,0
2022,2,منطقة المدينة المنورة,التخزين وأنشطة الدعم للنقل,متوسطة,5,177,160,17,274,274,0
2022,2,منطقة تبوك,التخزين وأنشطة الدعم للنقل,صغيرة,18,73,48,25,119,119,0
2022,2,منطقة تبوك,التخزين وأنشطة الدعم للنقل,متناهية الصغر,77,38,27,11,125,125,0
2022,2,منطقة تبوك,التخزين وأنشطة الدعم للنقل,متوسطة,1,45,11,34,34,34,0
2022,2,منطقة جازان,التخزين وأنشطة الدعم للنقل,صغيرة,13,46,35,11,95,94,1
2022,2,منطقة جازان,التخزين وأنشطة الدعم للنقل,متناهية الصغر,74,25,19,6,151,150,1
2022,2,منطقة جازان,التخزين وأنشطة الدعم للنقل,متوسطة,1,23,7,16,31,31,0
2022,2,منطقة حائل,التخزين وأنشطة الدعم للنقل,صغيرة,11,9,8,1,86,86,0
2022,2,منطقة حائل,التخزين وأنشطة الدعم للنقل,متناهية الصغر,61,21,13,8,128,128,0
2022,2,منطقة عسير,التخزين وأنشطة الدعم للنقل,صغيرة,24,103,79,24,321,321,0
2022,2,منطقة عسير,التخزين وأنشطة الدعم للنقل,متناهية الصغر,131,48,31,17,287,287,0
2022,2,منطقة عسير,التخزين وأنشطة الدعم للنقل,متوسطة,4,131,103,28,212,212,0
2022,2,منطقة مكة المكرمة,التخزين وأنشطة الدعم للنقل,صغيرة,382,1643,1052,591,4212,4155,57
2022,2,منطقة مكة المكرمة,التخزين وأنشطة الدعم للنقل,كبيرة,26,7416,6468,948,11706,11683,23
2022,2,منطقة مكة المكرمة,التخزين وأنشطة الدعم للنقل,متناهية الصغر,818,461,309,152,1438,1412,26
2022,2,منطقة مكة المكرمة,التخزين وأنشطة الدعم للنقل,متوسطة,78,2666,2008,658,5608,5570,38
2022,2,منطقة نجران,التخزين وأنشطة الدعم للنقل,صغيرة,95,57,30,27,863,863,0
2022,2,منطقة نجران,التخزين وأنشطة الدعم للنقل,متناهية الصغر,473,58,31,27,1241,1238,3
2022,2,المنطقة الشرقية,البحث والتطوير في المجال العلمي,صغيرة,10,48,33,15,42,41,1
2022,2,المنطقة الشرقية,البحث والتطوير في المجال العلمي,متناهية الصغر,11,10,4,6,9,9,0
2022,2,المنطقة الشرقية,البحث والتطوير في المجال العلمي,متوسطة,2,127,75,52,116,115,1
2022,2,منطقة الحدود الشمالية,البحث والتطوير في المجال العلمي,متناهية الصغر,1,1,1,0,2,2,0
2022,2,منطقة الرياض,البحث والتطوير في المجال العلمي,صغيرة,35,264,166,98,212,198,14
2022,2,منطقة الرياض,البحث والتطوير في المجال العلمي,متناهية الصغر,77,81,47,34,77,71,6
2022,2,منطقة الرياض,البحث والتطوير في المجال العلمي,متوسطة,5,289,173,116,239,230,9
2022,2,منطقة القصيم,البحث والتطوير في المجال العلمي,متناهية الصغر,4,1,0,1,6,6,0
2022,2,منطقة المدينة المنورة,البحث والتطوير في المجال العلمي,متناهية الصغر,10,10,5,5,11,10,1
2022,2,منطقة تبوك,البحث والتطوير في المجال العلمي,صغيرة,1,1,1,0,6,6,0
2022,2,منطقة تبوك,البحث والتطوير في المجال العلمي,متناهية الصغر,1,0,0,0,1,1,0
2022,2,منطقة جازان,البحث والتطوير في المجال العلمي,صغيرة,1,5,4,1,1,1,0
2022,2,منطقة جازان,البحث والتطوير في المجال العلمي,متناهية الصغر,2,3,0,3,2,2,0
2022,2,منطقة حائل,البحث والتطوير في المجال العلمي,متناهية الصغر,1,3,0,3,0,0,0
2022,2,منطقة عسير,البحث والتطوير في المجال العلمي,متناهية الصغر,4,7,0,7,3,3,0
2022,2,منطقة مكة المكرمة,البحث والتطوير في المجال العلمي,صغيرة,9,55,27,28,85,84,1
2022,2,منطقة مكة المكرمة,البحث والتطوير في المجال العلمي,متناهية الصغر,44,42,14,28,60,55,5
2022,2,منطقة مكة المكرمة,البحث والتطوير في المجال العلمي,متوسطة,4,307,302,5,180,175,5
2022,2,المنطقة الشرقية,الأنشطة غير المتميزة لإنتاج السلع والخدمات التي تقوم بها الأسر المعيشية الخاصة لإستعمالها الخاص,صغيرة,1,0,0,0,12,12,0
2022,2,المنطقة الشرقية,الأنشطة غير المتميزة لإنتاج السلع والخدمات التي تقوم بها الأسر المعيشية الخاصة لإستعمالها الخاص,متناهية الصغر,2,0,0,0,2,2,0
2022,2,منطقة الرياض,الأنشطة غير المتميزة لإنتاج السلع والخدمات التي تقوم بها الأسر المعيشية الخاصة لإستعمالها الخاص,صغيرة,1,1,0,1,6,6,0
2022,2,منطقة الرياض,الأنشطة غير المتميزة لإنتاج السلع والخدمات التي تقوم بها الأسر المعيشية الخاصة لإستعمالها الخاص,متناهية الصغر,2,0,0,0,2,2,0
2022,2,منطقة القصيم,الأنشطة غير المتميزة لإنتاج السلع والخدمات التي تقوم بها الأسر المعيشية الخاصة لإستعمالها الخاص,متناهية الصغر,2,0,0,0,3,3,0
2022,2,منطقة مكة المكرمة,الأنشطة غير المتميزة لإنتاج السلع والخدمات التي تقوم بها الأسر المعيشية الخاصة لإستعمالها الخاص,متناهية الصغر,1,0,0,0,1,0,1
2022,2,المنطقة الشرقية,الأنشطة المهنية والعلمية والتقنية الأخرى,صغيرة,32,136,59,77,209,191,18
2022,2,المنطقة الشرقية,الأنشطة المهنية والعلمية والتقنية الأخرى,كبيرة,1,276,234,42,355,353,2
2022,2,المنطقة الشرقية,الأنشطة المهنية والعلمية والتقنية الأخرى,متناهية الصغر,190,156,74,82,245,207,38
2022,2,منطقة الباحة,الأنشطة المهنية والعلمية والتقنية الأخرى,متناهية الصغر,11,3,2,1,18,16,2
2022,2,منطقة الجوف,الأنشطة المهنية والعلمية والتقنية الأخرى,صغيرة,3,3,2,1,26,26,0
2022,2,منطقة الجوف,الأنشطة المهنية والعلمية والتقنية الأخرى,متناهية الصغر,16,5,4,1,27,25,2
2022,2,منطقة الحدود الشمالية,الأنشطة المهنية والعلمية والتقنية الأخرى,متناهية الصغر,10,1,1,0,20,16,4
2022,2,منطقة الرياض,الأنشطة المهنية والعلمية والتقنية الأخرى,صغيرة,122,683,304,379,881,769,112
2022,2,منطقة الرياض,الأنشطة المهنية والعلمية والتقنية الأخرى,كبيرة,5,784,585,199,891,882,9
2022,2,منطقة الرياض,الأنشطة المهنية والعلمية والتقنية الأخرى,متناهية الصغر,513,327,126,201,822,698,124
2022,2,منطقة الرياض,الأنشطة المهنية والعلمية والتقنية الأخرى,متوسطة,9,610,352,258,503,480,23
2022,2,منطقة القصيم,الأنشطة المهنية والعلمية والتقنية الأخرى,صغيرة,8,56,37,19,147,147,0
2022,2,منطقة القصيم,الأنشطة المهنية والعلمية والتقنية الأخرى,متناهية الصغر,40,18,13,5,69,61,8
2022,2,منطقة المدينة المنورة,الأنشطة المهنية والعلمية والتقنية الأخرى,صغيرة,8,28,17,11,64,52,12
2022,2,منطقة المدينة المنورة,الأنشطة المهنية والعلمية والتقنية الأخرى,متناهية الصغر,87,37,15,22,149,125,24
2022,2,منطقة تبوك,الأنشطة المهنية والعلمية والتقنية الأخرى,متناهية الصغر,32,6,3,3,69,67,2
2022,2,منطقة جازان,الأنشطة المهنية والعلمية والتقنية الأخرى,صغيرة,2,14,1,13,5,5,0
2022,2,منطقة جازان,الأنشطة المهنية والعلمية والتقنية الأخرى,متناهية الصغر,36,9,3,6,56,53,3
2022,2,منطقة حائل,الأنشطة المهنية والعلمية والتقنية الأخرى,صغيرة,1,2,0,2,5,5,0
2022,2,منطقة حائل,الأنشطة المهنية والعلمية والتقنية الأخرى,متناهية الصغر,22,3,0,3,38,33,5
2022,2,منطقة عسير,الأنشطة المهنية والعلمية والتقنية الأخرى,صغيرة,7,23,9,14,43,31,12
2022,2,منطقة عسير,الأنشطة المهنية والعلمية والتقنية الأخرى,متناهية الصغر,46,12,6,6,91,86,5
2022,2,منطقة عسير,الأنشطة المهنية والعلمية والتقنية الأخرى,متوسطة,1,21,20,1,67,67,0
2022,2,منطقة مكة المكرمة,الأنشطة المهنية والعلمية والتقنية الأخرى,صغيرة,72,322,162,160,623,576,47
2022,2,منطقة مكة المكرمة,الأنشطة المهنية والعلمية والتقنية الأخرى,متناهية الصغر,408,220,70,150,714,600,114
2022,2,منطقة مكة المكرمة,الأنشطة المهنية والعلمية والتقنية الأخرى,متوسطة,5,162,131,31,176,175,1
2022,2,منطقة نجران,الأنشطة المهنية والعلمية والتقنية الأخرى,متناهية الصغر,27,1,1,0,59,56,3
2022,2,المنطقة الشرقية,الأنشطة المساعدة لأنشطة الخدمات المالية وأنشطة التأمين,صغيرة,27,304,192,112,140,138,2
2022,2,المنطقة الشرقية,الأنشطة المساعدة لأنشطة الخدمات المالية وأنشطة التأمين,كبيرة,1,218,97,121,45,41,4
2022,2,المنطقة الشرقية,الأنشطة المساعدة لأنشطة الخدمات المالية وأنشطة التأمين,متناهية الصغر,38,32,27,5,53,47,6
2022,2,المنطقة الشرقية,الأنشطة المساعدة لأنشطة الخدمات المالية وأنشطة التأمين,متوسطة,3,211,102,109,70,64,6
2022,2,منطقة الجوف,الأنشطة المساعدة لأنشطة الخدمات المالية وأنشطة التأمين,متناهية الصغر,2,0,0,0,4,4,0
2022,2,منطقة الرياض,الأنشطة المساعدة لأنشطة الخدمات المالية وأنشطة التأمين,صغيرة,141,1866,1160,706,788,752,36
2022,2,منطقة الرياض,الأنشطة المساعدة لأنشطة الخدمات المالية وأنشطة التأمين,كبيرة,13,29331,23382,5949,1846,1807,39
2022,2,منطقة الرياض,الأنشطة المساعدة لأنشطة الخدمات المالية وأنشطة التأمين,متناهية الصغر,165,234,142,92,152,149,3
2022,2,منطقة الرياض,الأنشطة المساعدة لأنشطة الخدمات المالية وأنشطة التأمين,متوسطة,38,4075,2871,1204,862,810,52
2022,2,منطقة القصيم,الأنشطة المساعدة لأنشطة الخدمات المالية وأنشطة التأمين,صغيرة,1,0,0,0,12,12,0
2022,2,منطقة القصيم,الأنشطة المساعدة لأنشطة الخدمات المالية وأنشطة التأمين,متناهية الصغر,5,5,2,3,3,3,0
2022,2,منطقة المدينة المنورة,الأنشطة المساعدة لأنشطة الخدمات المالية وأنشطة التأمين,صغيرة,2,11,8,3,4,4,0
2022,2,منطقة المدينة المنورة,الأنشطة المساعدة لأنشطة الخدمات المالية وأنشطة التأمين,متناهية الصغر,15,33,31,2,19,19,0
2022,2,منطقة المدينة المنورة,الأنشطة المساعدة لأنشطة الخدمات المالية وأنشطة التأمين,متوسطة,1,21,13,8,85,85,0
2022,2,منطقة تبوك,الأنشطة المساعدة لأنشطة الخدمات المالية وأنشطة التأمين,متناهية الصغر,2,0,0,0,4,4,0
2022,2,منطقة جازان,الأنشطة المساعدة لأنشطة الخدمات المالية وأنشطة التأمين,متناهية الصغر,1,0,0,0,2,2,0
2022,2,منطقة عسير,الأنشطة المساعدة لأنشطة الخدمات المالية وأنشطة التأمين,متناهية الصغر,5,1,1,0,5,5,0
2022,2,منطقة مكة المكرمة,الأنشطة المساعدة لأنشطة الخدمات المالية وأنشطة التأمين,صغيرة,49,480,275,205,272,261,11
2022,2,منطقة مكة المكرمة,الأنشطة المساعدة لأنشطة الخدمات المالية وأنشطة التأمين,متناهية الصغر,64,87,56,31,79,77,2
2022,2,منطقة مكة المكرمة,الأنشطة المساعدة لأنشطة الخدمات المالية وأنشطة التأمين,متوسطة,13,915,586,329,261,251,10
2022,2,منطقة نجران,الأنشطة المساعدة لأنشطة الخدمات المالية وأنشطة التأمين,صغيرة,1,21,20,1,11,11,0
2022,2,منطقة نجران,الأنشطة المساعدة لأنشطة الخدمات المالية وأنشطة التأمين,متناهية الصغر,2,0,0,0,3,3,0
2022,2,المنطقة الشرقية,الأنشطة القانونية وأنشطة المحاسبة,صغيرة,96,669,413,256,451,441,10
2022,2,المنطقة الشرقية,الأنشطة القانونية وأنشطة المحاسبة,متناهية الصغر,247,330,202,128,255,248,7
2022,2,المنطقة الشرقية,الأنشطة القانونية وأنشطة المحاسبة,متوسطة,8,414,216,198,440,426,14
2022,2,منطقة الباحة,الأنشطة القانونية وأنشطة المحاسبة,متناهية الصغر,11,18,8,10,16,16,0
2022,2,منطقة الجوف,الأنشطة القانونية وأنشطة المحاسبة,صغيرة,7,32,21,11,10,10,0
2022,2,منطقة الجوف,الأنشطة القانونية وأنشطة المحاسبة,متناهية الصغر,25,34,24,10,22,22,0
2022,2,منطقة الحدود الشمالية,الأنشطة القانونية وأنشطة المحاسبة,متناهية الصغر,6,8,4,4,5,5,0
2022,2,منطقة الرياض,الأنشطة القانونية وأنشطة المحاسبة,صغيرة,428,3218,1959,1259,2434,2342,92
2022,2,منطقة الرياض,الأنشطة القانونية وأنشطة المحاسبة,كبيرة,1,428,241,187,297,283,14
2022,2,منطقة الرياض,الأنشطة القانونية وأنشطة المحاسبة,متناهية الصغر,1352,1314,850,464,1835,1805,30
2022,2,منطقة الرياض,الأنشطة القانونية وأنشطة المحاسبة,متوسطة,30,1230,703,527,1521,1459,62
2022,2,منطقة القصيم,الأنشطة القانونية وأنشطة المحاسبة,صغيرة,14,83,45,38,30,30,0
2022,2,منطقة القصيم,الأنشطة القانونية وأنشطة المحاسبة,متناهية الصغر,77,91,49,42,61,60,1
2022,2,منطقة المدينة المنورة,الأنشطة القانونية وأنشطة المحاسبة,صغيرة,25,184,106,78,98,95,3
2022,2,منطقة المدينة المنورة,الأنشطة القانونية وأنشطة المحاسبة,متناهية الصغر,81,105,75,30,79,76,3
2022,2,منطقة تبوك,الأنشطة القانونية وأنشطة المحاسبة,صغيرة,3,17,9,8,4,4,0
2022,2,منطقة تبوك,الأنشطة القانونية وأنشطة المحاسبة,متناهية الصغر,15,18,4,14,11,11,0
2022,2,منطقة جازان,الأنشطة القانونية وأنشطة المحاسبة,صغيرة,5,48,32,16,8,8,0
2022,2,منطقة جازان,الأنشطة القانونية وأنشطة المحاسبة,متناهية الصغر,28,28,20,8,26,26,0
2022,2,منطقة حائل,الأنشطة القانونية وأنشطة المحاسبة,صغيرة,1,7,7,0,9,9,0
2022,2,منطقة حائل,الأنشطة القانونية وأنشطة المحاسبة,متناهية الصغر,29,35,24,11,29,29,0
2022,2,منطقة عسير,الأنشطة القانونية وأنشطة المحاسبة,صغيرة,5,34,28,6,61,61,0
2022,2,منطقة عسير,الأنشطة القانونية وأنشطة المحاسبة,متناهية الصغر,58,63,50,13,70,69,1
2022,2,منطقة عسير,الأنشطة القانونية وأنشطة المحاسبة,متوسطة,2,77,43,34,82,82,0
2022,2,منطقة مكة المكرمة,الأنشطة القانونية وأنشطة المحاسبة,صغيرة,244,1816,1105,711,1170,1107,63
2022,2,منطقة مكة المكرمة,الأنشطة القانونية وأنشطة المحاسبة,متناهية الصغر,650,847,546,301,685,658,27
2022,2,منطقة مكة المكرمة,الأنشطة القانونية وأنشطة المحاسبة,متوسطة,11,556,377,179,698,679,19
2022,2,منطقة نجران,الأنشطة القانونية وأنشطة المحاسبة,صغيرة,1,9,8,1,18,18,0
2022,2,منطقة نجران,الأنشطة القانونية وأنشطة المحاسبة,متناهية الصغر,34,6,4,2,63,62,1
2022,2,المنطقة الشرقية,الأنشطة العقارية,صغيرة,222,1194,754,440,1946,1925,21
2022,2,المنطقة الشرقية,الأنشطة العقارية,كبيرة,3,359,99,260,580,570,10
2022,2,المنطقة الشرقية,الأنشطة العقارية,متناهية الصغر,622,474,281,193,882,873,9
2022,2,المنطقة الشرقية,الأنشطة العقارية,متوسطة,19,765,553,212,1185,1176,9
2022,2,منطقة الباحة,الأنشطة العقارية,صغيرة,5,28,24,4,47,47,0
2022,2,منطقة الباحة,الأنشطة العقارية,متناهية الصغر,20,14,8,6,32,32,0
2022,2,منطقة الجوف,الأنشطة العقارية,صغيرة,7,40,26,14,65,64,1
2022,2,منطقة الجوف,الأنشطة العقارية,متناهية الصغر,47,30,22,8,71,71,0
2022,2,منطقة الجوف,الأنشطة العقارية,متوسطة,1,20,11,9,50,49,1
2022,2,منطقة الحدود الشمالية,الأنشطة العقارية,صغيرة,6,36,24,12,78,78,0
2022,2,منطقة الحدود الشمالية,الأنشطة العقارية,متناهية الصغر,41,11,9,2,74,74,0
2022,2,منطقة الرياض,الأنشطة العقارية,صغيرة,719,4528,2737,1791,6424,6287,137
2022,2,منطقة الرياض,الأنشطة العقارية,كبيرة,13,2685,1841,844,5236,4180,1056
2022,2,منطقة الرياض,الأنشطة العقارية,متناهية الصغر,2106,1793,1088,705,2806,2769,37
2022,2,منطقة الرياض,الأنشطة العقارية,متوسطة,85,3751,1969,1782,4215,4157,58
2022,2,منطقة القصيم,الأنشطة العقارية,صغيرة,32,127,76,51,201,199,2
2022,2,منطقة القصيم,الأنشطة العقارية,كبيرة,1,129,77,52,294,294,0
2022,2,منطقة القصيم,الأنشطة العقارية,متناهية الصغر,184,102,72,30,290,287,3
2022,2,منطقة القصيم,الأنشطة العقارية,متوسطة,7,249,164,85,617,617,0
2022,2,منطقة المدينة المنورة,الأنشطة العقارية,صغيرة,48,194,131,63,478,473,5
2022,2,منطقة المدينة المنورة,الأنشطة العقارية,كبيرة,1,171,154,17,201,201,0
2022,2,منطقة المدينة المنورة,الأنشطة العقارية,متناهية الصغر,269,142,75,67,416,416,0
2022,2,منطقة المدينة المنورة,الأنشطة العقارية,متوسطة,3,71,44,27,301,293,8
2022,2,منطقة تبوك,الأنشطة العقارية,صغيرة,11,39,30,9,109,109,0
2022,2,منطقة تبوك,الأنشطة العقارية,متناهية الصغر,105,44,26,18,165,165,0
2022,2,منطقة جازان,الأنشطة العقارية,صغيرة,21,56,25,31,185,185,0
2022,2,منطقة جازان,الأنشطة العقارية,متناهية الصغر,135,56,31,25,226,224,2
2022,2,منطقة جازان,الأنشطة العقارية,متوسطة,4,190,41,149,196,196,0
2022,2,منطقة حائل,الأنشطة العقارية,صغيرة,10,30,18,12,75,75,0
2022,2,منطقة حائل,الأنشطة العقارية,متناهية الصغر,93,45,21,24,159,159,0
2022,2,منطقة حائل,الأنشطة العقارية,متوسطة,1,0,0,0,134,134,0
2022,2,منطقة عسير,الأنشطة العقارية,صغيرة,37,184,113,71,344,344,0
2022,2,منطقة عسير,الأنشطة العقارية,متناهية الصغر,243,114,64,50,396,395,1
2022,2,منطقة عسير,الأنشطة العقارية,متوسطة,4,86,47,39,312,311,1
2022,2,منطقة مكة المكرمة,الأنشطة العقارية,صغيرة,461,2341,1399,942,4276,4179,97
2022,2,منطقة مكة المكرمة,الأنشطة العقارية,كبيرة,6,1464,1007,457,2602,2565,37
2022,2,منطقة مكة المكرمة,الأنشطة العقارية,متناهية الصغر,1651,1047,628,419,2533,2475,58
2022,2,منطقة مكة المكرمة,الأنشطة العقارية,متوسطة,43,1700,1205,495,2784,2717,67
2022,2,منطقة نجران,الأنشطة العقارية,صغيرة,5,25,15,10,39,39,0
2022,2,منطقة نجران,الأنشطة العقارية,متناهية الصغر,51,6,3,3,92,92,0
2022,2,المنطقة الشرقية,الأنشطة الرياضية وأنشطة التسلية والترفيه,صغيرة,129,567,299,268,1012,902,110
2022,2,المنطقة الشرقية,الأنشطة الرياضية وأنشطة التسلية والترفيه,كبيرة,1,22,11,11,291,272,19
2022,2,المنطقة الشرقية,الأنشطة الرياضية وأنشطة التسلية والترفيه,متناهية الصغر,286,275,104,171,430,383,47
2022,2,المنطقة الشرقية,الأنشطة الرياضية وأنشطة التسلية والترفيه,متوسطة,9,229,97,132,559,556,3
2022,2,منطقة الباحة,الأنشطة الرياضية وأنشطة التسلية والترفيه,صغيرة,5,20,15,5,33,32,1
2022,2,منطقة الباحة,الأنشطة الرياضية وأنشطة التسلية والترفيه,متناهية الصغر,25,16,9,7,46,42,4
2022,2,منطقة الجوف,الأنشطة الرياضية وأنشطة التسلية والترفيه,صغيرة,9,55,41,14,62,58,4
2022,2,منطقة الجوف,الأنشطة الرياضية وأنشطة التسلية والترفيه,متناهية الصغر,41,18,12,6,73,66,7
2022,2,منطقة الحدود الشمالية,الأنشطة الرياضية وأنشطة التسلية والترفيه,صغيرة,10,36,16,20,72,63,9
2022,2,منطقة الحدود الشمالية,الأنشطة الرياضية وأنشطة التسلية والترفيه,متناهية الصغر,37,19,10,9,92,81,11
2022,2,منطقة الرياض,الأنشطة الرياضية وأنشطة التسلية والترفيه,صغيرة,258,1459,596,863,2446,2096,350
2022,2,منطقة الرياض,الأنشطة الرياضية وأنشطة التسلية والترفيه,كبيرة,5,1574,966,608,1993,1740,253
2022,2,منطقة الرياض,الأنشطة الرياضية وأنشطة التسلية والترفيه,متناهية الصغر,645,504,201,303,994,901,93
2022,2,منطقة الرياض,الأنشطة الرياضية وأنشطة التسلية والترفيه,متوسطة,26,1155,551,604,1720,1523,197
2022,2,منطقة القصيم,الأنشطة الرياضية وأنشطة التسلية والترفيه,صغيرة,39,243,122,121,360,332,28
2022,2,منطقة القصيم,الأنشطة الرياضية وأنشطة التسلية والترفيه,متناهية الصغر,75,67,20,47,127,109,18
2022,2,منطقة القصيم,الأنشطة الرياضية وأنشطة التسلية والترفيه,متوسطة,3,75,37,38,251,251,0
2022,2,منطقة المدينة المنورة,الأنشطة الرياضية وأنشطة التسلية والترفيه,صغيرة,27,202,76,126,247,228,19
2022,2,منطقة المدينة المنورة,الأنشطة الرياضية وأنشطة التسلية والترفيه,متناهية الصغر,93,67,28,39,163,141,22
2022,2,منطقة المدينة المنورة,الأنشطة الرياضية وأنشطة التسلية والترفيه,متوسطة,2,80,48,32,72,63,9
2022,2,منطقة تبوك,الأنشطة الرياضية وأنشطة التسلية والترفيه,صغيرة,12,42,10,32,86,74,12
2022,2,منطقة تبوك,الأنشطة الرياضية وأنشطة التسلية والترفيه,متناهية الصغر,74,51,28,23,127,117,10
2022,2,منطقة تبوك,الأنشطة الرياضية وأنشطة التسلية والترفيه,متوسطة,1,40,34,6,22,22,0
2022,2,منطقة جازان,الأنشطة الرياضية وأنشطة التسلية والترفيه,صغيرة,7,18,12,6,44,39,5
2022,2,منطقة جازان,الأنشطة الرياضية وأنشطة التسلية والترفيه,متناهية الصغر,67,38,20,18,123,109,14
2022,2,منطقة جازان,الأنشطة الرياضية وأنشطة التسلية والترفيه,متوسطة,2,46,14,32,125,125,0
2022,2,منطقة حائل,الأنشطة الرياضية وأنشطة التسلية والترفيه,صغيرة,23,86,56,30,226,224,2
2022,2,منطقة حائل,الأنشطة الرياضية وأنشطة التسلية والترفيه,متناهية الصغر,52,30,18,12,94,82,12
2022,2,منطقة حائل,الأنشطة الرياضية وأنشطة التسلية والترفيه,متوسطة,1,13,2,11,46,46,0
2022,2,منطقة عسير,الأنشطة الرياضية وأنشطة التسلية والترفيه,صغيرة,50,254,102,152,452,405,47
2022,2,منطقة عسير,الأنشطة الرياضية وأنشطة التسلية والترفيه,متناهية الصغر,130,85,44,41,239,218,21
2022,2,منطقة عسير,الأنشطة الرياضية وأنشطة التسلية والترفيه,متوسطة,1,10,6,4,86,86,0
2022,2,منطقة مكة المكرمة,الأنشطة الرياضية وأنشطة التسلية والترفيه,صغيرة,175,915,349,566,1447,1250,197
2022,2,منطقة مكة المكرمة,الأنشطة الرياضية وأنشطة التسلية والترفيه,متناهية الصغر,516,364,156,208,805,737,68
2022,2,منطقة مكة المكرمة,الأنشطة الرياضية وأنشطة التسلية والترفيه,متوسطة,22,934,450,484,1033,913,120
2022,2,منطقة نجران,الأنشطة الرياضية وأنشطة التسلية والترفيه,صغيرة,17,75,43,32,129,122,7
2022,2,منطقة نجران,الأنشطة الرياضية وأنشطة التسلية والترفيه,متناهية الصغر,27,17,8,9,61,57,4
2022,2,المنطقة الشرقية,الأنشطة البيطرية,صغيرة,8,15,8,7,51,49,2
2022,2,المنطقة الشرقية,الأنشطة البيطرية,متناهية الصغر,39,32,18,14,67,62,5
2022,2,المنطقة الشرقية,الأنشطة البيطرية,متوسطة,2,44,22,22,61,57,4
2022,2,منطقة الباحة,الأنشطة البيطرية,متناهية الصغر,1,0,0,0,2,2,0
2022,2,منطقة الجوف,الأنشطة البيطرية,متناهية الصغر,2,0,0,0,3,3,0
2022,2,منطقة الحدود الشمالية,الأنشطة البيطرية,متناهية الصغر,6,2,1,1,14,14,0
2022,2,منطقة الرياض,الأنشطة البيطرية,صغيرة,25,96,50,46,238,223,15
2022,2,منطقة الرياض,الأنشطة البيطرية,متناهية الصغر,66,41,18,23,113,111,2
2022,2,منطقة الرياض,الأنشطة البيطرية,متوسطة,5,150,68,82,327,297,30
2022,2,منطقة القصيم,الأنشطة البيطرية,صغيرة,4,10,7,3,20,20,0
2022,2,منطقة القصيم,الأنشطة البيطرية,متناهية الصغر,12,1,0,1,23,23,0
2022,2,منطقة القصيم,الأنشطة البيطرية,متوسطة,1,23,23,0,41,41,0
2022,2,منطقة المدينة المنورة,الأنشطة البيطرية,صغيرة,4,8,4,4,23,20,3
2022,2,منطقة المدينة المنورة,الأنشطة البيطرية,متناهية الصغر,18,3,1,2,36,32,4
2022,2,منطقة تبوك,الأنشطة البيطرية,صغيرة,1,5,0,5,9,9,0
2022,2,منطقة تبوك,الأنشطة البيطرية,متناهية الصغر,6,1,1,0,9,9,0
2022,2,منطقة جازان,الأنشطة البيطرية,متناهية الصغر,7,3,3,0,20,20,0
2022,2,منطقة حائل,الأنشطة البيطرية,متناهية الصغر,7,1,0,1,13,13,0
2022,2,منطقة عسير,الأنشطة البيطرية,صغيرة,3,33,8,25,16,15,1
2022,2,منطقة عسير,الأنشطة البيطرية,متناهية الصغر,22,6,4,2,39,39,0
2022,2,منطقة مكة المكرمة,الأنشطة البيطرية,صغيرة,14,60,13,47,136,123,13
2022,2,منطقة مكة المكرمة,الأنشطة البيطرية,متناهية الصغر,51,26,11,15,97,92,5
2022,2,منطقة مكة المكرمة,الأنشطة البيطرية,متوسطة,2,40,18,22,74,61,13
2022,2,منطقة نجران,الأنشطة البيطرية,متناهية الصغر,10,0,0,0,26,26,0
2022,2,المنطقة الشرقية,الأنشطة الإيجارية,صغيرة,312,948,578,370,3455,3444,11
2022,2,المنطقة الشرقية,الأنشطة الإيجارية,كبيرة,8,1020,811,209,2571,2569,2
2022,2,المنطقة الشرقية,الأنشطة الإيجارية,متناهية الصغر,2035,411,220,191,4276,4271,5
2022,2,المنطقة الشرقية,الأنشطة الإيجارية,متوسطة,37,987,783,204,2880,2877,3
2022,2,منطقة الباحة,الأنشطة الإيجارية,صغيرة,6,9,3,6,52,52,0
2022,2,منطقة الباحة,الأنشطة الإيجارية,متناهية الصغر,140,16,12,4,279,277,2
2022,2,منطقة الجوف,الأنشطة الإيجارية,صغيرة,29,26,20,6,202,201,1
2022,2,منطقة الجوف,الأنشطة الإيجارية,متناهية الصغر,602,51,37,14,1224,1217,7
2022,2,منطقة الحدود الشمالية,الأنشطة الإيجارية,صغيرة,7,31,18,13,61,61,0
2022,2,منطقة الحدود الشمالية,الأنشطة الإيجارية,متناهية الصغر,229,24,18,6,491,487,4
2022,2,منطقة الرياض,الأنشطة الإيجارية,صغيرة,1297,1477,843,634,10537,10478,59
2022,2,منطقة الرياض,الأنشطة الإيجارية,كبيرة,11,2439,2048,391,4167,4163,4
2022,2,منطقة الرياض,الأنشطة الإيجارية,متناهية الصغر,54145,3686,1812,1874,135472,134879,593
2022,2,منطقة الرياض,الأنشطة الإيجارية,متوسطة,44,956,696,260,3591,3582,9
2022,2,منطقة القصيم,الأنشطة الإيجارية,صغيرة,74,120,79,41,629,626,3
2022,2,منطقة القصيم,الأنشطة الإيجارية,كبيرة,2,124,111,13,528,528,0
2022,2,منطقة القصيم,الأنشطة الإيجارية,متناهية الصغر,1239,191,112,79,2830,2822,8
2022,2,منطقة القصيم,الأنشطة الإيجارية,متوسطة,4,68,58,10,306,306,0
2022,2,منطقة المدينة المنورة,الأنشطة الإيجارية,صغيرة,91,197,109,88,844,838,6
2022,2,منطقة المدينة المنورة,الأنشطة الإيجارية,كبيرة,1,85,64,21,268,268,0
2022,2,منطقة المدينة المنورة,الأنشطة الإيجارية,متناهية الصغر,1015,128,73,55,2148,2135,13
2022,2,منطقة المدينة المنورة,الأنشطة الإيجارية,متوسطة,6,193,160,33,576,576,0
2022,2,منطقة تبوك,الأنشطة الإيجارية,صغيرة,11,36,25,11,79,79,0
2022,2,منطقة تبوك,الأنشطة الإيجارية,متناهية الصغر,462,54,30,24,871,869,2
2022,2,منطقة تبوك,الأنشطة الإيجارية,متوسطة,1,65,65,0,134,134,0
2022,2,منطقة جازان,الأنشطة الإيجارية,صغيرة,30,44,30,14,298,282,16
2022,2,منطقة جازان,الأنشطة الإيجارية,متناهية الصغر,1203,94,55,39,2801,2791,10
2022,2,منطقة جازان,الأنشطة الإيجارية,متوسطة,1,18,12,6,57,57,0
2022,2,منطقة حائل,الأنشطة الإيجارية,صغيرة,43,51,38,13,311,308,3
2022,2,منطقة حائل,الأنشطة الإيجارية,متناهية الصغر,925,92,45,47,2256,2244,12
2022,2,منطقة حائل,الأنشطة الإيجارية,متوسطة,1,9,9,0,53,53,0
2022,2,منطقة عسير,الأنشطة الإيجارية,صغيرة,78,122,85,37,599,598,1
2022,2,منطقة عسير,الأنشطة الإيجارية,متناهية الصغر,1405,189,122,67,2721,2711,10
2022,2,منطقة عسير,الأنشطة الإيجارية,متوسطة,2,74,55,19,76,76,0
2022,2,منطقة مكة المكرمة,الأنشطة الإيجارية,صغيرة,256,658,409,249,2441,2403,38
2022,2,منطقة مكة المكرمة,الأنشطة الإيجارية,كبيرة,4,982,872,110,1559,1557,2
2022,2,منطقة مكة المكرمة,الأنشطة الإيجارية,متناهية الصغر,3340,446,263,183,7161,7078,83
2022,2,منطقة مكة المكرمة,الأنشطة الإيجارية,متوسطة,23,573,416,157,1504,1502,2
2022,2,منطقة نجران,الأنشطة الإيجارية,صغيرة,62,52,28,24,519,512,7
2022,2,منطقة نجران,الأنشطة الإيجارية,متناهية الصغر,1300,103,55,48,3120,3101,19
2022,2,المنطقة الشرقية,الأنشطة الإدارية للمكاتب ، وأنشطة الدعم للمكاتب وغير ذلك من أنشطة الدعم للأعمال,صغيرة,132,673,327,346,1090,1072,18
2022,2,المنطقة الشرقية,الأنشطة الإدارية للمكاتب ، وأنشطة الدعم للمكاتب وغير ذلك من أنشطة الدعم للأعمال,كبيرة,3,693,472,221,1238,1234,4
2022,2,المنطقة الشرقية,الأنشطة الإدارية للمكاتب ، وأنشطة الدعم للمكاتب وغير ذلك من أنشطة الدعم للأعمال,متناهية الصغر,640,386,162,224,1032,1002,30
2022,2,المنطقة الشرقية,الأنشطة الإدارية للمكاتب ، وأنشطة الدعم للمكاتب وغير ذلك من أنشطة الدعم للأعمال,متوسطة,18,794,541,253,994,981,13
2022,2,منطقة الباحة,الأنشطة الإدارية للمكاتب ، وأنشطة الدعم للمكاتب وغير ذلك من أنشطة الدعم للأعمال,صغيرة,6,22,19,3,41,41,0
2022,2,منطقة الباحة,الأنشطة الإدارية للمكاتب ، وأنشطة الدعم للمكاتب وغير ذلك من أنشطة الدعم للأعمال,متناهية الصغر,37,16,11,5,57,57,0
2022,2,منطقة الباحة,الأنشطة الإدارية للمكاتب ، وأنشطة الدعم للمكاتب وغير ذلك من أنشطة الدعم للأعمال,متوسطة,1,53,25,28,174,174,0
2022,2,منطقة الجوف,الأنشطة الإدارية للمكاتب ، وأنشطة الدعم للمكاتب وغير ذلك من أنشطة الدعم للأعمال,صغيرة,3,4,2,2,41,41,0
2022,2,منطقة الجوف,الأنشطة الإدارية للمكاتب ، وأنشطة الدعم للمكاتب وغير ذلك من أنشطة الدعم للأعمال,متناهية الصغر,68,32,18,14,127,126,1
2022,2,منطقة الحدود الشمالية,الأنشطة الإدارية للمكاتب ، وأنشطة الدعم للمكاتب وغير ذلك من أنشطة الدعم للأعمال,صغيرة,7,27,1,26,44,44,0
2022,2,منطقة الحدود الشمالية,الأنشطة الإدارية للمكاتب ، وأنشطة الدعم للمكاتب وغير ذلك من أنشطة الدعم للأعمال,متناهية الصغر,36,10,7,3,71,71,0
2022,2,منطقة الرياض,الأنشطة الإدارية للمكاتب ، وأنشطة الدعم للمكاتب وغير ذلك من أنشطة الدعم للأعمال,صغيرة,555,3186,1435,1751,4823,4582,241
2022,2,منطقة الرياض,الأنشطة الإدارية للمكاتب ، وأنشطة الدعم للمكاتب وغير ذلك من أنشطة الدعم للأعمال,كبيرة,11,3762,2571,1191,3787,3597,190
2022,2,منطقة الرياض,الأنشطة الإدارية للمكاتب ، وأنشطة الدعم للمكاتب وغير ذلك من أنشطة الدعم للأعمال,متناهية الصغر,1978,1224,595,629,3244,3112,132
2022,2,منطقة الرياض,الأنشطة الإدارية للمكاتب ، وأنشطة الدعم للمكاتب وغير ذلك من أنشطة الدعم للأعمال,متوسطة,42,1935,873,1062,2255,2123,132
2022,2,منطقة القصيم,الأنشطة الإدارية للمكاتب ، وأنشطة الدعم للمكاتب وغير ذلك من أنشطة الدعم للأعمال,صغيرة,20,52,29,23,182,172,10
2022,2,منطقة القصيم,الأنشطة الإدارية للمكاتب ، وأنشطة الدعم للمكاتب وغير ذلك من أنشطة الدعم للأعمال,متناهية الصغر,199,76,47,29,344,342,2
2022,2,منطقة القصيم,الأنشطة الإدارية للمكاتب ، وأنشطة الدعم للمكاتب وغير ذلك من أنشطة الدعم للأعمال,متوسطة,3,40,6,34,189,188,1
2022,2,منطقة المدينة المنورة,الأنشطة الإدارية للمكاتب ، وأنشطة الدعم للمكاتب وغير ذلك من أنشطة الدعم للأعمال,صغيرة,33,126,52,74,255,246,9
2022,2,منطقة المدينة المنورة,الأنشطة الإدارية للمكاتب ، وأنشطة الدعم للمكاتب وغير ذلك من أنشطة الدعم للأعمال,متناهية الصغر,245,107,68,39,444,427,17
2022,2,منطقة المدينة المنورة,الأنشطة الإدارية للمكاتب ، وأنشطة الدعم للمكاتب وغير ذلك من أنشطة الدعم للأعمال,متوسطة,5,156,114,42,402,397,5
2022,2,منطقة تبوك,الأنشطة الإدارية للمكاتب ، وأنشطة الدعم للمكاتب وغير ذلك من أنشطة الدعم للأعمال,صغيرة,7,21,15,6,60,59,1
2022,2,منطقة تبوك,الأنشطة الإدارية للمكاتب ، وأنشطة الدعم للمكاتب وغير ذلك من أنشطة الدعم للأعمال,متناهية الصغر,103,38,8,30,165,163,2
2022,2,منطقة جازان,الأنشطة الإدارية للمكاتب ، وأنشطة الدعم للمكاتب وغير ذلك من أنشطة الدعم للأعمال,صغيرة,4,18,11,7,27,27,0
2022,2,منطقة جازان,الأنشطة الإدارية للمكاتب ، وأنشطة الدعم للمكاتب وغير ذلك من أنشطة الدعم للأعمال,متناهية الصغر,93,26,13,13,179,178,1
2022,2,منطقة حائل,الأنشطة الإدارية للمكاتب ، وأنشطة الدعم للمكاتب وغير ذلك من أنشطة الدعم للأعمال,صغيرة,9,26,16,10,46,46,0
2022,2,منطقة حائل,الأنشطة الإدارية للمكاتب ، وأنشطة الدعم للمكاتب وغير ذلك من أنشطة الدعم للأعمال,متناهية الصغر,150,34,16,18,274,268,6
2022,2,منطقة حائل,الأنشطة الإدارية للمكاتب ، وأنشطة الدعم للمكاتب وغير ذلك من أنشطة الدعم للأعمال,متوسطة,1,1,0,1,54,54,0
2022,2,منطقة عسير,الأنشطة الإدارية للمكاتب ، وأنشطة الدعم للمكاتب وغير ذلك من أنشطة الدعم للأعمال,صغيرة,23,64,25,39,185,185,0
2022,2,منطقة عسير,الأنشطة الإدارية للمكاتب ، وأنشطة الدعم للمكاتب وغير ذلك من أنشطة الدعم للأعمال,متناهية الصغر,243,87,51,36,404,398,6
2022,2,منطقة عسير,الأنشطة الإدارية للمكاتب ، وأنشطة الدعم للمكاتب وغير ذلك من أنشطة الدعم للأعمال,متوسطة,1,28,18,10,32,32,0
2022,2,منطقة مكة المكرمة,الأنشطة الإدارية للمكاتب ، وأنشطة الدعم للمكاتب وغير ذلك من أنشطة الدعم للأعمال,صغيرة,269,1365,648,717,2255,2116,139
2022,2,منطقة مكة المكرمة,الأنشطة الإدارية للمكاتب ، وأنشطة الدعم للمكاتب وغير ذلك من أنشطة الدعم للأعمال,كبيرة,5,2908,1882,1026,1194,1143,51
2022,2,منطقة مكة المكرمة,الأنشطة الإدارية للمكاتب ، وأنشطة الدعم للمكاتب وغير ذلك من أنشطة الدعم للأعمال,متناهية الصغر,1298,623,313,310,2372,2259,113
2022,2,منطقة مكة المكرمة,الأنشطة الإدارية للمكاتب ، وأنشطة الدعم للمكاتب وغير ذلك من أنشطة الدعم للأعمال,متوسطة,27,1002,536,466,1575,1506,69
2022,2,منطقة نجران,الأنشطة الإدارية للمكاتب ، وأنشطة الدعم للمكاتب وغير ذلك من أنشطة الدعم للأعمال,صغيرة,3,2,1,1,17,15,2
2022,2,منطقة نجران,الأنشطة الإدارية للمكاتب ، وأنشطة الدعم للمكاتب وغير ذلك من أنشطة الدعم للأعمال,متناهية الصغر,87,27,15,12,158,157,1
2022,2,المنطقة الشرقية,الأنشطة الأخرى للتعدين واستغلال المحاجر,صغيرة,47,169,78,91,585,581,4
2022,2,المنطقة الشرقية,الأنشطة الأخرى للتعدين واستغلال المحاجر,كبيرة,3,1048,912,136,2382,2379,3
2022,2,المنطقة الشرقية,الأنشطة الأخرى للتعدين واستغلال المحاجر,متناهية الصغر,80,52,34,18,142,140,2
2022,2,المنطقة الشرقية,الأنشطة الأخرى للتعدين واستغلال المحاجر,متوسطة,16,381,301,80,1178,1177,1
2022,2,منطقة الباحة,الأنشطة الأخرى للتعدين واستغلال المحاجر,صغيرة,3,16,5,11,64,64,0
2022,2,منطقة الباحة,الأنشطة الأخرى للتعدين واستغلال المحاجر,متناهية الصغر,1,2,1,1,3,3,0
2022,2,منطقة الباحة,الأنشطة الأخرى للتعدين واستغلال المحاجر,متوسطة,1,14,8,6,36,36,0
2022,2,منطقة الجوف,الأنشطة الأخرى للتعدين واستغلال المحاجر,صغيرة,2,14,11,3,76,76,0
2022,2,منطقة الجوف,الأنشطة الأخرى للتعدين واستغلال المحاجر,متناهية الصغر,12,3,3,0,16,16,0
2022,2,منطقة الحدود الشمالية,الأنشطة الأخرى للتعدين واستغلال المحاجر,صغيرة,5,12,9,3,68,68,0
2022,2,منطقة الحدود الشمالية,الأنشطة الأخرى للتعدين واستغلال المحاجر,متناهية الصغر,6,3,2,1,7,7,0
2022,2,منطقة الحدود الشمالية,الأنشطة الأخرى للتعدين واستغلال المحاجر,متوسطة,1,13,4,9,40,40,0
2022,2,منطقة الرياض,الأنشطة الأخرى للتعدين واستغلال المحاجر,صغيرة,152,631,351,280,1919,1914,5
2022,2,منطقة الرياض,الأنشطة الأخرى للتعدين واستغلال المحاجر,كبيرة,6,637,378,259,2257,2256,1
2022,2,منطقة الرياض,الأنشطة الأخرى للتعدين واستغلال المحاجر,متناهية الصغر,228,155,86,69,375,371,4
2022,2,منطقة الرياض,الأنشطة الأخرى للتعدين واستغلال المحاجر,متوسطة,27,731,417,314,2088,2088,0
2022,2,منطقة القصيم,الأنشطة الأخرى للتعدين واستغلال المحاجر,صغيرة,8,52,27,25,134,134,0
2022,2,منطقة القصيم,الأنشطة الأخرى للتعدين واستغلال المحاجر,متناهية الصغر,26,15,7,8,47,47,0
2022,2,منطقة القصيم,الأنشطة الأخرى للتعدين واستغلال المحاجر,متوسطة,3,59,33,26,220,220,0
2022,2,منطقة المدينة المنورة,الأنشطة الأخرى للتعدين واستغلال المحاجر,صغيرة,25,136,101,35,375,375,0
2022,2,منطقة المدينة المنورة,الأنشطة الأخرى للتعدين واستغلال المحاجر,كبيرة,2,315,302,13,457,457,0
2022,2,منطقة المدينة المنورة,الأنشطة الأخرى للتعدين واستغلال المحاجر,متناهية الصغر,41,25,16,9,70,70,0
2022,2,منطقة المدينة المنورة,الأنشطة الأخرى للتعدين واستغلال المحاجر,متوسطة,1,25,25,0,47,47,0
2022,2,منطقة تبوك,الأنشطة الأخرى للتعدين واستغلال المحاجر,صغيرة,6,35,23,12,49,49,0
2022,2,منطقة تبوك,الأنشطة الأخرى للتعدين واستغلال المحاجر,متناهية الصغر,8,5,5,0,9,9,0
2022,2,منطقة تبوك,الأنشطة الأخرى للتعدين واستغلال المحاجر,متوسطة,1,27,15,12,116,115,1
2022,2,منطقة جازان,الأنشطة الأخرى للتعدين واستغلال المحاجر,صغيرة,16,80,54,26,195,195,0
2022,2,منطقة جازان,الأنشطة الأخرى للتعدين واستغلال المحاجر,متناهية الصغر,21,12,6,6,35,35,0
2022,2,منطقة جازان,الأنشطة الأخرى للتعدين واستغلال المحاجر,متوسطة,2,13,4,9,145,145,0
2022,2,منطقة حائل,الأنشطة الأخرى للتعدين واستغلال المحاجر,صغيرة,1,0,0,0,6,6,0
2022,2,منطقة حائل,الأنشطة الأخرى للتعدين واستغلال المحاجر,متناهية الصغر,17,5,2,3,24,24,0
2022,2,منطقة عسير,الأنشطة الأخرى للتعدين واستغلال المحاجر,صغيرة,23,91,75,16,255,254,1
2022,2,منطقة عسير,الأنشطة الأخرى للتعدين واستغلال المحاجر,متناهية الصغر,45,30,22,8,83,83,0
2022,2,منطقة مكة المكرمة,الأنشطة الأخرى للتعدين واستغلال المحاجر,صغيرة,61,225,121,104,682,680,2
2022,2,منطقة مكة المكرمة,الأنشطة الأخرى للتعدين واستغلال المحاجر,كبيرة,4,1278,1194,84,1207,1207,0
2022,2,منطقة مكة المكرمة,الأنشطة الأخرى للتعدين واستغلال المحاجر,متناهية الصغر,112,72,47,25,185,184,1
2022,2,منطقة مكة المكرمة,الأنشطة الأخرى للتعدين واستغلال المحاجر,متوسطة,9,219,136,83,673,671,2
2022,2,منطقة نجران,الأنشطة الأخرى للتعدين واستغلال المحاجر,صغيرة,8,25,9,16,93,93,0
2022,2,منطقة نجران,الأنشطة الأخرى للتعدين واستغلال المحاجر,متناهية الصغر,11,9,5,4,20,20,0
2022,2,منطقة نجران,الأنشطة الأخرى للتعدين واستغلال المحاجر,متوسطة,1,16,13,3,46,46,0
2022,2,المنطقة الشرقية,الأنشطة الإبداعية والفنون وأنشطة الترفيه,صغيرة,4,13,7,6,39,39,0
2022,2,المنطقة الشرقية,الأنشطة الإبداعية والفنون وأنشطة الترفيه,متناهية الصغر,33,21,9,12,44,39,5
2022,2,منطقة الباحة,الأنشطة الإبداعية والفنون وأنشطة الترفيه,متناهية الصغر,2,1,1,0,4,4,0
2022,2,منطقة الجوف,الأنشطة الإبداعية والفنون وأنشطة الترفيه,متناهية الصغر,2,1,0,1,2,2,0
2022,2,منطقة الرياض,الأنشطة الإبداعية والفنون وأنشطة الترفيه,صغيرة,23,121,41,80,156,143,13
2022,2,منطقة الرياض,الأنشطة الإبداعية والفنون وأنشطة الترفيه,كبيرة,2,158,113,45,570,565,5
2022,2,منطقة الرياض,الأنشطة الإبداعية والفنون وأنشطة الترفيه,متناهية الصغر,102,62,30,32,147,136,11
2022,2,منطقة الرياض,الأنشطة الإبداعية والفنون وأنشطة الترفيه,متوسطة,2,159,120,39,146,143,3
2022,2,منطقة القصيم,الأنشطة الإبداعية والفنون وأنشطة الترفيه,متناهية الصغر,4,1,1,0,10,10,0
2022,2,منطقة المدينة المنورة,الأنشطة الإبداعية والفنون وأنشطة الترفيه,صغيرة,1,0,0,0,9,9,0
2022,2,منطقة المدينة المنورة,الأنشطة الإبداعية والفنون وأنشطة الترفيه,متناهية الصغر,17,5,2,3,25,24,1
2022,2,منطقة تبوك,الأنشطة الإبداعية والفنون وأنشطة الترفيه,متناهية الصغر,2,0,0,0,4,4,0
2022,2,منطقة جازان,الأنشطة الإبداعية والفنون وأنشطة الترفيه,متناهية الصغر,1,1,1,0,2,2,0
2022,2,منطقة حائل,الأنشطة الإبداعية والفنون وأنشطة الترفيه,متناهية الصغر,1,0,0,0,1,1,0
2022,2,منطقة عسير,الأنشطة الإبداعية والفنون وأنشطة الترفيه,صغيرة,2,24,3,21,10,10,0
2022,2,منطقة عسير,الأنشطة الإبداعية والفنون وأنشطة الترفيه,متناهية الصغر,11,4,3,1,28,28,0
2022,2,منطقة مكة المكرمة,الأنشطة الإبداعية والفنون وأنشطة الترفيه,صغيرة,11,39,21,18,75,73,2
2022,2,منطقة مكة المكرمة,الأنشطة الإبداعية والفنون وأنشطة الترفيه,متناهية الصغر,94,65,20,45,145,131,14
2022,2,منطقة مكة المكرمة,الأنشطة الإبداعية والفنون وأنشطة الترفيه,متوسطة,1,1,1,0,52,52,0
2022,2,منطقة نجران,الأنشطة الإبداعية والفنون وأنشطة الترفيه,متناهية الصغر,3,1,1,0,4,4,0
2022,2,المنطقة الشرقية,الإقامة,صغيرة,222,1086,606,480,2118,2097,21
2022,2,المنطقة الشرقية,الإقامة,كبيرة,2,176,130,46,469,432,37
2022,2,المنطقة الشرقية,الإقامة,متناهية الصغر,298,261,156,105,490,485,5
2022,2,المنطقة الشرقية,الإقامة,متوسطة,35,1312,723,589,2106,2042,64
2022,2,منطقة الباحة,الإقامة,صغيرة,23,81,48,33,197,197,0
2022,2,منطقة الباحة,الإقامة,متناهية الصغر,65,45,35,10,103,103,0
2022,2,منطقة الباحة,الإقامة,متوسطة,1,26,12,14,44,44,0
2022,2,منطقة الجوف,الإقامة,صغيرة,11,20,12,8,70,70,0
2022,2,منطقة الجوف,الإقامة,متناهية الصغر,52,25,12,13,101,101,0
2022,2,منطقة الجوف,الإقامة,متوسطة,1,17,8,9,47,47,0
2022,2,منطقة الحدود الشمالية,الإقامة,صغيرة,10,32,16,16,87,87,0
2022,2,منطقة الحدود الشمالية,الإقامة,متناهية الصغر,36,19,15,4,63,63,0
2022,2,منطقة الحدود الشمالية,الإقامة,متوسطة,1,18,13,5,37,37,0
2022,2,منطقة الرياض,الإقامة,صغيرة,328,1707,881,826,3577,3543,34
2022,2,منطقة الرياض,الإقامة,كبيرة,9,2103,1245,858,3307,3221,86
2022,2,منطقة الرياض,الإقامة,متناهية الصغر,680,525,282,243,1244,1224,20
2022,2,منطقة الرياض,الإقامة,متوسطة,78,2913,1671,1242,4957,4874,83
2022,2,منطقة القصيم,الإقامة,صغيرة,56,264,179,85,472,471,1
2022,2,منطقة القصيم,الإقامة,كبيرة,1,0,0,0,351,350,1
2022,2,منطقة القصيم,الإقامة,متناهية الصغر,98,66,51,15,190,190,0
2022,2,منطقة القصيم,الإقامة,متوسطة,4,100,53,47,175,175,0
2022,2,منطقة المدينة المنورة,الإقامة,صغيرة,149,885,644,241,1396,1386,10
2022,2,منطقة المدينة المنورة,الإقامة,كبيرة,4,524,372,152,774,764,10
2022,2,منطقة المدينة المنورة,الإقامة,متناهية الصغر,311,231,169,62,504,492,12
2022,2,منطقة المدينة المنورة,الإقامة,متوسطة,33,1237,892,345,2083,2065,18
2022,2,منطقة تبوك,الإقامة,صغيرة,38,239,133,106,315,314,1
2022,2,منطقة تبوك,الإقامة,متناهية الصغر,88,78,51,27,146,146,0
2022,2,منطقة تبوك,الإقامة,متوسطة,4,155,91,64,342,330,12
2022,2,منطقة جازان,الإقامة,صغيرة,43,153,87,66,420,411,9
2022,2,منطقة جازان,الإقامة,متناهية الصغر,226,123,72,51,360,358,2
2022,2,منطقة جازان,الإقامة,متوسطة,5,199,72,127,269,229,40
2022,2,منطقة حائل,الإقامة,صغيرة,22,96,68,28,223,223,0
2022,2,منطقة حائل,الإقامة,متناهية الصغر,62,43,23,20,130,130,0
2022,2,منطقة حائل,الإقامة,متوسطة,1,24,16,8,86,86,0
2022,2,منطقة عسير,الإقامة,صغيرة,96,348,210,138,833,824,9
2022,2,منطقة عسير,الإقامة,متناهية الصغر,365,247,145,102,630,627,3
2022,2,منطقة عسير,الإقامة,متوسطة,5,167,112,55,300,297,3
2022,2,منطقة مكة المكرمة,الإقامة,صغيرة,498,2248,1338,910,4690,4568,122
2022,2,منطقة مكة المكرمة,الإقامة,كبيرة,13,1976,1429,547,2728,2684,44
2022,2,منطقة مكة المكرمة,الإقامة,متناهية الصغر,1023,787,509,278,1690,1661,29
2022,2,منطقة مكة المكرمة,الإقامة,متوسطة,80,3103,2209,894,5620,5503,117
2022,2,منطقة نجران,الإقامة,صغيرة,22,106,51,55,240,239,1
2022,2,منطقة نجران,الإقامة,متناهية الصغر,94,48,30,18,209,207,2
2022,2,منطقة نجران,الإقامة,متوسطة,2,83,15,68,223,220,3
2022,2,المنطقة الشرقية,الإدارة العامة والدفاع ؛ والضمان الاجتماعي الإلزامي,صغيرة,55,763,578,185,438,429,9
2022,2,المنطقة الشرقية,الإدارة العامة والدفاع ؛ والضمان الاجتماعي الإلزامي,كبيرة,21,13717,11003,2714,5932,4317,1615
2022,2,المنطقة الشرقية,الإدارة العامة والدفاع ؛ والضمان الاجتماعي الإلزامي,متناهية الصغر,127,110,76,34,187,184,3
2022,2,المنطقة الشرقية,الإدارة العامة والدفاع ؛ والضمان الاجتماعي الإلزامي,متوسطة,30,2409,2022,387,1302,1247,55
2022,2,منطقة الباحة,الإدارة العامة والدفاع ؛ والضمان الاجتماعي الإلزامي,صغيرة,3,27,18,9,20,19,1
2022,2,منطقة الباحة,الإدارة العامة والدفاع ؛ والضمان الاجتماعي الإلزامي,كبيرة,3,582,424,158,560,559,1
2022,2,منطقة الباحة,الإدارة العامة والدفاع ؛ والضمان الاجتماعي الإلزامي,متناهية الصغر,11,7,7,0,23,23,0
2022,2,منطقة الباحة,الإدارة العامة والدفاع ؛ والضمان الاجتماعي الإلزامي,متوسطة,14,510,427,83,1131,1111,20
2022,2,منطقة الجوف,الإدارة العامة والدفاع ؛ والضمان الاجتماعي الإلزامي,صغيرة,7,87,76,11,14,14,0
2022,2,منطقة الجوف,الإدارة العامة والدفاع ؛ والضمان الاجتماعي الإلزامي,كبيرة,3,489,403,86,798,617,181
2022,2,منطقة الجوف,الإدارة العامة والدفاع ؛ والضمان الاجتماعي الإلزامي,متناهية الصغر,17,6,3,3,23,22,1
2022,2,منطقة الجوف,الإدارة العامة والدفاع ؛ والضمان الاجتماعي الإلزامي,متوسطة,13,937,770,167,852,821,31
2022,2,منطقة الحدود الشمالية,الإدارة العامة والدفاع ؛ والضمان الاجتماعي الإلزامي,صغيرة,7,51,43,8,56,56,0
2022,2,منطقة الحدود الشمالية,الإدارة العامة والدفاع ؛ والضمان الاجتماعي الإلزامي,كبيرة,3,805,363,442,291,291,0
2022,2,منطقة الحدود الشمالية,الإدارة العامة والدفاع ؛ والضمان الاجتماعي الإلزامي,متناهية الصغر,8,13,10,3,4,4,0
2022,2,منطقة الحدود الشمالية,الإدارة العامة والدفاع ؛ والضمان الاجتماعي الإلزامي,متوسطة,10,338,300,38,917,916,1
2022,2,منطقة الرياض,الإدارة العامة والدفاع ؛ والضمان الاجتماعي الإلزامي,صغيرة,186,3142,2400,742,838,780,58
2022,2,منطقة الرياض,الإدارة العامة والدفاع ؛ والضمان الاجتماعي الإلزامي,كبيرة,74,118244,98433,19811,9952,7101,2851
2022,2,منطقة الرياض,الإدارة العامة والدفاع ؛ والضمان الاجتماعي الإلزامي,متناهية الصغر,323,254,161,93,483,467,16
2022,2,منطقة الرياض,الإدارة العامة والدفاع ؛ والضمان الاجتماعي الإلزامي,متوسطة,120,12898,10014,2884,1879,1815,64
2022,2,منطقة القصيم,الإدارة العامة والدفاع ؛ والضمان الاجتماعي الإلزامي,صغيرة,9,116,84,32,45,45,0
2022,2,منطقة القصيم,الإدارة العامة والدفاع ؛ والضمان الاجتماعي الإلزامي,كبيرة,12,2179,1562,617,3958,3952,6
2022,2,منطقة القصيم,الإدارة العامة والدفاع ؛ والضمان الاجتماعي الإلزامي,متناهية الصغر,32,13,8,5,72,69,3
2022,2,منطقة القصيم,الإدارة العامة والدفاع ؛ والضمان الاجتماعي الإلزامي,متوسطة,20,546,426,120,1824,1816,8
2022,2,منطقة المدينة المنورة,الإدارة العامة والدفاع ؛ والضمان الاجتماعي الإلزامي,صغيرة,18,236,212,24,81,80,1
2022,2,منطقة المدينة المنورة,الإدارة العامة والدفاع ؛ والضمان الاجتماعي الإلزامي,كبيرة,3,523,455,68,1052,1052,0
2022,2,منطقة المدينة المنورة,الإدارة العامة والدفاع ؛ والضمان الاجتماعي الإلزامي,متناهية الصغر,49,19,15,4,106,105,1
2022,2,منطقة المدينة المنورة,الإدارة العامة والدفاع ؛ والضمان الاجتماعي الإلزامي,متوسطة,12,423,386,37,990,990,0
2022,2,منطقة تبوك,الإدارة العامة والدفاع ؛ والضمان الاجتماعي الإلزامي,صغيرة,8,120,99,21,36,35,1
2022,2,منطقة تبوك,الإدارة العامة والدفاع ؛ والضمان الاجتماعي الإلزامي,كبيرة,1,316,180,136,0,0,0
2022,2,منطقة تبوك,الإدارة العامة والدفاع ؛ والضمان الاجتماعي الإلزامي,متناهية الصغر,20,6,5,1,52,51,1
2022,2,منطقة تبوك,الإدارة العامة والدفاع ؛ والضمان الاجتماعي الإلزامي,متوسطة,11,745,564,181,498,498,0
2022,2,منطقة جازان,الإدارة العامة والدفاع ؛ والضمان الاجتماعي الإلزامي,صغيرة,13,164,159,5,107,103,4
2022,2,منطقة جازان,الإدارة العامة والدفاع ؛ والضمان الاجتماعي الإلزامي,كبيرة,3,1534,977,557,0,0,0
2022,2,منطقة جازان,الإدارة العامة والدفاع ؛ والضمان الاجتماعي الإلزامي,متناهية الصغر,40,12,9,3,107,107,0
2022,2,منطقة جازان,الإدارة العامة والدفاع ؛ والضمان الاجتماعي الإلزامي,متوسطة,16,1186,1132,54,567,567,0
2022,2,منطقة حائل,الإدارة العامة والدفاع ؛ والضمان الاجتماعي الإلزامي,صغيرة,5,87,70,17,11,11,0
2022,2,منطقة حائل,الإدارة العامة والدفاع ؛ والضمان الاجتماعي الإلزامي,كبيرة,2,952,556,396,428,428,0
2022,2,منطقة حائل,الإدارة العامة والدفاع ؛ والضمان الاجتماعي الإلزامي,متناهية الصغر,19,9,9,0,30,30,0
2022,2,منطقة حائل,الإدارة العامة والدفاع ؛ والضمان الاجتماعي الإلزامي,متوسطة,17,856,823,33,1855,1854,1
2022,2,منطقة عسير,الإدارة العامة والدفاع ؛ والضمان الاجتماعي الإلزامي,صغيرة,12,246,223,23,45,45,0
2022,2,منطقة عسير,الإدارة العامة والدفاع ؛ والضمان الاجتماعي الإلزامي,كبيرة,17,5685,4117,1568,6452,5877,575
2022,2,منطقة عسير,الإدارة العامة والدفاع ؛ والضمان الاجتماعي الإلزامي,متناهية الصغر,28,12,7,5,78,78,0
2022,2,منطقة عسير,الإدارة العامة والدفاع ؛ والضمان الاجتماعي الإلزامي,متوسطة,32,2020,1523,497,3284,3283,1
2022,2,منطقة مكة المكرمة,الإدارة العامة والدفاع ؛ والضمان الاجتماعي الإلزامي,صغيرة,92,848,654,194,568,534,34
2022,2,منطقة مكة المكرمة,الإدارة العامة والدفاع ؛ والضمان الاجتماعي الإلزامي,كبيرة,25,20991,12525,8466,9362,5026,4336
2022,2,منطقة مكة المكرمة,الإدارة العامة والدفاع ؛ والضمان الاجتماعي الإلزامي,متناهية الصغر,281,156,107,49,480,465,15
2022,2,منطقة مكة المكرمة,الإدارة العامة والدفاع ؛ والضمان الاجتماعي الإلزامي,متوسطة,41,3054,2458,596,2236,2195,41
2022,2,منطقة نجران,الإدارة العامة والدفاع ؛ والضمان الاجتماعي الإلزامي,صغيرة,5,89,68,21,17,17,0
2022,2,منطقة نجران,الإدارة العامة والدفاع ؛ والضمان الاجتماعي الإلزامي,كبيرة,6,1595,1363,232,1744,1147,597
2022,2,منطقة نجران,الإدارة العامة والدفاع ؛ والضمان الاجتماعي الإلزامي,متناهية الصغر,32,15,15,0,50,50,0
2022,2,منطقة نجران,الإدارة العامة والدفاع ؛ والضمان الاجتماعي الإلزامي,متوسطة,15,1084,930,154,754,754,0
2022,2,المنطقة الشرقية,الاتصالات,صغيرة,34,159,101,58,258,252,6
2022,2,المنطقة الشرقية,الاتصالات,متناهية الصغر,91,48,28,20,144,144,0
2022,2,المنطقة الشرقية,الاتصالات,متوسطة,3,94,78,16,154,154,0
2022,2,منطقة الباحة,الاتصالات,صغيرة,1,4,1,3,11,11,0
2022,2,منطقة الباحة,الاتصالات,متناهية الصغر,5,1,1,0,9,9,0
2022,2,منطقة الجوف,الاتصالات,صغيرة,1,1,1,0,6,6,0
2022,2,منطقة الجوف,الاتصالات,متناهية الصغر,16,1,0,1,33,33,0
2022,2,منطقة الحدود الشمالية,الاتصالات,صغيرة,2,5,0,5,12,12,0
2022,2,منطقة الحدود الشمالية,الاتصالات,متناهية الصغر,13,4,2,2,25,24,1
2022,2,منطقة الرياض,الاتصالات,صغيرة,149,836,427,409,1640,1568,72
2022,2,منطقة الرياض,الاتصالات,كبيرة,15,21273,16731,4542,3198,3131,67
2022,2,منطقة الرياض,الاتصالات,متناهية الصغر,335,171,108,63,579,569,10
2022,2,منطقة الرياض,الاتصالات,متوسطة,33,2236,1591,645,1416,1381,35
2022,2,منطقة القصيم,الاتصالات,صغيرة,15,13,10,3,174,174,0
2022,2,منطقة القصيم,الاتصالات,متناهية الصغر,54,19,7,12,101,101,0
2022,2,منطقة المدينة المنورة,الاتصالات,صغيرة,3,18,7,11,6,6,0
2022,2,منطقة المدينة المنورة,الاتصالات,متناهية الصغر,38,10,4,6,61,59,2
2022,2,منطقة تبوك,الاتصالات,متناهية الصغر,17,1,1,0,29,29,0
2022,2,منطقة جازان,الاتصالات,صغيرة,1,2,2,0,7,7,0
2022,2,منطقة جازان,الاتصالات,متناهية الصغر,24,8,5,3,36,36,0
2022,2,منطقة حائل,الاتصالات,صغيرة,1,5,0,5,4,4,0
2022,2,منطقة حائل,الاتصالات,متناهية الصغر,23,7,0,7,44,43,1
2022,2,منطقة عسير,الاتصالات,صغيرة,4,6,3,3,36,36,0
2022,2,منطقة عسير,الاتصالات,متناهية الصغر,46,10,7,3,84,83,1
2022,2,منطقة مكة المكرمة,الاتصالات,صغيرة,39,173,81,92,406,403,3
2022,2,منطقة مكة المكرمة,الاتصالات,متناهية الصغر,247,91,55,36,419,409,10
2022,2,منطقة مكة المكرمة,الاتصالات,متوسطة,1,62,26,36,82,71,11
2022,2,منطقة نجران,الاتصالات,صغيرة,3,0,0,0,41,39,2
2022,2,منطقة نجران,الاتصالات,متناهية الصغر,20,7,4,3,30,30,0
2022,2,المنطقة الشرقية,إصلاح وتركيب الآلات والمعدات,صغيرة,244,907,623,284,2907,2901,6
2022,2,المنطقة الشرقية,إصلاح وتركيب الآلات والمعدات,كبيرة,18,3051,2501,550,8822,8803,19
2022,2,المنطقة الشرقية,إصلاح وتركيب الآلات والمعدات,متناهية الصغر,764,337,190,147,1583,1582,1
2022,2,المنطقة الشرقية,إصلاح وتركيب الآلات والمعدات,متوسطة,58,1721,1367,354,4270,4267,3
2022,2,منطقة الباحة,إصلاح وتركيب الآلات والمعدات,صغيرة,1,1,1,0,11,11,0
2022,2,منطقة الباحة,إصلاح وتركيب الآلات والمعدات,متناهية الصغر,37,8,7,1,66,66,0
2022,2,منطقة الجوف,إصلاح وتركيب الآلات والمعدات,صغيرة,7,7,2,5,62,62,0
2022,2,منطقة الجوف,إصلاح وتركيب الآلات والمعدات,متناهية الصغر,49,6,3,3,97,97,0
2022,2,منطقة الحدود الشمالية,إصلاح وتركيب الآلات والمعدات,صغيرة,3,18,14,4,5,5,0
2022,2,منطقة الحدود الشمالية,إصلاح وتركيب الآلات والمعدات,متناهية الصغر,50,5,2,3,137,137,0
2022,2,منطقة الرياض,إصلاح وتركيب الآلات والمعدات,صغيرة,245,943,533,410,2885,2875,10
2022,2,منطقة الرياض,إصلاح وتركيب الآلات والمعدات,كبيرة,14,4543,4099,444,4335,4296,39
2022,2,منطقة الرياض,إصلاح وتركيب الآلات والمعدات,متناهية الصغر,968,294,157,137,2156,2144,12
2022,2,منطقة الرياض,إصلاح وتركيب الآلات والمعدات,متوسطة,63,1934,1585,349,4553,4479,74
2022,2,منطقة القصيم,إصلاح وتركيب الآلات والمعدات,صغيرة,34,76,40,36,307,307,0
2022,2,منطقة القصيم,إصلاح وتركيب الآلات والمعدات,متناهية الصغر,206,29,21,8,456,456,0
2022,2,منطقة القصيم,إصلاح وتركيب الآلات والمعدات,متوسطة,7,117,85,32,597,597,0
2022,2,منطقة المدينة المنورة,إصلاح وتركيب الآلات والمعدات,صغيرة,24,94,68,26,191,190,1
2022,2,منطقة المدينة المنورة,إصلاح وتركيب الآلات والمعدات,كبيرة,1,47,21,26,208,208,0
2022,2,منطقة المدينة المنورة,إصلاح وتركيب الآلات والمعدات,متناهية الصغر,233,49,32,17,471,468,3
2022,2,منطقة المدينة المنورة,إصلاح وتركيب الآلات والمعدات,متوسطة,2,26,16,10,108,108,0
2022,2,منطقة تبوك,إصلاح وتركيب الآلات والمعدات,صغيرة,1,1,0,1,11,11,0
2022,2,منطقة تبوك,إصلاح وتركيب الآلات والمعدات,متناهية الصغر,111,18,13,5,240,238,2
2022,2,منطقة تبوك,إصلاح وتركيب الآلات والمعدات,متوسطة,1,31,31,0,22,22,0
2022,2,منطقة جازان,إصلاح وتركيب الآلات والمعدات,صغيرة,14,13,9,4,103,103,0
2022,2,منطقة جازان,إصلاح وتركيب الآلات والمعدات,متناهية الصغر,295,30,17,13,697,697,0
2022,2,منطقة جازان,إصلاح وتركيب الآلات والمعدات,متوسطة,1,0,0,0,64,64,0
2022,2,منطقة حائل,إصلاح وتركيب الآلات والمعدات,صغيرة,6,9,4,5,77,77,0
2022,2,منطقة حائل,إصلاح وتركيب الآلات والمعدات,متناهية الصغر,70,10,7,3,150,149,1
2022,2,منطقة عسير,إصلاح وتركيب الآلات والمعدات,صغيرة,12,25,23,2,110,110,0
2022,2,منطقة عسير,إصلاح وتركيب الآلات والمعدات,كبيرة,1,51,37,14,283,283,0
2022,2,منطقة عسير,إصلاح وتركيب الآلات والمعدات,متناهية الصغر,176,31,21,10,412,410,2
2022,2,منطقة عسير,إصلاح وتركيب الآلات والمعدات,متوسطة,1,16,15,1,134,134,0
2022,2,منطقة مكة المكرمة,إصلاح وتركيب الآلات والمعدات,صغيرة,127,387,245,142,1414,1404,10
2022,2,منطقة مكة المكرمة,إصلاح وتركيب الآلات والمعدات,كبيرة,2,398,369,29,297,297,0
2022,2,منطقة مكة المكرمة,إصلاح وتركيب الآلات والمعدات,متناهية الصغر,849,209,109,100,1938,1933,5
2022,2,منطقة مكة المكرمة,إصلاح وتركيب الآلات والمعدات,متوسطة,26,1132,914,218,1773,1763,10
2022,2,منطقة نجران,إصلاح وتركيب الآلات والمعدات,صغيرة,5,6,1,5,40,40,0
2022,2,منطقة نجران,إصلاح وتركيب الآلات والمعدات,متناهية الصغر,42,8,5,3,99,99,0
2022,2,المنطقة الشرقية,إصلاح أجهزة الحاسوب والسلع الشخصية والمنزلية,صغيرة,134,298,215,83,1380,1368,12
2022,2,المنطقة الشرقية,إصلاح أجهزة الحاسوب والسلع الشخصية والمنزلية,كبيرة,1,0,0,0,282,282,0
2022,2,المنطقة الشرقية,إصلاح أجهزة الحاسوب والسلع الشخصية والمنزلية,متناهية الصغر,867,221,124,97,1823,1820,3
2022,2,المنطقة الشرقية,إصلاح أجهزة الحاسوب والسلع الشخصية والمنزلية,متوسطة,12,363,285,78,1083,1083,0
2022,2,منطقة الباحة,إصلاح أجهزة الحاسوب والسلع الشخصية والمنزلية,صغيرة,2,3,3,0,12,12,0
2022,2,منطقة الباحة,إصلاح أجهزة الحاسوب والسلع الشخصية والمنزلية,متناهية الصغر,52,17,13,4,101,101,0
2022,2,منطقة الجوف,إصلاح أجهزة الحاسوب والسلع الشخصية والمنزلية,صغيرة,12,8,7,1,175,175,0
2022,2,منطقة الجوف,إصلاح أجهزة الحاسوب والسلع الشخصية والمنزلية,متناهية الصغر,127,17,11,6,284,284,0
2022,2,منطقة الجوف,إصلاح أجهزة الحاسوب والسلع الشخصية والمنزلية,متوسطة,1,0,0,0,85,85,0
2022,2,منطقة الحدود الشمالية,إصلاح أجهزة الحاسوب والسلع الشخصية والمنزلية,صغيرة,2,1,1,0,12,12,0
2022,2,منطقة الحدود الشمالية,إصلاح أجهزة الحاسوب والسلع الشخصية والمنزلية,متناهية الصغر,73,12,9,3,174,174,0
2022,2,منطقة الرياض,إصلاح أجهزة الحاسوب والسلع الشخصية والمنزلية,صغيرة,447,462,239,223,6558,6527,31
2022,2,منطقة الرياض,إصلاح أجهزة الحاسوب والسلع الشخصية والمنزلية,كبيرة,39,540,426,114,24955,24950,5
2022,2,منطقة الرياض,إصلاح أجهزة الحاسوب والسلع الشخصية والمنزلية,متناهية الصغر,1877,337,179,158,4453,4426,27
2022,2,منطقة الرياض,إصلاح أجهزة الحاسوب والسلع الشخصية والمنزلية,متوسطة,158,116,55,61,19676,19577,99
2022,2,منطقة القصيم,إصلاح أجهزة الحاسوب والسلع الشخصية والمنزلية,صغيرة,210,93,64,29,3186,3174,12
2022,2,منطقة القصيم,إصلاح أجهزة الحاسوب والسلع الشخصية والمنزلية,كبيرة,6,0,0,0,5088,5088,0
2022,2,منطقة القصيم,إصلاح أجهزة الحاسوب والسلع الشخصية والمنزلية,متناهية الصغر,593,95,59,36,1430,1425,5
2022,2,منطقة القصيم,إصلاح أجهزة الحاسوب والسلع الشخصية والمنزلية,متوسطة,45,6,3,3,4296,4292,4
2022,2,منطقة المدينة المنورة,إصلاح أجهزة الحاسوب والسلع الشخصية والمنزلية,صغيرة,28,34,21,13,259,255,4
2022,2,منطقة المدينة المنورة,إصلاح أجهزة الحاسوب والسلع الشخصية والمنزلية,متناهية الصغر,321,64,33,31,692,687,5
2022,2,منطقة تبوك,إصلاح أجهزة الحاسوب والسلع الشخصية والمنزلية,صغيرة,25,35,21,14,207,206,1
2022,2,منطقة تبوك,إصلاح أجهزة الحاسوب والسلع الشخصية والمنزلية,متناهية الصغر,246,47,31,16,544,542,2
2022,2,منطقة تبوك,إصلاح أجهزة الحاسوب والسلع الشخصية والمنزلية,متوسطة,2,1,1,0,238,238,0
2022,2,منطقة جازان,إصلاح أجهزة الحاسوب والسلع الشخصية والمنزلية,صغيرة,18,22,18,4,164,164,0
2022,2,منطقة جازان,إصلاح أجهزة الحاسوب والسلع الشخصية والمنزلية,متناهية الصغر,263,41,24,17,614,611,3
2022,2,منطقة حائل,إصلاح أجهزة الحاسوب والسلع الشخصية والمنزلية,صغيرة,41,25,13,12,418,418,0
2022,2,منطقة حائل,إصلاح أجهزة الحاسوب والسلع الشخصية والمنزلية,متناهية الصغر,288,26,21,5,697,684,13
2022,2,منطقة عسير,إصلاح أجهزة الحاسوب والسلع الشخصية والمنزلية,صغيرة,62,50,38,12,605,603,2
2022,2,منطقة عسير,إصلاح أجهزة الحاسوب والسلع الشخصية والمنزلية,متناهية الصغر,451,71,48,23,999,998,1
2022,2,منطقة مكة المكرمة,إصلاح أجهزة الحاسوب والسلع الشخصية والمنزلية,صغيرة,141,203,114,89,1299,1286,13
2022,2,منطقة مكة المكرمة,إصلاح أجهزة الحاسوب والسلع الشخصية والمنزلية,متناهية الصغر,1305,277,149,128,2826,2795,31
2022,2,منطقة مكة المكرمة,إصلاح أجهزة الحاسوب والسلع الشخصية والمنزلية,متوسطة,8,187,140,47,586,584,2
2022,2,منطقة نجران,إصلاح أجهزة الحاسوب والسلع الشخصية والمنزلية,صغيرة,61,25,7,18,906,905,1
2022,2,منطقة نجران,إصلاح أجهزة الحاسوب والسلع الشخصية والمنزلية,كبيرة,3,0,0,0,953,953,0
2022,2,منطقة نجران,إصلاح أجهزة الحاسوب والسلع الشخصية والمنزلية,متناهية الصغر,200,26,10,16,504,503,1
2022,2,منطقة نجران,إصلاح أجهزة الحاسوب والسلع الشخصية والمنزلية,متوسطة,11,3,2,1,931,931,0
2022,2,المنطقة الشرقية,استخراج النفط الخام والغاز الطبيعي,صغيرة,16,98,74,24,189,189,0
2022,2,المنطقة الشرقية,استخراج النفط الخام والغاز الطبيعي,كبيرة,5,64406,61068,3338,7214,6599,615
2022,2,المنطقة الشرقية,استخراج النفط الخام والغاز الطبيعي,متناهية الصغر,27,20,13,7,55,54,1
2022,2,المنطقة الشرقية,استخراج النفط الخام والغاز الطبيعي,متوسطة,10,612,568,44,427,422,5
2022,2,منطقة الجوف,استخراج النفط الخام والغاز الطبيعي,متناهية الصغر,5,1,1,0,9,9,0
2022,2,منطقة الرياض,استخراج النفط الخام والغاز الطبيعي,صغيرة,7,2,2,0,139,139,0
2022,2,منطقة الرياض,استخراج النفط الخام والغاز الطبيعي,متناهية الصغر,14,6,3,3,36,36,0
2022,2,منطقة الرياض,استخراج النفط الخام والغاز الطبيعي,متوسطة,2,48,35,13,112,112,0
2022,2,منطقة القصيم,استخراج النفط الخام والغاز الطبيعي,متناهية الصغر,1,1,0,1,4,4,0
2022,2,منطقة المدينة المنورة,استخراج النفط الخام والغاز الطبيعي,متناهية الصغر,2,0,0,0,3,3,0
2022,2,منطقة جازان,استخراج النفط الخام والغاز الطبيعي,صغيرة,1,3,3,0,5,5,0
2022,2,منطقة عسير,استخراج النفط الخام والغاز الطبيعي,متناهية الصغر,2,1,0,1,3,3,0
2022,2,منطقة مكة المكرمة,استخراج النفط الخام والغاز الطبيعي,صغيرة,1,0,0,0,17,17,0
2022,2,منطقة مكة المكرمة,استخراج النفط الخام والغاز الطبيعي,كبيرة,1,488,470,18,100,100,0
2022,2,منطقة مكة المكرمة,استخراج النفط الخام والغاز الطبيعي,متناهية الصغر,2,0,0,0,9,9,0
2022,2,منطقة نجران,استخراج النفط الخام والغاز الطبيعي,صغيرة,2,4,4,0,16,16,0
2022,2,منطقة نجران,استخراج النفط الخام والغاز الطبيعي,متناهية الصغر,7,2,2,0,11,10,1
2022,2,المنطقة الشرقية,أبحاث الإعلان والسوق,صغيرة,189,911,431,480,1663,1645,18
2022,2,المنطقة الشرقية,أبحاث الإعلان والسوق,كبيرة,3,2089,1616,473,4499,4495,4
2022,2,المنطقة الشرقية,أبحاث الإعلان والسوق,متناهية الصغر,585,388,147,241,1045,1023,22
2022,2,المنطقة الشرقية,أبحاث الإعلان والسوق,متوسطة,6,312,70,242,304,300,4
2022,2,منطقة الباحة,أبحاث الإعلان والسوق,صغيرة,5,13,6,7,22,22,0
2022,2,منطقة الباحة,أبحاث الإعلان والسوق,متناهية الصغر,15,8,5,3,30,30,0
2022,2,منطقة الجوف,أبحاث الإعلان والسوق,صغيرة,9,9,8,1,56,56,0
2022,2,منطقة الجوف,أبحاث الإعلان والسوق,متناهية الصغر,69,14,9,5,146,144,2
2022,2,منطقة الحدود الشمالية,أبحاث الإعلان والسوق,صغيرة,5,15,9,6,46,46,0
2022,2,منطقة الحدود الشمالية,أبحاث الإعلان والسوق,متناهية الصغر,19,8,3,5,33,33,0
2022,2,منطقة الرياض,أبحاث الإعلان والسوق,صغيرة,581,3435,1520,1915,4708,4501,207
2022,2,منطقة الرياض,أبحاث الإعلان والسوق,كبيرة,9,6536,5205,1331,1619,1394,225
2022,2,منطقة الرياض,أبحاث الإعلان والسوق,متناهية الصغر,1710,1170,461,709,2683,2568,115
2022,2,منطقة الرياض,أبحاث الإعلان والسوق,متوسطة,27,852,476,376,1477,1396,81
2022,2,منطقة القصيم,أبحاث الإعلان والسوق,صغيرة,40,105,58,47,380,376,4
2022,2,منطقة القصيم,أبحاث الإعلان والسوق,متناهية الصغر,130,58,26,32,209,206,3
2022,2,منطقة القصيم,أبحاث الإعلان والسوق,متوسطة,2,27,13,14,147,146,1
2022,2,منطقة المدينة المنورة,أبحاث الإعلان والسوق,صغيرة,31,77,45,32,223,222,1
2022,2,منطقة المدينة المنورة,أبحاث الإعلان والسوق,متناهية الصغر,189,103,56,47,317,312,5
2022,2,منطقة تبوك,أبحاث الإعلان والسوق,صغيرة,6,29,14,15,69,69,0
2022,2,منطقة تبوك,أبحاث الإعلان والسوق,متناهية الصغر,71,22,11,11,137,135,2
2022,2,منطقة جازان,أبحاث الإعلان والسوق,صغيرة,8,36,16,20,65,64,1
2022,2,منطقة جازان,أبحاث الإعلان والسوق,متناهية الصغر,90,32,16,16,179,179,0
2022,2,منطقة حائل,أبحاث الإعلان والسوق,صغيرة,7,8,5,3,49,49,0
2022,2,منطقة حائل,أبحاث الإعلان والسوق,متناهية الصغر,59,20,9,11,117,117,0
2022,2,منطقة عسير,أبحاث الإعلان والسوق,صغيرة,22,89,51,38,207,207,0
2022,2,منطقة عسير,أبحاث الإعلان والسوق,متناهية الصغر,153,76,41,35,291,290,1
2022,2,منطقة عسير,أبحاث الإعلان والسوق,متوسطة,1,26,11,15,59,59,0
2022,2,منطقة مكة المكرمة,أبحاث الإعلان والسوق,صغيرة,320,1564,678,886,2820,2690,130
2022,2,منطقة مكة المكرمة,أبحاث الإعلان والسوق,كبيرة,3,494,381,113,669,659,10
2022,2,منطقة مكة المكرمة,أبحاث الإعلان والسوق,متناهية الصغر,1266,641,257,384,2256,2124,132
2022,2,منطقة مكة المكرمة,أبحاث الإعلان والسوق,متوسطة,30,987,561,426,1841,1763,78
2022,2,منطقة نجران,أبحاث الإعلان والسوق,صغيرة,11,42,18,24,150,150,0
2022,2,منطقة نجران,أبحاث الإعلان والسوق,متناهية الصغر,33,10,6,4,83,83,0
2022,2,المنطقة الشرقية,غير معرف,صغيرة,74,170,103,67,715,674,41
2022,2,المنطقة الشرقية,غير معرف,كبيرة,1,0,0,0,328,272,56
2022,2,المنطقة الشرقية,غير معرف,متناهية الصغر,2251,195,111,84,4038,4005,33
2022,2,منطقة الباحة,غير معرف,متناهية الصغر,220,11,10,1,342,339,3
2022,2,منطقة الجوف,غير معرف,صغيرة,6,6,5,1,37,33,4
2022,2,منطقة الجوف,غير معرف,متناهية الصغر,827,46,31,15,1363,1350,13
2022,2,منطقة الحدود الشمالية,غير معرف,صغيرة,5,4,1,3,31,31,0
2022,2,منطقة الحدود الشمالية,غير معرف,متناهية الصغر,241,18,7,11,402,400,2
2022,2,منطقة الرياض,غير معرف,صغيرة,517,806,408,398,4550,4472,78
2022,2,منطقة الرياض,غير معرف,كبيرة,5,2714,1700,1014,443,421,22
2022,2,منطقة الرياض,غير معرف,متناهية الصغر,51990,3282,1715,1567,108930,108057,873
2022,2,منطقة الرياض,غير معرف,متوسطة,10,275,221,54,366,365,1
2022,2,منطقة القصيم,غير معرف,صغيرة,29,20,14,6,375,368,7
2022,2,منطقة القصيم,غير معرف,متناهية الصغر,1574,101,54,47,3080,3063,17
2022,2,منطقة القصيم,غير معرف,متوسطة,1,0,0,0,54,53,1
2022,2,منطقة المدينة المنورة,غير معرف,صغيرة,24,31,20,11,206,205,1
2022,2,منطقة المدينة المنورة,غير معرف,متناهية الصغر,1654,111,60,51,2700,2632,68
2022,2,منطقة المدينة المنورة,غير معرف,متوسطة,1,0,0,0,54,54,0
2022,2,منطقة تبوك,غير معرف,صغيرة,7,9,6,3,53,53,0
2022,2,منطقة تبوك,غير معرف,متناهية الصغر,588,26,10,16,951,941,10
2022,2,منطقة تبوك,غير معرف,متوسطة,1,0,0,0,61,61,0
2022,2,منطقة جازان,غير معرف,صغيرة,15,27,20,7,125,121,4
2022,2,منطقة جازان,غير معرف,متناهية الصغر,1348,65,39,26,2182,2155,27
2022,2,منطقة جازان,غير معرف,متوسطة,1,74,68,6,130,130,0
2022,2,منطقة حائل,غير معرف,صغيرة,14,11,5,6,140,140,0
2022,2,منطقة حائل,غير معرف,متناهية الصغر,1991,101,63,38,4171,4158,13
2022,2,منطقة حائل,غير معرف,متوسطة,2,0,0,0,159,112,47
2022,2,منطقة عسير,غير معرف,صغيرة,21,47,40,7,181,175,6
2022,2,منطقة عسير,غير معرف,متناهية الصغر,1653,91,56,35,2520,2502,18
2022,2,منطقة مكة المكرمة,غير معرف,صغيرة,127,274,124,150,1096,1047,49
2022,2,منطقة مكة المكرمة,غير معرف,متناهية الصغر,5530,436,256,180,9073,8680,393
2022,2,منطقة مكة المكرمة,غير معرف,متوسطة,6,108,74,34,442,398,44
2022,2,منطقة نجران,غير معرف,صغيرة,26,25,13,12,248,248,0
2022,2,منطقة نجران,غير معرف,متناهية الصغر,2152,131,60,71,4540,4522,18