year,quarter,region,sector,enterprise_size,number_of_enterprises,number_of_saudi_employees,number_of_saudi_employees (male),number_of_saudi_employees (female),number_of_foreign_employees,number_of_foreign_employees (male),number_of_foreign_employees (female)
2022,1,Eastern Province,"Travel Agencies, Tour Operators, Reservation Services, and Related Activities",small,50,276,132,144,462,451,11
2022,1,Eastern Province,"Travel Agencies, Tour Operators, Reservation Services, and Related Activities",large,1,273,258,15,334,333,1
2022,1,Eastern Province,"Travel Agencies, Tour Operators, Reservation Services, and Related Activities",micro,128,96,47,49,198,194,4
2022,1,Eastern Province,"Travel Agencies, Tour Operators, Reservation Services, and Related Activities",medium,7,184,119,65,392,390,2
2022,1,Al Bahah Region,"Travel Agencies, Tour Operators, Reservation Services, and Related Activities",micro,2,0,0,0,6,6,0
2022,1,Al Jawf Region,"Travel Agencies, Tour Operators, Reservation Services, and Related Activities",small,3,13,12,1,35,34,1
2022,1,Al Jawf Region,"Travel Agencies, Tour Operators, Reservation Services, and Related Activities",micro,7,3,0,3,14,14,0
2022,1,Northern Borders Region,"Travel Agencies, Tour Operators, Reservation Services, and Related Activities",small,1,2,2,0,8,8,0
2022,1,Northern Borders Region,"Travel Agencies, Tour Operators, Reservation Services, and Related Activities",large,1,116,113,3,537,537,0
2022,1,Northern Borders Region,"Travel Agencies, Tour Operators, Reservation Services, and Related Activities",micro,8,2,1,1,11,11,0
2022,1,Riyadh Region,"Travel Agencies, Tour Operators, Reservation Services, and Related Activities",small,102,489,233,256,1026,1014,12
2022,1,Riyadh Region,"Travel Agencies, Tour Operators, Reservation Services, and Related Activities",large,4,609,454,155,917,890,27
2022,1,Riyadh Region,"Travel Agencies, Tour Operators, Reservation Services, and Related Activities",micro,278,184,87,97,459,445,14
2022,1,Riyadh Region,"Travel Agencies, Tour Operators, Reservation Services, and Related Activities",medium,16,557,331,226,1127,1121,6
2022,1,Qassim Region,"Travel Agencies, Tour Operators, Reservation Services, and Related Activities",small,18,41,14,27,147,146,1
2022,1,Qassim Region,"Travel Agencies, Tour Operators, Reservation Services, and Related Activities",micro,65,19,9,10,157,156,1
2022,1,Al Madinah Region,"Travel Agencies, Tour Operators, Reservation Services, and Related Activities",small,21,76,40,36,253,243,10
2022,1,Al Madinah Region,"Travel Agencies, Tour Operators, Reservation Services, and Related Activities",micro,101,64,41,23,154,153,1
2022,1,Al Madinah Region,"Travel Agencies, Tour Operators, Reservation Services, and Related Activities",medium,1,8,4,4,47,46,1
2022,1,Tabuk Region,"Travel Agencies, Tour Operators, Reservation Services, and Related Activities",small,5,22,13,9,35,35,0
2022,1,Tabuk Region,"Travel Agencies, Tour Operators, Reservation Services, and Related Activities",micro,24,11,7,4,45,44,1
2022,1,Jazan Region,"Travel Agencies, Tour Operators, Reservation Services, and Related Activities",small,1,6,3,3,8,8,0
2022,1,Jazan Region,"Travel Agencies, Tour Operators, Reservation Services, and Related Activities",micro,21,14,7,7,31,31,0
2022,1,Hail Region,"Travel Agencies, Tour Operators, Reservation Services, and Related Activities",small,6,24,6,18,69,69,0
2022,1,Hail Region,"Travel Agencies, Tour Operators, Reservation Services, and Related Activities",micro,16,11,7,4,28,28,0
2022,1,Aseer Region,"Travel Agencies, Tour Operators, Reservation Services, and Related Activities",small,5,20,9,11,41,41,0
2022,1,Aseer Region,"Travel Agencies, Tour Operators, Reservation Services, and Related Activities",micro,33,23,16,7,43,43,0
2022,1,Makkah Region,"Travel Agencies, Tour Operators, Reservation Services, and Related Activities",small,184,667,416,251,1558,1534,24
2022,1,Makkah Region,"Travel Agencies, Tour Operators, Reservation Services, and Related Activities",large,1,3141,2862,279,790,790,0
2022,1,Makkah Region,"Travel Agencies, Tour Operators, Reservation Services, and Related Activities",micro,496,352,214,138,814,793,21
2022,1,Makkah Region,"Travel Agencies, Tour Operators, Reservation Services, and Related Activities",medium,17,790,518,272,1036,1029,7
2022,1,Najran Region,"Travel Agencies, Tour Operators, Reservation Services, and Related Activities",small,3,8,2,6,31,31,0
2022,1,Najran Region,"Travel Agencies, Tour Operators, Reservation Services, and Related Activities",micro,8,8,5,3,18,18,0
2022,1,Eastern Province,Fishing and Aquaculture,small,131,141,57,84,1395,1393,2
2022,1,Eastern Province,Fishing and Aquaculture,micro,275,52,33,19,686,686,0
2022,1,Eastern Province,Fishing and Aquaculture,medium,1,7,3,4,57,57,0
2022,1,Al Bahah Region,Fishing and Aquaculture,small,1,1,1,0,5,5,0
2022,1,Al Bahah Region,Fishing and Aquaculture,micro,12,0,0,0,22,22,0
2022,1,Al Jawf Region,Fishing and Aquaculture,micro,39,3,1,2,55,55,0
2022,1,Northern Borders Region,Fishing and Aquaculture,micro,11,1,1,0,23,23,0
2022,1,Riyadh Region,Fishing and Aquaculture,small,17,28,17,11,135,135,0
2022,1,Riyadh Region,Fishing and Aquaculture,micro,4309,524,260,264,7828,7775,53
2022,1,Qassim Region,Fishing and Aquaculture,small,2,7,0,7,15,15,0
2022,1,Qassim Region,Fishing and Aquaculture,micro,97,15,10,5,192,192,0
2022,1,Al Madinah Region,Fishing and Aquaculture,small,10,4,0,4,81,81,0
2022,1,Al Madinah Region,Fishing and Aquaculture,micro,100,5,2,3,190,185,5
2022,1,Tabuk Region,Fishing and Aquaculture,small,3,4,2,2,31,31,0
2022,1,Tabuk Region,Fishing and Aquaculture,micro,41,4,2,2,61,60,1
2022,1,Jazan Region,Fishing and Aquaculture,small,52,136,96,40,601,600,1
2022,1,Jazan Region,Fishing and Aquaculture,large,1,78,72,6,233,233,0
2022,1,Jazan Region,Fishing and Aquaculture,micro,142,19,10,9,311,311,0
2022,1,Jazan Region,Fishing and Aquaculture,medium,1,30,11,19,196,196,0
2022,1,Hail Region,Fishing and Aquaculture,small,2,3,2,1,10,10,0
2022,1,Hail Region,Fishing and Aquaculture,micro,168,20,12,8,339,337,2
2022,1,Aseer Region,Fishing and Aquaculture,small,7,3,2,1,59,59,0
2022,1,Aseer Region,Fishing and Aquaculture,micro,121,11,3,8,247,247,0
2022,1,Makkah Region,Fishing and Aquaculture,small,35,35,18,17,395,393,2
2022,1,Makkah Region,Fishing and Aquaculture,large,1,605,511,94,2476,2471,5
2022,1,Makkah Region,Fishing and Aquaculture,micro,530,60,27,33,962,920,42
2022,1,Makkah Region,Fishing and Aquaculture,medium,1,1,1,0,67,67,0
2022,1,Najran Region,Fishing and Aquaculture,small,1,0,0,0,8,8,0
2022,1,Najran Region,Fishing and Aquaculture,micro,176,18,5,13,311,310,1
2022,1,Eastern Province,Manufacture of Shaped Metal Products (Except Machinery and Equipment),small,567,1763,1101,662,6818,6810,8
2022,1,Eastern Province,Manufacture of Shaped Metal Products (Except Machinery and Equipment),large,20,6818,6540,278,7312,7304,8
2022,1,Eastern Province,Manufacture of Shaped Metal Products (Except Machinery and Equipment),micro,1273,420,237,183,2586,2582,4
2022,1,Eastern Province,Manufacture of Shaped Metal Products (Except Machinery and Equipment),medium,94,2486,1956,530,7567,7560,7
2022,1,Al Bahah Region,Manufacture of Shaped Metal Products (Except Machinery and Equipment),small,22,20,14,6,202,202,0
2022,1,Al Bahah Region,Manufacture of Shaped Metal Products (Except Machinery and Equipment),micro,226,57,35,22,451,451,0
2022,1,Al Bahah Region,Manufacture of Shaped Metal Products (Except Machinery and Equipment),medium,1,18,17,1,61,61,0
2022,1,Al Jawf Region,Manufacture of Shaped Metal Products (Except Machinery and Equipment),small,30,39,32,7,327,327,0
2022,1,Al Jawf Region,Manufacture of Shaped Metal Products (Except Machinery and Equipment),micro,219,29,24,5,468,467,1
2022,1,Northern Borders Region,Manufacture of Shaped Metal Products (Except Machinery and Equipment),small,14,25,15,10,144,144,0
2022,1,Northern Borders Region,Manufacture of Shaped Metal Products (Except Machinery and Equipment),micro,87,19,12,7,202,198,4
2022,1,Riyadh Region,Manufacture of Shaped Metal Products (Except Machinery and Equipment),small,861,2588,1152,1436,10922,10864,58
2022,1,Riyadh Region,Manufacture of Shaped Metal Products (Except Machinery and Equipment),large,16,2714,1711,1003,5750,5741,9
2022,1,Riyadh Region,Manufacture of Shaped Metal Products (Except Machinery and Equipment),micro,2126,599,277,322,4681,4664,17
2022,1,Riyadh Region,Manufacture of Shaped Metal Products (Except Machinery and Equipment),medium,122,2690,1530,1160,9468,9438,30
2022,1,Qassim Region,Manufacture of Shaped Metal Products (Except Machinery and Equipment),small,162,328,188,140,1743,1743,0
2022,1,Qassim Region,Manufacture of Shaped Metal Products (Except Machinery and Equipment),large,1,119,97,22,360,360,0
2022,1,Qassim Region,Manufacture of Shaped Metal Products (Except Machinery and Equipment),micro,1026,191,118,73,2443,2436,7
2022,1,Qassim Region,Manufacture of Shaped Metal Products (Except Machinery and Equipment),medium,5,43,31,12,275,275,0
2022,1,Al Madinah Region,Manufacture of Shaped Metal Products (Except Machinery and Equipment),small,76,168,102,66,819,816,3
2022,1,Al Madinah Region,Manufacture of Shaped Metal Products (Except Machinery and Equipment),micro,509,109,65,44,1130,1129,1
2022,1,Al Madinah Region,Manufacture of Shaped Metal Products (Except Machinery and Equipment),medium,6,144,115,29,544,544,0
2022,1,Tabuk Region,Manufacture of Shaped Metal Products (Except Machinery and Equipment),small,38,70,31,39,366,364,2
2022,1,Tabuk Region,Manufacture of Shaped Metal Products (Except Machinery and Equipment),micro,185,44,28,16,389,389,0
2022,1,Tabuk Region,Manufacture of Shaped Metal Products (Except Machinery and Equipment),medium,1,16,15,1,75,75,0
2022,1,Jazan Region,Manufacture of Shaped Metal Products (Except Machinery and Equipment),small,51,76,53,23,386,385,1
2022,1,Jazan Region,Manufacture of Shaped Metal Products (Except Machinery and Equipment),micro,676,83,54,29,1609,1606,3
2022,1,Hail Region,Manufacture of Shaped Metal Products (Except Machinery and Equipment),small,45,125,74,51,496,496,0
2022,1,Hail Region,Manufacture of Shaped Metal Products (Except Machinery and Equipment),micro,201,41,24,17,428,424,4
2022,1,Hail Region,Manufacture of Shaped Metal Products (Except Machinery and Equipment),medium,2,27,8,19,117,117,0
2022,1,Aseer Region,Manufacture of Shaped Metal Products (Except Machinery and Equipment),small,78,184,113,71,866,865,1
2022,1,Aseer Region,Manufacture of Shaped Metal Products (Except Machinery and Equipment),micro,809,157,88,69,1817,1816,1
2022,1,Aseer Region,Manufacture of Shaped Metal Products (Except Machinery and Equipment),medium,5,63,41,22,321,321,0
2022,1,Makkah Region,Manufacture of Shaped Metal Products (Except Machinery and Equipment),small,341,861,436,425,4057,4038,19
2022,1,Makkah Region,Manufacture of Shaped Metal Products (Except Machinery and Equipment),large,8,914,612,302,2765,2760,5
2022,1,Makkah Region,Manufacture of Shaped Metal Products (Except Machinery and Equipment),micro,1750,334,192,142,3958,3945,13
2022,1,Makkah Region,Manufacture of Shaped Metal Products (Except Machinery and Equipment),medium,75,2086,1573,513,6078,6069,9
2022,1,Najran Region,Manufacture of Shaped Metal Products (Except Machinery and Equipment),small,19,26,10,16,204,204,0
2022,1,Najran Region,Manufacture of Shaped Metal Products (Except Machinery and Equipment),micro,280,33,18,15,692,690,2
2022,1,Najran Region,Manufacture of Shaped Metal Products (Except Machinery and Equipment),medium,1,0,0,0,58,58,0
2022,1,Eastern Province,Manufacture of Other Non-Metallic Mineral Products,small,232,875,551,324,3398,3396,2
2022,1,Eastern Province,Manufacture of Other Non-Metallic Mineral Products,large,14,2321,1968,353,5040,5038,2
2022,1,Eastern Province,Manufacture of Other Non-Metallic Mineral Products,micro,342,143,79,64,692,691,1
2022,1,Eastern Province,Manufacture of Other Non-Metallic Mineral Products,medium,88,1953,1410,543,6756,6753,3
2022,1,Al Bahah Region,Manufacture of Other Non-Metallic Mineral Products,small,18,58,41,17,253,252,1
2022,1,Al Bahah Region,Manufacture of Other Non-Metallic Mineral Products,micro,44,8,7,1,89,89,0
2022,1,Al Bahah Region,Manufacture of Other Non-Metallic Mineral Products,medium,4,69,51,18,297,296,1
2022,1,Al Jawf Region,Manufacture of Other Non-Metallic Mineral Products,small,25,104,79,25,326,326,0
2022,1,Al Jawf Region,Manufacture of Other Non-Metallic Mineral Products,micro,53,16,13,3,107,106,1
2022,1,Al Jawf Region,Manufacture of Other Non-Metallic Mineral Products,medium,6,122,100,22,471,471,0
2022,1,Northern Borders Region,Manufacture of Other Non-Metallic Mineral Products,small,20,53,25,28,221,221,0
2022,1,Northern Borders Region,Manufacture of Other Non-Metallic Mineral Products,large,1,243,241,2,239,239,0
2022,1,Northern Borders Region,Manufacture of Other Non-Metallic Mineral Products,micro,31,13,8,5,59,59,0
2022,1,Northern Borders Region,Manufacture of Other Non-Metallic Mineral Products,medium,1,34,16,18,85,85,0
2022,1,Riyadh Region,Manufacture of Other Non-Metallic Mineral Products,small,847,1768,849,919,12216,12183,33
2022,1,Riyadh Region,Manufacture of Other Non-Metallic Mineral Products,large,29,4559,3574,985,11707,11695,12
2022,1,Riyadh Region,Manufacture of Other Non-Metallic Mineral Products,micro,1498,410,208,202,3292,3284,8
2022,1,Riyadh Region,Manufacture of Other Non-Metallic Mineral Products,medium,140,3082,1757,1325,11218,11193,25
2022,1,Qassim Region,Manufacture of Other Non-Metallic Mineral Products,small,97,225,127,98,1306,1303,3
2022,1,Qassim Region,Manufacture of Other Non-Metallic Mineral Products,large,5,825,669,156,2860,2860,0
2022,1,Qassim Region,Manufacture of Other Non-Metallic Mineral Products,micro,216,54,30,24,489,488,1
2022,1,Qassim Region,Manufacture of Other Non-Metallic Mineral Products,medium,27,556,368,188,2067,2066,1
2022,1,Al Madinah Region,Manufacture of Other Non-Metallic Mineral Products,small,70,216,142,74,788,787,1
2022,1,Al Madinah Region,Manufacture of Other Non-Metallic Mineral Products,large,4,687,538,149,1218,1216,2
2022,1,Al Madinah Region,Manufacture of Other Non-Metallic Mineral Products,micro,156,55,32,23,321,320,1
2022,1,Al Madinah Region,Manufacture of Other Non-Metallic Mineral Products,medium,27,789,607,182,2120,2119,1
2022,1,Tabuk Region,Manufacture of Other Non-Metallic Mineral Products,small,26,133,84,49,290,290,0
2022,1,Tabuk Region,Manufacture of Other Non-Metallic Mineral Products,large,2,335,315,20,565,563,2
2022,1,Tabuk Region,Manufacture of Other Non-Metallic Mineral Products,micro,50,14,9,5,90,90,0
2022,1,Tabuk Region,Manufacture of Other Non-Metallic Mineral Products,medium,2,25,15,10,82,82,0
2022,1,Jazan Region,Manufacture of Other Non-Metallic Mineral Products,small,48,225,132,93,698,697,1
2022,1,Jazan Region,Manufacture of Other Non-Metallic Mineral Products,large,1,347,347,0,159,159,0
2022,1,Jazan Region,Manufacture of Other Non-Metallic Mineral Products,micro,126,51,37,14,278,277,1
2022,1,Jazan Region,Manufacture of Other Non-Metallic Mineral Products,medium,17,373,254,119,1257,1257,0
2022,1,Hail Region,Manufacture of Other Non-Metallic Mineral Products,small,39,57,39,18,437,435,2
2022,1,Hail Region,Manufacture of Other Non-Metallic Mineral Products,large,1,257,257,0,170,170,0
2022,1,Hail Region,Manufacture of Other Non-Metallic Mineral Products,micro,128,26,14,12,293,292,1
2022,1,Hail Region,Manufacture of Other Non-Metallic Mineral Products,medium,6,122,88,34,414,414,0
2022,1,Aseer Region,Manufacture of Other Non-Metallic Mineral Products,small,112,373,238,135,1458,1458,0
2022,1,Aseer Region,Manufacture of Other Non-Metallic Mineral Products,large,6,969,898,71,2107,2107,0
2022,1,Aseer Region,Manufacture of Other Non-Metallic Mineral Products,micro,230,76,48,28,477,474,3
2022,1,Aseer Region,Manufacture of Other Non-Metallic Mineral Products,medium,29,597,413,184,2234,2233,1
2022,1,Makkah Region,Manufacture of Other Non-Metallic Mineral Products,small,184,721,391,330,2658,2650,8
2022,1,Makkah Region,Manufacture of Other Non-Metallic Mineral Products,large,17,2865,2030,835,6857,6853,4
2022,1,Makkah Region,Manufacture of Other Non-Metallic Mineral Products,micro,402,142,74,68,849,846,3
2022,1,Makkah Region,Manufacture of Other Non-Metallic Mineral Products,medium,49,1039,660,379,3784,3779,5
2022,1,Najran Region,Manufacture of Other Non-Metallic Mineral Products,small,34,135,77,58,579,566,13
2022,1,Najran Region,Manufacture of Other Non-Metallic Mineral Products,large,1,346,329,17,389,389,0
2022,1,Najran Region,Manufacture of Other Non-Metallic Mineral Products,micro,71,19,12,7,171,170,1
2022,1,Najran Region,Manufacture of Other Non-Metallic Mineral Products,medium,11,291,194,97,1014,1006,8
2022,1,Eastern Province,Manufacture of Rubber and Plastic Products,small,39,160,105,55,666,666,0
2022,1,Eastern Province,Manufacture of Rubber and Plastic Products,large,6,690,560,130,1704,1704,0
2022,1,Eastern Province,Manufacture of Rubber and Plastic Products,micro,39,13,7,6,86,86,0
2022,1,Eastern Province,Manufacture of Rubber and Plastic Products,medium,31,868,652,216,2234,2232,2
2022,1,Al Bahah Region,Manufacture of Rubber and Plastic Products,small,1,3,2,1,21,21,0
2022,1,Al Bahah Region,Manufacture of Rubber and Plastic Products,micro,2,1,0,1,1,1,0
2022,1,Al Jawf Region,Manufacture of Rubber and Plastic Products,small,2,11,7,4,40,40,0
2022,1,Al Jawf Region,Manufacture of Rubber and Plastic Products,large,1,121,82,39,354,353,1
2022,1,Al Jawf Region,Manufacture of Rubber and Plastic Products,micro,8,0,0,0,17,17,0
2022,1,Northern Borders Region,Manufacture of Rubber and Plastic Products,small,2,3,1,2,17,17,0
2022,1,Riyadh Region,Manufacture of Rubber and Plastic Products,small,115,522,233,289,2030,2028,2
2022,1,Riyadh Region,Manufacture of Rubber and Plastic Products,large,11,950,573,377,3120,3115,5
2022,1,Riyadh Region,Manufacture of Rubber and Plastic Products,micro,168,57,23,34,346,345,1
2022,1,Riyadh Region,Manufacture of Rubber and Plastic Products,medium,62,1608,862,746,5033,5023,10
2022,1,Qassim Region,Manufacture of Rubber and Plastic Products,small,5,41,23,18,78,78,0
2022,1,Qassim Region,Manufacture of Rubber and Plastic Products,micro,7,0,0,0,16,16,0
2022,1,Qassim Region,Manufacture of Rubber and Plastic Products,medium,5,158,94,64,424,423,1
2022,1,Al Madinah Region,Manufacture of Rubber and Plastic Products,small,18,79,38,41,318,317,1
2022,1,Al Madinah Region,Manufacture of Rubber and Plastic Products,large,1,139,73,66,347,347,0
2022,1,Al Madinah Region,Manufacture of Rubber and Plastic Products,micro,19,19,12,7,29,29,0
2022,1,Al Madinah Region,Manufacture of Rubber and Plastic Products,medium,7,229,167,62,593,587,6
2022,1,Tabuk Region,Manufacture of Rubber and Plastic Products,small,5,20,12,8,72,72,0
2022,1,Tabuk Region,Manufacture of Rubber and Plastic Products,micro,7,5,0,5,16,16,0
2022,1,Jazan Region,Manufacture of Rubber and Plastic Products,small,3,7,6,1,44,44,0
2022,1,Jazan Region,Manufacture of Rubber and Plastic Products,micro,2,0,0,0,7,7,0
2022,1,Hail Region,Manufacture of Rubber and Plastic Products,small,3,17,6,11,45,45,0
2022,1,Hail Region,Manufacture of Rubber and Plastic Products,micro,4,1,1,0,10,10,0
2022,1,Hail Region,Manufacture of Rubber and Plastic Products,medium,3,108,84,24,180,180,0
2022,1,Aseer Region,Manufacture of Rubber and Plastic Products,small,8,18,14,4,100,100,0
2022,1,Aseer Region,Manufacture of Rubber and Plastic Products,micro,19,4,3,1,40,40,0
2022,1,Aseer Region,Manufacture of Rubber and Plastic Products,medium,2,50,21,29,159,159,0
2022,1,Makkah Region,Manufacture of Rubber and Plastic Products,small,70,351,195,156,1212,1197,15
2022,1,Makkah Region,Manufacture of Rubber and Plastic Products,large,8,1043,792,251,2594,2577,17
2022,1,Makkah Region,Manufacture of Rubber and Plastic Products,micro,76,41,28,13,129,128,1
2022,1,Makkah Region,Manufacture of Rubber and Plastic Products,medium,35,1005,578,427,3033,3028,5
2022,1,Najran Region,Manufacture of Rubber and Plastic Products,small,3,20,14,6,66,66,0
2022,1,Najran Region,Manufacture of Rubber and Plastic Products,micro,10,5,1,4,29,29,0
2022,1,Najran Region,Manufacture of Rubber and Plastic Products,medium,1,40,16,24,56,56,0
2022,1,Eastern Province,Manufacture of Coke and Refined Petroleum Products,small,22,166,147,19,310,309,1
2022,1,Eastern Province,Manufacture of Coke and Refined Petroleum Products,large,6,2927,2883,44,1387,1386,1
2022,1,Eastern Province,Manufacture of Coke and Refined Petroleum Products,micro,13,12,9,3,23,23,0
2022,1,Eastern Province,Manufacture of Coke and Refined Petroleum Products,medium,8,463,435,28,671,671,0
2022,1,Al Jawf Region,Manufacture of Coke and Refined Petroleum Products,micro,1,0,0,0,3,3,0
2022,1,Riyadh Region,Manufacture of Coke and Refined Petroleum Products,small,29,143,90,53,372,369,3
2022,1,Riyadh Region,Manufacture of Coke and Refined Petroleum Products,micro,44,34,21,13,72,71,1
2022,1,Riyadh Region,Manufacture of Coke and Refined Petroleum Products,medium,2,116,88,28,163,162,1
2022,1,Qassim Region,Manufacture of Coke and Refined Petroleum Products,small,3,19,18,1,45,45,0
2022,1,Qassim Region,Manufacture of Coke and Refined Petroleum Products,micro,1,1,1,0,3,3,0
2022,1,Al Madinah Region,Manufacture of Coke and Refined Petroleum Products,small,1,8,8,0,23,23,0
2022,1,Al Madinah Region,Manufacture of Coke and Refined Petroleum Products,large,4,1937,1879,58,781,781,0
2022,1,Al Madinah Region,Manufacture of Coke and Refined Petroleum Products,micro,5,2,2,0,8,8,0
2022,1,Al Madinah Region,Manufacture of Coke and Refined Petroleum Products,medium,3,272,272,0,155,155,0
2022,1,Jazan Region,Manufacture of Coke and Refined Petroleum Products,medium,1,103,101,2,34,29,5
2022,1,Aseer Region,Manufacture of Coke and Refined Petroleum Products,small,1,7,4,3,12,12,0
2022,1,Aseer Region,Manufacture of Coke and Refined Petroleum Products,micro,1,2,1,1,1,1,0
2022,1,Makkah Region,Manufacture of Coke and Refined Petroleum Products,small,16,94,70,24,206,204,2
2022,1,Makkah Region,Manufacture of Coke and Refined Petroleum Products,large,2,2834,2748,86,1545,1533,12
2022,1,Makkah Region,Manufacture of Coke and Refined Petroleum Products,micro,15,8,5,3,23,23,0
2022,1,Makkah Region,Manufacture of Coke and Refined Petroleum Products,medium,3,21,15,6,160,160,0
2022,1,Eastern Province,Manufacture of Paper and Paper Products,small,40,233,126,107,679,677,2
2022,1,Eastern Province,Manufacture of Paper and Paper Products,large,5,547,414,133,1379,1377,2
2022,1,Eastern Province,Manufacture of Paper and Paper Products,micro,47,25,15,10,103,102,1
2022,1,Eastern Province,Manufacture of Paper and Paper Products,medium,15,517,363,154,1392,1390,2
2022,1,Al Bahah Region,Manufacture of Paper and Paper Products,micro,1,1,1,0,4,4,0
2022,1,Al Jawf Region,Manufacture of Paper and Paper Products,small,1,3,2,1,12,12,0
2022,1,Al Jawf Region,Manufacture of Paper and Paper Products,micro,2,1,1,0,7,7,0
2022,1,Northern Borders Region,Manufacture of Paper and Paper Products,small,2,4,2,2,15,15,0
2022,1,Northern Borders Region,Manufacture of Paper and Paper Products,micro,2,0,0,0,5,5,0
2022,1,Riyadh Region,Manufacture of Paper and Paper Products,small,73,318,147,171,1019,1016,3
2022,1,Riyadh Region,Manufacture of Paper and Paper Products,large,2,83,28,55,432,432,0
2022,1,Riyadh Region,Manufacture of Paper and Paper Products,micro,104,48,20,28,229,229,0
2022,1,Riyadh Region,Manufacture of Paper and Paper Products,medium,31,850,478,372,2491,2487,4
2022,1,Qassim Region,Manufacture of Paper and Paper Products,small,8,33,15,18,101,101,0
2022,1,Qassim Region,Manufacture of Paper and Paper Products,micro,14,6,2,4,31,31,0
2022,1,Qassim Region,Manufacture of Paper and Paper Products,medium,3,90,75,15,288,287,1
2022,1,Al Madinah Region,Manufacture of Paper and Paper Products,small,10,43,22,21,137,136,1
2022,1,Al Madinah Region,Manufacture of Paper and Paper Products,micro,13,5,3,2,27,27,0
2022,1,Al Madinah Region,Manufacture of Paper and Paper Products,medium,1,17,7,10,66,66,0
2022,1,Tabuk Region,Manufacture of Paper and Paper Products,small,3,13,6,7,40,40,0
2022,1,Tabuk Region,Manufacture of Paper and Paper Products,micro,4,2,1,1,9,9,0
2022,1,Jazan Region,Manufacture of Paper and Paper Products,small,1,2,1,1,6,6,0
2022,1,Jazan Region,Manufacture of Paper and Paper Products,micro,5,4,1,3,10,10,0
2022,1,Jazan Region,Manufacture of Paper and Paper Products,medium,1,17,8,9,46,46,0
2022,1,Hail Region,Manufacture of Paper and Paper Products,small,2,7,4,3,23,23,0
2022,1,Hail Region,Manufacture of Paper and Paper Products,micro,5,5,3,2,10,10,0
2022,1,Aseer Region,Manufacture of Paper and Paper Products,small,9,37,19,18,87,87,0
2022,1,Aseer Region,Manufacture of Paper and Paper Products,micro,10,4,3,1,26,25,1
2022,1,Makkah Region,Manufacture of Paper and Paper Products,small,62,239,138,101,844,839,5
2022,1,Makkah Region,Manufacture of Paper and Paper Products,large,5,713,541,172,1665,1658,7
2022,1,Makkah Region,Manufacture of Paper and Paper Products,micro,48,28,18,10,93,91,2
2022,1,Makkah Region,Manufacture of Paper and Paper Products,medium,21,666,352,314,1587,1577,10
2022,1,Najran Region,Manufacture of Paper and Paper Products,small,3,1,1,0,21,21,0
2022,1,Najran Region,Manufacture of Paper and Paper Products,micro,18,4,1,3,39,39,0
2022,1,Eastern Province,Manufacture of Chemicals and Chemical Products,small,149,985,746,239,2070,2063,7
2022,1,Eastern Province,Manufacture of Chemicals and Chemical Products,large,16,11081,10980,101,2573,2572,1
2022,1,Eastern Province,Manufacture of Chemicals and Chemical Products,micro,159,117,60,57,240,239,1
2022,1,Eastern Province,Manufacture of Chemicals and Chemical Products,medium,66,3063,2715,348,4227,4221,6
2022,1,Al Bahah Region,Manufacture of Chemicals and Chemical Products,small,4,5,4,1,67,67,0
2022,1,Al Bahah Region,Manufacture of Chemicals and Chemical Products,micro,4,0,0,0,8,8,0
2022,1,Al Jawf Region,Manufacture of Chemicals and Chemical Products,small,1,2,1,1,4,4,0
2022,1,Al Jawf Region,Manufacture of Chemicals and Chemical Products,micro,8,3,1,2,14,14,0
2022,1,Northern Borders Region,Manufacture of Chemicals and Chemical Products,large,1,575,570,5,231,231,0
2022,1,Northern Borders Region,Manufacture of Chemicals and Chemical Products,micro,8,2,1,1,18,18,0
2022,1,Riyadh Region,Manufacture of Chemicals and Chemical Products,small,320,1429,701,728,4688,4673,15
2022,1,Riyadh Region,Manufacture of Chemicals and Chemical Products,large,13,2189,1404,785,3758,3744,14
2022,1,Riyadh Region,Manufacture of Chemicals and Chemical Products,micro,436,214,91,123,856,847,9
2022,1,Riyadh Region,Manufacture of Chemicals and Chemical Products,medium,78,2008,1070,938,6025,6014,11
2022,1,Qassim Region,Manufacture of Chemicals and Chemical Products,small,14,22,9,13,132,132,0
2022,1,Qassim Region,Manufacture of Chemicals and Chemical Products,large,2,508,483,25,1193,1192,1
2022,1,Qassim Region,Manufacture of Chemicals and Chemical Products,micro,27,12,8,4,47,47,0
2022,1,Qassim Region,Manufacture of Chemicals and Chemical Products,medium,9,185,111,74,489,489,0
2022,1,Al Madinah Region,Manufacture of Chemicals and Chemical Products,small,25,140,110,30,334,332,2
2022,1,Al Madinah Region,Manufacture of Chemicals and Chemical Products,large,4,2581,2572,9,378,378,0
2022,1,Al Madinah Region,Manufacture of Chemicals and Chemical Products,micro,39,20,13,7,81,80,1
2022,1,Al Madinah Region,Manufacture of Chemicals and Chemical Products,medium,11,254,217,37,608,604,4
2022,1,Tabuk Region,Manufacture of Chemicals and Chemical Products,small,6,31,17,14,104,104,0
2022,1,Tabuk Region,Manufacture of Chemicals and Chemical Products,large,1,518,323,195,728,723,5
2022,1,Tabuk Region,Manufacture of Chemicals and Chemical Products,micro,15,6,4,2,30,30,0
2022,1,Tabuk Region,Manufacture of Chemicals and Chemical Products,medium,1,7,5,2,43,43,0
2022,1,Jazan Region,Manufacture of Chemicals and Chemical Products,small,9,36,22,14,112,112,0
2022,1,Jazan Region,Manufacture of Chemicals and Chemical Products,micro,14,5,3,2,32,32,0
2022,1,Jazan Region,Manufacture of Chemicals and Chemical Products,medium,1,9,9,0,73,73,0
2022,1,Hail Region,Manufacture of Chemicals and Chemical Products,small,11,11,4,7,76,76,0
2022,1,Hail Region,Manufacture of Chemicals and Chemical Products,micro,50,15,10,5,121,121,0
2022,1,Aseer Region,Manufacture of Chemicals and Chemical Products,small,22,83,44,39,321,320,1
2022,1,Aseer Region,Manufacture of Chemicals and Chemical Products,large,1,601,488,113,1357,1354,3
2022,1,Aseer Region,Manufacture of Chemicals and Chemical Products,micro,32,14,9,5,59,59,0
2022,1,Aseer Region,Manufacture of Chemicals and Chemical Products,medium,3,67,45,22,215,215,0
2022,1,Makkah Region,Manufacture of Chemicals and Chemical Products,small,168,746,406,340,2595,2578,17
2022,1,Makkah Region,Manufacture of Chemicals and Chemical Products,large,4,853,640,213,2242,2237,5
2022,1,Makkah Region,Manufacture of Chemicals and Chemical Products,micro,235,116,66,50,456,445,11
2022,1,Makkah Region,Manufacture of Chemicals and Chemical Products,medium,64,1858,1233,625,4794,4754,40
2022,1,Najran Region,Manufacture of Chemicals and Chemical Products,small,4,10,5,5,41,41,0
2022,1,Najran Region,Manufacture of Chemicals and Chemical Products,micro,14,3,2,1,28,28,0
2022,1,Najran Region,Manufacture of Chemicals and Chemical Products,medium,1,9,9,0,41,41,0
2022,1,Eastern Province,Manufacture of Textiles,small,63,146,73,73,708,685,23
2022,1,Eastern Province,Manufacture of Textiles,micro,305,68,22,46,647,625,22
2022,1,Eastern Province,Manufacture of Textiles,medium,7,268,213,55,554,554,0
2022,1,Al Bahah Region,Manufacture of Textiles,small,5,5,3,2,46,45,1
2022,1,Al Bahah Region,Manufacture of Textiles,micro,16,7,3,4,40,40,0
2022,1,Al Jawf Region,Manufacture of Textiles,small,6,3,3,0,63,63,0
2022,1,Al Jawf Region,Manufacture of Textiles,micro,41,6,5,1,90,89,1
2022,1,Northern Borders Region,Manufacture of Textiles,small,3,5,4,1,30,30,0
2022,1,Northern Borders Region,Manufacture of Textiles,micro,26,6,4,2,59,56,3
2022,1,Riyadh Region,Manufacture of Textiles,small,78,170,67,103,820,817,3
2022,1,Riyadh Region,Manufacture of Textiles,large,6,1606,907,699,3538,3515,23
2022,1,Riyadh Region,Manufacture of Textiles,micro,376,84,39,45,799,794,5
2022,1,Riyadh Region,Manufacture of Textiles,medium,10,340,189,151,881,879,2
2022,1,Qassim Region,Manufacture of Textiles,small,15,25,23,2,128,128,0
2022,1,Qassim Region,Manufacture of Textiles,micro,85,18,12,6,205,205,0
2022,1,Qassim Region,Manufacture of Textiles,medium,1,18,9,9,50,50,0
2022,1,Al Madinah Region,Manufacture of Textiles,small,28,65,45,20,301,299,2
2022,1,Al Madinah Region,Manufacture of Textiles,micro,119,23,10,13,260,252,8
2022,1,Al Madinah Region,Manufacture of Textiles,medium,4,91,52,39,304,304,0
2022,1,Tabuk Region,Manufacture of Textiles,small,11,17,5,12,109,108,1
2022,1,Tabuk Region,Manufacture of Textiles,micro,56,11,8,3,137,135,2
2022,1,Jazan Region,Manufacture of Textiles,small,1,4,3,1,12,12,0
2022,1,Jazan Region,Manufacture of Textiles,micro,22,1,1,0,54,54,0
2022,1,Hail Region,Manufacture of Textiles,small,13,23,17,6,125,125,0
2022,1,Hail Region,Manufacture of Textiles,micro,48,5,3,2,121,119,2
2022,1,Aseer Region,Manufacture of Textiles,small,6,14,8,6,62,62,0
2022,1,Aseer Region,Manufacture of Textiles,micro,54,12,9,3,137,134,3
2022,1,Aseer Region,Manufacture of Textiles,medium,1,1,1,0,59,56,3
2022,1,Makkah Region,Manufacture of Textiles,small,55,135,69,66,591,577,14
2022,1,Makkah Region,Manufacture of Textiles,large,3,288,278,10,973,972,1
2022,1,Makkah Region,Manufacture of Textiles,micro,257,51,33,18,578,565,13
2022,1,Makkah Region,Manufacture of Textiles,medium,9,328,249,79,563,560,3
2022,1,Najran Region,Manufacture of Textiles,small,6,7,2,5,73,70,3
2022,1,Najran Region,Manufacture of Textiles,micro,45,5,5,0,117,114,3
2022,1,Eastern Province,Manufacture of Food Products,small,254,868,473,395,3230,3221,9
2022,1,Eastern Province,Manufacture of Food Products,large,11,1215,569,646,4131,4124,7
2022,1,Eastern Province,Manufacture of Food Products,micro,697,261,136,125,1393,1388,5
2022,1,Eastern Province,Manufacture of Food Products,medium,59,1198,703,495,4302,4290,12
2022,1,Al Bahah Region,Manufacture of Food Products,small,18,38,26,12,193,190,3
2022,1,Al Bahah Region,Manufacture of Food Products,micro,80,21,15,6,159,158,1
2022,1,Al Bahah Region,Manufacture of Food Products,medium,1,12,6,6,48,48,0
2022,1,Al Jawf Region,Manufacture of Food Products,small,34,63,53,10,311,311,0
2022,1,Al Jawf Region,Manufacture of Food Products,micro,141,37,27,10,286,286,0
2022,1,Northern Borders Region,Manufacture of Food Products,small,20,43,28,15,249,249,0
2022,1,Northern Borders Region,Manufacture of Food Products,micro,91,12,9,3,193,193,0
2022,1,Riyadh Region,Manufacture of Food Products,small,506,1740,770,970,6763,6707,56
2022,1,Riyadh Region,Manufacture of Food Products,large,34,5255,3392,1863,14379,14329,50
2022,1,Riyadh Region,Manufacture of Food Products,micro,1558,508,259,249,3173,3144,29
2022,1,Riyadh Region,Manufacture of Food Products,medium,102,2459,1339,1120,7134,7111,23
2022,1,Qassim Region,Manufacture of Food Products,small,105,339,190,149,1308,1302,6
2022,1,Qassim Region,Manufacture of Food Products,large,6,757,574,183,2626,2470,156
2022,1,Qassim Region,Manufacture of Food Products,micro,329,102,70,32,662,661,1
2022,1,Qassim Region,Manufacture of Food Products,medium,43,1096,611,485,3817,3813,4
2022,1,Al Madinah Region,Manufacture of Food Products,small,105,283,156,127,1233,1222,11
2022,1,Al Madinah Region,Manufacture of Food Products,micro,468,121,66,55,988,977,11
2022,1,Al Madinah Region,Manufacture of Food Products,medium,12,341,246,95,993,991,2
2022,1,Tabuk Region,Manufacture of Food Products,small,35,68,39,29,346,345,1
2022,1,Tabuk Region,Manufacture of Food Products,large,1,84,20,64,182,181,1
2022,1,Tabuk Region,Manufacture of Food Products,micro,180,40,23,17,346,346,0
2022,1,Tabuk Region,Manufacture of Food Products,medium,6,114,35,79,359,359,0
2022,1,Jazan Region,Manufacture of Food Products,small,56,123,62,61,742,740,2
2022,1,Jazan Region,Manufacture of Food Products,micro,229,34,25,9,483,481,2
2022,1,Jazan Region,Manufacture of Food Products,medium,6,127,44,83,401,401,0
2022,1,Hail Region,Manufacture of Food Products,small,26,79,25,54,276,275,1
2022,1,Hail Region,Manufacture of Food Products,micro,176,32,14,18,357,355,2
2022,1,Hail Region,Manufacture of Food Products,medium,9,160,31,129,804,801,3
2022,1,Aseer Region,Manufacture of Food Products,small,73,224,126,98,807,807,0
2022,1,Aseer Region,Manufacture of Food Products,large,3,252,142,110,1157,1157,0
2022,1,Aseer Region,Manufacture of Food Products,micro,441,86,56,30,793,793,0
2022,1,Aseer Region,Manufacture of Food Products,medium,12,216,112,104,948,910,38
2022,1,Makkah Region,Manufacture of Food Products,small,382,1121,538,583,4635,4587,48
2022,1,Makkah Region,Manufacture of Food Products,large,32,5841,3136,2705,17224,16913,311
2022,1,Makkah Region,Manufacture of Food Products,micro,1312,411,216,195,2568,2549,19
2022,1,Makkah Region,Manufacture of Food Products,medium,67,1773,888,885,4985,4923,62
2022,1,Najran Region,Manufacture of Food Products,small,22,38,16,22,217,217,0
2022,1,Najran Region,Manufacture of Food Products,micro,136,29,15,14,323,321,2
2022,1,Eastern Province,Manufacture of Basic Pharmaceuticals and Pharmaceutical Preparations,small,10,48,27,21,147,133,14
2022,1,Eastern Province,Manufacture of Basic Pharmaceuticals and Pharmaceutical Preparations,micro,6,4,1,3,10,9,1
2022,1,Eastern Province,Manufacture of Basic Pharmaceuticals and Pharmaceutical Preparations,medium,4,170,125,45,183,181,2
2022,1,Al Jawf Region,Manufacture of Basic Pharmaceuticals and Pharmaceutical Preparations,micro,3,0,0,0,7,7,0
2022,1,Northern Borders Region,Manufacture of Basic Pharmaceuticals and Pharmaceutical Preparations,micro,1,1,0,1,0,0,0
2022,1,Riyadh Region,Manufacture of Basic Pharmaceuticals and Pharmaceutical Preparations,small,21,178,83,95,243,235,8
2022,1,Riyadh Region,Manufacture of Basic Pharmaceuticals and Pharmaceutical Preparations,large,5,542,265,277,1496,1471,25
2022,1,Riyadh Region,Manufacture of Basic Pharmaceuticals and Pharmaceutical Preparations,micro,100,22,13,9,214,212,2
2022,1,Riyadh Region,Manufacture of Basic Pharmaceuticals and Pharmaceutical Preparations,medium,6,153,71,82,313,308,5
2022,1,Qassim Region,Manufacture of Basic Pharmaceuticals and Pharmaceutical Preparations,small,1,0,0,0,7,7,0
2022,1,Qassim Region,Manufacture of Basic Pharmaceuticals and Pharmaceutical Preparations,large,1,283,268,15,306,301,5
2022,1,Qassim Region,Manufacture of Basic Pharmaceuticals and Pharmaceutical Preparations,micro,7,1,1,0,10,10,0
2022,1,Qassim Region,Manufacture of Basic Pharmaceuticals and Pharmaceutical Preparations,medium,1,31,27,4,95,87,8
2022,1,Al Madinah Region,Manufacture of Basic Pharmaceuticals and Pharmaceutical Preparations,small,2,9,6,3,37,37,0
2022,1,Al Madinah Region,Manufacture of Basic Pharmaceuticals and Pharmaceutical Preparations,micro,4,3,0,3,6,6,0
2022,1,Tabuk Region,Manufacture of Basic Pharmaceuticals and Pharmaceutical Preparations,micro,1,0,0,0,4,4,0
2022,1,Jazan Region,Manufacture of Basic Pharmaceuticals and Pharmaceutical Preparations,small,1,1,1,0,5,5,0
2022,1,Jazan Region,Manufacture of Basic Pharmaceuticals and Pharmaceutical Preparations,micro,5,0,0,0,11,9,2
2022,1,Hail Region,Manufacture of Basic Pharmaceuticals and Pharmaceutical Preparations,micro,5,0,0,0,9,9,0
2022,1,Aseer Region,Manufacture of Basic Pharmaceuticals and Pharmaceutical Preparations,small,2,18,4,14,36,36,0
2022,1,Aseer Region,Manufacture of Basic Pharmaceuticals and Pharmaceutical Preparations,micro,3,0,0,0,5,5,0
2022,1,Makkah Region,Manufacture of Basic Pharmaceuticals and Pharmaceutical Preparations,small,9,32,20,12,73,68,5
2022,1,Makkah Region,Manufacture of Basic Pharmaceuticals and Pharmaceutical Preparations,large,4,855,440,415,933,903,30
2022,1,Makkah Region,Manufacture of Basic Pharmaceuticals and Pharmaceutical Preparations,micro,14,19,13,6,17,17,0
2022,1,Makkah Region,Manufacture of Basic Pharmaceuticals and Pharmaceutical Preparations,medium,6,243,138,105,392,381,11
2022,1,Najran Region,Manufacture of Basic Pharmaceuticals and Pharmaceutical Preparations,micro,1,0,0,0,2,2,0
2022,1,Eastern Province,Manufacture of Leather and Leather Products,small,5,9,5,4,60,60,0
2022,1,Eastern Province,Manufacture of Leather and Leather Products,micro,14,1,1,0,27,27,0
2022,1,Eastern Province,Manufacture of Leather and Leather Products,medium,2,57,55,2,137,137,0
2022,1,Al Bahah Region,Manufacture of Leather and Leather Products,micro,1,0,0,0,2,2,0
2022,1,Al Jawf Region,Manufacture of Leather and Leather Products,micro,1,0,0,0,2,2,0
2022,1,Northern Borders Region,Manufacture of Leather and Leather Products,small,2,1,1,0,19,19,0
2022,1,Northern Borders Region,Manufacture of Leather and Leather Products,micro,4,1,1,0,13,13,0
2022,1,Riyadh Region,Manufacture of Leather and Leather Products,small,15,27,15,12,148,147,1
2022,1,Riyadh Region,Manufacture of Leather and Leather Products,large,2,184,44,140,628,628,0
2022,1,Riyadh Region,Manufacture of Leather and Leather Products,micro,71,7,2,5,177,177,0
2022,1,Riyadh Region,Manufacture of Leather and Leather Products,medium,3,32,6,26,186,186,0
2022,1,Qassim Region,Manufacture of Leather and Leather Products,micro,7,2,1,1,14,14,0
2022,1,Al Madinah Region,Manufacture of Leather and Leather Products,small,2,3,0,3,17,17,0
2022,1,Al Madinah Region,Manufacture of Leather and Leather Products,micro,9,4,4,0,22,22,0
2022,1,Al Madinah Region,Manufacture of Leather and Leather Products,medium,1,23,9,14,124,124,0
2022,1,Tabuk Region,Manufacture of Leather and Leather Products,micro,1,0,0,0,2,2,0
2022,1,Jazan Region,Manufacture of Leather and Leather Products,small,1,0,0,0,6,6,0
2022,1,Jazan Region,Manufacture of Leather and Leather Products,micro,51,7,3,4,156,156,0
2022,1,Hail Region,Manufacture of Leather and Leather Products,small,2,0,0,0,13,13,0
2022,1,Hail Region,Manufacture of Leather and Leather Products,micro,3,1,0,1,6,6,0
2022,1,Aseer Region,Manufacture of Leather and Leather Products,small,1,0,0,0,6,6,0
2022,1,Aseer Region,Manufacture of Leather and Leather Products,micro,12,1,1,0,34,34,0
2022,1,Makkah Region,Manufacture of Leather and Leather Products,small,4,20,10,10,84,83,1
2022,1,Makkah Region,Manufacture of Leather and Leather Products,micro,31,8,3,5,71,70,1
2022,1,Makkah Region,Manufacture of Leather and Leather Products,medium,2,29,16,13,98,98,0
2022,1,Najran Region,Manufacture of Leather and Leather Products,micro,3,1,0,1,6,6,0
2022,1,Eastern Province,Manufacture of Wearing Apparel,small,221,549,219,330,2327,2136,191
2022,1,Eastern Province,Manufacture of Wearing Apparel,micro,1963,320,115,205,4088,3749,339
2022,1,Eastern Province,Manufacture of Wearing Apparel,medium,11,267,87,180,665,663,2
2022,1,Al Bahah Region,Manufacture of Wearing Apparel,small,15,25,15,10,133,107,26
2022,1,Al Bahah Region,Manufacture of Wearing Apparel,micro,143,32,22,10,267,219,48
2022,1,Al Jawf Region,Manufacture of Wearing Apparel,small,17,16,9,7,115,103,12
2022,1,Al Jawf Region,Manufacture of Wearing Apparel,micro,255,25,11,14,524,491,33
2022,1,Northern Borders Region,Manufacture of Wearing Apparel,small,7,11,3,8,92,67,25
2022,1,Northern Borders Region,Manufacture of Wearing Apparel,micro,260,34,19,15,641,607,34
2022,1,Riyadh Region,Manufacture of Wearing Apparel,small,375,899,322,577,3775,3309,466
2022,1,Riyadh Region,Manufacture of Wearing Apparel,large,6,875,174,701,1928,1866,62
2022,1,Riyadh Region,Manufacture of Wearing Apparel,micro,3313,591,218,373,7046,6492,554
2022,1,Riyadh Region,Manufacture of Wearing Apparel,medium,24,573,194,379,1941,1745,196
2022,1,Qassim Region,Manufacture of Wearing Apparel,small,55,63,27,36,449,385,64
2022,1,Qassim Region,Manufacture of Wearing Apparel,large,1,0,0,0,346,340,6
2022,1,Qassim Region,Manufacture of Wearing Apparel,micro,677,96,44,52,1461,1341,120
2022,1,Qassim Region,Manufacture of Wearing Apparel,medium,4,69,58,11,250,249,1
2022,1,Al Madinah Region,Manufacture of Wearing Apparel,small,70,95,31,64,650,564,86
2022,1,Al Madinah Region,Manufacture of Wearing Apparel,micro,936,138,60,78,1996,1732,264
2022,1,Al Madinah Region,Manufacture of Wearing Apparel,medium,3,62,36,26,177,173,4
2022,1,Tabuk Region,Manufacture of Wearing Apparel,small,32,37,15,22,275,256,19
2022,1,Tabuk Region,Manufacture of Wearing Apparel,micro,713,82,48,34,1767,1728,39
2022,1,Tabuk Region,Manufacture of Wearing Apparel,medium,1,6,1,5,45,45,0
2022,1,Jazan Region,Manufacture of Wearing Apparel,small,28,26,15,11,194,169,25
2022,1,Jazan Region,Manufacture of Wearing Apparel,micro,573,66,39,27,1351,1235,116
2022,1,Hail Region,Manufacture of Wearing Apparel,small,25,39,15,24,201,153,48
2022,1,Hail Region,Manufacture of Wearing Apparel,micro,372,43,16,27,815,740,75
2022,1,Aseer Region,Manufacture of Wearing Apparel,small,61,93,44,49,509,471,38
2022,1,Aseer Region,Manufacture of Wearing Apparel,micro,862,130,66,64,1870,1658,212
2022,1,Aseer Region,Manufacture of Wearing Apparel,medium,2,29,25,4,145,145,0
2022,1,Makkah Region,Manufacture of Wearing Apparel,small,228,524,170,354,2260,2066,194
2022,1,Makkah Region,Manufacture of Wearing Apparel,large,1,139,37,102,392,392,0
2022,1,Makkah Region,Manufacture of Wearing Apparel,micro,2591,404,183,221,5571,4992,579
2022,1,Makkah Region,Manufacture of Wearing Apparel,medium,10,263,62,201,750,658,92
2022,1,Najran Region,Manufacture of Wearing Apparel,small,24,27,9,18,197,178,19
2022,1,Najran Region,Manufacture of Wearing Apparel,micro,376,38,19,19,891,830,61
2022,1,Najran Region,Manufacture of Wearing Apparel,medium,1,17,3,14,61,59,2
2022,1,Eastern Province,Manufacture of Electrical Equipment,small,62,303,200,103,813,810,3
2022,1,Eastern Province,Manufacture of Electrical Equipment,large,6,1763,1717,46,1306,1302,4
2022,1,Eastern Province,Manufacture of Electrical Equipment,micro,153,55,32,23,315,314,1
2022,1,Eastern Province,Manufacture of Electrical Equipment,medium,23,717,545,172,1531,1530,1
2022,1,Al Bahah Region,Manufacture of Electrical Equipment,micro,10,0,0,0,17,17,0
2022,1,Al Jawf Region,Manufacture of Electrical Equipment,small,2,0,0,0,15,15,0
2022,1,Al Jawf Region,Manufacture of Electrical Equipment,micro,14,1,1,0,28,28,0
2022,1,Northern Borders Region,Manufacture of Electrical Equipment,small,1,0,0,0,6,6,0
2022,1,Northern Borders Region,Manufacture of Electrical Equipment,micro,21,0,0,0,53,53,0
2022,1,Riyadh Region,Manufacture of Electrical Equipment,small,88,356,204,152,1420,1417,3
2022,1,Riyadh Region,Manufacture of Electrical Equipment,large,7,642,579,63,1804,1802,2
2022,1,Riyadh Region,Manufacture of Electrical Equipment,micro,160,63,35,28,339,337,2
2022,1,Riyadh Region,Manufacture of Electrical Equipment,medium,50,1429,883,546,4268,4259,9
2022,1,Qassim Region,Manufacture of Electrical Equipment,small,11,28,16,12,173,173,0
2022,1,Qassim Region,Manufacture of Electrical Equipment,micro,21,2,0,2,41,41,0
2022,1,Qassim Region,Manufacture of Electrical Equipment,medium,1,23,23,0,109,109,0
2022,1,Al Madinah Region,Manufacture of Electrical Equipment,small,12,38,23,15,164,164,0
2022,1,Al Madinah Region,Manufacture of Electrical Equipment,large,1,95,88,7,293,293,0
2022,1,Al Madinah Region,Manufacture of Electrical Equipment,micro,37,12,10,2,76,76,0
2022,1,Al Madinah Region,Manufacture of Electrical Equipment,medium,2,69,43,26,190,189,1
2022,1,Tabuk Region,Manufacture of Electrical Equipment,micro,18,1,0,1,40,40,0
2022,1,Jazan Region,Manufacture of Electrical Equipment,small,2,0,0,0,12,12,0
2022,1,Jazan Region,Manufacture of Electrical Equipment,micro,30,2,1,1,83,83,0
2022,1,Hail Region,Manufacture of Electrical Equipment,small,1,0,0,0,6,6,0
2022,1,Hail Region,Manufacture of Electrical Equipment,micro,13,7,1,6,34,34,0
2022,1,Aseer Region,Manufacture of Electrical Equipment,small,5,21,14,7,66,66,0
2022,1,Aseer Region,Manufacture of Electrical Equipment,micro,32,5,2,3,77,77,0
2022,1,Makkah Region,Manufacture of Electrical Equipment,small,50,154,84,70,700,696,4
2022,1,Makkah Region,Manufacture of Electrical Equipment,large,3,350,329,21,1253,1252,1
2022,1,Makkah Region,Manufacture of Electrical Equipment,micro,150,36,22,14,331,328,3
2022,1,Makkah Region,Manufacture of Electrical Equipment,medium,8,195,114,81,518,516,2
2022,1,Najran Region,Manufacture of Electrical Equipment,small,1,4,4,0,23,23,0
2022,1,Najran Region,Manufacture of Electrical Equipment,micro,8,2,0,2,15,15,0
2022,1,Eastern Province,Manufacture of Beverages,small,19,100,60,40,264,263,1
2022,1,Eastern Province,Manufacture of Beverages,large,3,507,307,200,1295,1294,1
2022,1,Eastern Province,Manufacture of Beverages,micro,34,13,6,7,72,72,0
2022,1,Eastern Province,Manufacture of Beverages,medium,6,175,100,75,524,522,2
2022,1,Al Bahah Region,Manufacture of Beverages,small,2,29,14,15,40,40,0
2022,1,Al Bahah Region,Manufacture of Beverages,micro,4,2,2,0,6,6,0
2022,1,Al Bahah Region,Manufacture of Beverages,medium,2,45,14,31,95,90,5
2022,1,Al Jawf Region,Manufacture of Beverages,small,2,6,1,5,12,12,0
2022,1,Al Jawf Region,Manufacture of Beverages,micro,6,1,0,1,8,8,0
2022,1,Al Jawf Region,Manufacture of Beverages,medium,1,17,10,7,49,49,0
2022,1,Northern Borders Region,Manufacture of Beverages,small,1,3,2,1,11,11,0
2022,1,Riyadh Region,Manufacture of Beverages,small,45,185,74,111,753,748,5
2022,1,Riyadh Region,Manufacture of Beverages,large,15,2060,1390,670,5312,5304,8
2022,1,Riyadh Region,Manufacture of Beverages,micro,69,38,14,24,154,153,1
2022,1,Riyadh Region,Manufacture of Beverages,medium,21,679,359,320,1528,1525,3
2022,1,Qassim Region,Manufacture of Beverages,small,5,9,6,3,80,80,0
2022,1,Qassim Region,Manufacture of Beverages,large,2,314,160,154,699,699,0
2022,1,Qassim Region,Manufacture of Beverages,micro,15,5,3,2,32,32,0
2022,1,Qassim Region,Manufacture of Beverages,medium,4,138,55,83,342,342,0
2022,1,Al Madinah Region,Manufacture of Beverages,small,13,45,31,14,182,181,1
2022,1,Al Madinah Region,Manufacture of Beverages,micro,15,8,6,2,28,28,0
2022,1,Al Madinah Region,Manufacture of Beverages,medium,4,111,54,57,329,329,0
2022,1,Tabuk Region,Manufacture of Beverages,small,4,20,8,12,89,89,0
2022,1,Tabuk Region,Manufacture of Beverages,micro,19,2,0,2,44,44,0
2022,1,Tabuk Region,Manufacture of Beverages,medium,2,102,56,46,153,152,1
2022,1,Jazan Region,Manufacture of Beverages,small,3,1,1,0,26,26,0
2022,1,Jazan Region,Manufacture of Beverages,large,2,127,72,55,448,448,0
2022,1,Jazan Region,Manufacture of Beverages,micro,13,2,1,1,28,28,0
2022,1,Jazan Region,Manufacture of Beverages,medium,5,153,95,58,404,404,0
2022,1,Hail Region,Manufacture of Beverages,small,7,27,14,13,119,118,1
2022,1,Hail Region,Manufacture of Beverages,micro,5,4,4,0,10,10,0
2022,1,Hail Region,Manufacture of Beverages,medium,1,73,42,31,157,157,0
2022,1,Aseer Region,Manufacture of Beverages,small,9,36,26,10,145,145,0
2022,1,Aseer Region,Manufacture of Beverages,large,1,126,116,10,308,308,0
2022,1,Aseer Region,Manufacture of Beverages,micro,22,3,1,2,42,42,0
2022,1,Aseer Region,Manufacture of Beverages,medium,1,32,25,7,68,68,0
2022,1,Makkah Region,Manufacture of Beverages,small,41,187,105,82,509,509,0
2022,1,Makkah Region,Manufacture of Beverages,large,5,954,774,180,2007,2001,6
2022,1,Makkah Region,Manufacture of Beverages,micro,95,38,22,16,195,193,2
2022,1,Makkah Region,Manufacture of Beverages,medium,16,573,348,225,1598,1595,3
2022,1,Najran Region,Manufacture of Beverages,small,2,10,5,5,32,31,1
2022,1,Najran Region,Manufacture of Beverages,micro,7,0,0,0,12,12,0
2022,1,Najran Region,Manufacture of Beverages,medium,1,85,66,19,129,129,0
2022,1,Eastern Province,Manufacture of Basic Metals,small,105,523,366,157,1493,1489,4
2022,1,Eastern Province,Manufacture of Basic Metals,large,12,2226,2124,102,3472,3472,0
2022,1,Eastern Province,Manufacture of Basic Metals,micro,129,57,47,10,228,228,0
2022,1,Eastern Province,Manufacture of Basic Metals,medium,55,1845,1437,408,4776,4776,0
2022,1,Al Bahah Region,Manufacture of Basic Metals,micro,12,1,1,0,29,29,0
2022,1,Al Jawf Region,Manufacture of Basic Metals,small,3,1,1,0,19,19,0
2022,1,Al Jawf Region,Manufacture of Basic Metals,micro,14,1,1,0,37,37,0
2022,1,Northern Borders Region,Manufacture of Basic Metals,small,2,2,1,1,14,14,0
2022,1,Northern Borders Region,Manufacture of Basic Metals,micro,11,0,0,0,35,35,0
2022,1,Riyadh Region,Manufacture of Basic Metals,small,172,557,285,272,2421,2411,10
2022,1,Riyadh Region,Manufacture of Basic Metals,large,8,748,531,217,3036,3032,4
2022,1,Riyadh Region,Manufacture of Basic Metals,micro,379,102,52,50,817,813,4
2022,1,Riyadh Region,Manufacture of Basic Metals,medium,52,1288,798,490,3995,3973,22
2022,1,Qassim Region,Manufacture of Basic Metals,small,17,42,24,18,200,199,1
2022,1,Qassim Region,Manufacture of Basic Metals,micro,86,10,5,5,207,207,0
2022,1,Qassim Region,Manufacture of Basic Metals,medium,3,33,23,10,168,168,0
2022,1,Al Madinah Region,Manufacture of Basic Metals,small,9,18,17,1,90,90,0
2022,1,Al Madinah Region,Manufacture of Basic Metals,micro,70,13,7,6,146,145,1
2022,1,Al Madinah Region,Manufacture of Basic Metals,medium,2,179,167,12,183,183,0
2022,1,Tabuk Region,Manufacture of Basic Metals,small,2,3,2,1,26,26,0
2022,1,Tabuk Region,Manufacture of Basic Metals,micro,20,3,3,0,35,35,0
2022,1,Tabuk Region,Manufacture of Basic Metals,medium,1,30,15,15,90,90,0
2022,1,Jazan Region,Manufacture of Basic Metals,small,2,7,2,5,27,27,0
2022,1,Jazan Region,Manufacture of Basic Metals,large,2,242,242,0,280,280,0
2022,1,Jazan Region,Manufacture of Basic Metals,micro,38,2,2,0,93,93,0
2022,1,Jazan Region,Manufacture of Basic Metals,medium,1,21,9,12,66,66,0
2022,1,Hail Region,Manufacture of Basic Metals,small,9,14,7,7,114,114,0
2022,1,Hail Region,Manufacture of Basic Metals,micro,50,9,8,1,102,102,0
2022,1,Hail Region,Manufacture of Basic Metals,medium,1,10,5,5,43,43,0
2022,1,Aseer Region,Manufacture of Basic Metals,small,15,58,50,8,207,207,0
2022,1,Aseer Region,Manufacture of Basic Metals,micro,77,12,7,5,164,164,0
2022,1,Aseer Region,Manufacture of Basic Metals,medium,1,32,31,1,110,110,0
2022,1,Makkah Region,Manufacture of Basic Metals,small,86,344,220,124,1175,1173,2
2022,1,Makkah Region,Manufacture of Basic Metals,large,6,677,363,314,1703,1702,1
2022,1,Makkah Region,Manufacture of Basic Metals,micro,190,67,38,29,420,416,4
2022,1,Makkah Region,Manufacture of Basic Metals,medium,26,847,677,170,1835,1820,15
2022,1,Najran Region,Manufacture of Basic Metals,small,5,2,1,1,31,31,0
2022,1,Najran Region,Manufacture of Basic Metals,large,1,181,179,2,326,326,0
2022,1,Najran Region,Manufacture of Basic Metals,micro,50,5,3,2,135,135,0
2022,1,Najran Region,Manufacture of Basic Metals,medium,1,27,17,10,50,50,0
2022,1,Eastern Province,"Manufacture of Wood and Wood Products (Except Furniture), Manufacture of Straw and Plaiting Materials",small,138,356,193,163,1655,1650,5
2022,1,Eastern Province,"Manufacture of Wood and Wood Products (Except Furniture), Manufacture of Straw and Plaiting Materials",large,1,60,60,0,202,202,0
2022,1,Eastern Province,"Manufacture of Wood and Wood Products (Except Furniture), Manufacture of Straw and Plaiting Materials",micro,383,158,77,81,801,801,0
2022,1,Eastern Province,"Manufacture of Wood and Wood Products (Except Furniture), Manufacture of Straw and Plaiting Materials",medium,12,339,235,104,1085,1084,1
2022,1,Al Bahah Region,"Manufacture of Wood and Wood Products (Except Furniture), Manufacture of Straw and Plaiting Materials",small,10,11,9,2,73,73,0
2022,1,Al Bahah Region,"Manufacture of Wood and Wood Products (Except Furniture), Manufacture of Straw and Plaiting Materials",micro,67,17,8,9,148,148,0
2022,1,Al Jawf Region,"Manufacture of Wood and Wood Products (Except Furniture), Manufacture of Straw and Plaiting Materials",small,7,7,5,2,54,54,0
2022,1,Al Jawf Region,"Manufacture of Wood and Wood Products (Except Furniture), Manufacture of Straw and Plaiting Materials",micro,54,15,12,3,102,102,0
2022,1,Northern Borders Region,"Manufacture of Wood and Wood Products (Except Furniture), Manufacture of Straw and Plaiting Materials",small,3,3,2,1,17,17,0
2022,1,Northern Borders Region,"Manufacture of Wood and Wood Products (Except Furniture), Manufacture of Straw and Plaiting Materials",micro,42,10,6,4,83,83,0
2022,1,Riyadh Region,"Manufacture of Wood and Wood Products (Except Furniture), Manufacture of Straw and Plaiting Materials",small,226,585,229,356,2880,2869,11
2022,1,Riyadh Region,"Manufacture of Wood and Wood Products (Except Furniture), Manufacture of Straw and Plaiting Materials",large,1,106,14,92,337,336,1
2022,1,Riyadh Region,"Manufacture of Wood and Wood Products (Except Furniture), Manufacture of Straw and Plaiting Materials",micro,776,248,104,144,1741,1735,6
2022,1,Riyadh Region,"Manufacture of Wood and Wood Products (Except Furniture), Manufacture of Straw and Plaiting Materials",medium,18,405,190,215,1489,1420,69
2022,1,Qassim Region,"Manufacture of Wood and Wood Products (Except Furniture), Manufacture of Straw and Plaiting Materials",small,31,44,23,21,306,306,0
2022,1,Qassim Region,"Manufacture of Wood and Wood Products (Except Furniture), Manufacture of Straw and Plaiting Materials",large,1,63,44,19,196,196,0
2022,1,Qassim Region,"Manufacture of Wood and Wood Products (Except Furniture), Manufacture of Straw and Plaiting Materials",micro,206,44,24,20,516,512,4
2022,1,Qassim Region,"Manufacture of Wood and Wood Products (Except Furniture), Manufacture of Straw and Plaiting Materials",medium,2,10,9,1,101,95,6
2022,1,Al Madinah Region,"Manufacture of Wood and Wood Products (Except Furniture), Manufacture of Straw and Plaiting Materials",small,20,29,21,8,173,173,0
2022,1,Al Madinah Region,"Manufacture of Wood and Wood Products (Except Furniture), Manufacture of Straw and Plaiting Materials",micro,139,44,22,22,294,294,0
2022,1,Al Madinah Region,"Manufacture of Wood and Wood Products (Except Furniture), Manufacture of Straw and Plaiting Materials",medium,2,22,19,3,87,86,1
2022,1,Tabuk Region,"Manufacture of Wood and Wood Products (Except Furniture), Manufacture of Straw and Plaiting Materials",small,13,12,8,4,80,80,0
2022,1,Tabuk Region,"Manufacture of Wood and Wood Products (Except Furniture), Manufacture of Straw and Plaiting Materials",micro,76,15,7,8,171,171,0
2022,1,Jazan Region,"Manufacture of Wood and Wood Products (Except Furniture), Manufacture of Straw and Plaiting Materials",small,15,29,16,13,129,128,1
2022,1,Jazan Region,"Manufacture of Wood and Wood Products (Except Furniture), Manufacture of Straw and Plaiting Materials",micro,165,34,21,13,401,401,0
2022,1,Jazan Region,"Manufacture of Wood and Wood Products (Except Furniture), Manufacture of Straw and Plaiting Materials",medium,1,22,2,20,54,54,0
2022,1,Hail Region,"Manufacture of Wood and Wood Products (Except Furniture), Manufacture of Straw and Plaiting Materials",small,9,19,7,12,106,106,0
2022,1,Hail Region,"Manufacture of Wood and Wood Products (Except Furniture), Manufacture of Straw and Plaiting Materials",micro,50,7,5,2,115,115,0
2022,1,Aseer Region,"Manufacture of Wood and Wood Products (Except Furniture), Manufacture of Straw and Plaiting Materials",small,37,51,34,17,324,324,0
2022,1,Aseer Region,"Manufacture of Wood and Wood Products (Except Furniture), Manufacture of Straw and Plaiting Materials",micro,251,54,31,23,569,568,1
2022,1,Aseer Region,"Manufacture of Wood and Wood Products (Except Furniture), Manufacture of Straw and Plaiting Materials",medium,2,23,14,9,91,91,0
2022,1,Makkah Region,"Manufacture of Wood and Wood Products (Except Furniture), Manufacture of Straw and Plaiting Materials",small,109,244,104,140,1149,1135,14
2022,1,Makkah Region,"Manufacture of Wood and Wood Products (Except Furniture), Manufacture of Straw and Plaiting Materials",large,2,183,154,29,644,644,0
2022,1,Makkah Region,"Manufacture of Wood and Wood Products (Except Furniture), Manufacture of Straw and Plaiting Materials",micro,577,138,78,60,1249,1241,8
2022,1,Makkah Region,"Manufacture of Wood and Wood Products (Except Furniture), Manufacture of Straw and Plaiting Materials",medium,12,271,173,98,912,903,9
2022,1,Najran Region,"Manufacture of Wood and Wood Products (Except Furniture), Manufacture of Straw and Plaiting Materials",small,5,5,4,1,40,40,0
2022,1,Najran Region,"Manufacture of Wood and Wood Products (Except Furniture), Manufacture of Straw and Plaiting Materials",micro,71,12,8,4,152,152,0
2022,1,Eastern Province,"Manufacture of Computers, Electronic and Optical Products",small,22,113,82,31,242,240,2
2022,1,Eastern Province,"Manufacture of Computers, Electronic and Optical Products",large,1,0,0,0,394,394,0
2022,1,Eastern Province,"Manufacture of Computers, Electronic and Optical Products",micro,78,36,23,13,143,140,3
2022,1,Eastern Province,"Manufacture of Computers, Electronic and Optical Products",medium,4,128,98,30,275,274,1
2022,1,Al Bahah Region,"Manufacture of Computers, Electronic and Optical Products",small,1,3,3,0,5,5,0
2022,1,Al Bahah Region,"Manufacture of Computers, Electronic and Optical Products",micro,7,6,6,0,14,14,0
2022,1,Al Jawf Region,"Manufacture of Computers, Electronic and Optical Products",micro,4,0,0,0,11,11,0
2022,1,Northern Borders Region,"Manufacture of Computers, Electronic and Optical Products",micro,5,0,0,0,11,11,0
2022,1,Riyadh Region,"Manufacture of Computers, Electronic and Optical Products",small,25,92,56,36,352,352,0
2022,1,Riyadh Region,"Manufacture of Computers, Electronic and Optical Products",micro,83,32,17,15,155,155,0
2022,1,Riyadh Region,"Manufacture of Computers, Electronic and Optical Products",medium,1,12,4,8,40,40,0
2022,1,Qassim Region,"Manufacture of Computers, Electronic and Optical Products",micro,13,3,3,0,23,23,0
2022,1,Al Madinah Region,"Manufacture of Computers, Electronic and Optical Products",small,5,11,8,3,36,36,0
2022,1,Al Madinah Region,"Manufacture of Computers, Electronic and Optical Products",micro,21,4,2,2,48,48,0
2022,1,Tabuk Region,"Manufacture of Computers, Electronic and Optical Products",small,3,9,4,5,13,13,0
2022,1,Tabuk Region,"Manufacture of Computers, Electronic and Optical Products",micro,17,1,0,1,31,31,0
2022,1,Jazan Region,"Manufacture of Computers, Electronic and Optical Products",small,5,8,7,1,52,52,0
2022,1,Jazan Region,"Manufacture of Computers, Electronic and Optical Products",micro,26,2,2,0,65,65,0
2022,1,Hail Region,"Manufacture of Computers, Electronic and Optical Products",small,1,1,0,1,7,7,0
2022,1,Hail Region,"Manufacture of Computers, Electronic and Optical Products",micro,14,0,0,0,36,34,2
2022,1,Aseer Region,"Manufacture of Computers, Electronic and Optical Products",small,4,5,4,1,25,25,0
2022,1,Aseer Region,"Manufacture of Computers, Electronic and Optical Products",micro,57,3,3,0,109,109,0
2022,1,Makkah Region,"Manufacture of Computers, Electronic and Optical Products",small,31,66,38,28,250,235,15
2022,1,Makkah Region,"Manufacture of Computers, Electronic and Optical Products",micro,159,46,27,19,315,314,1
2022,1,Makkah Region,"Manufacture of Computers, Electronic and Optical Products",medium,2,53,39,14,75,72,3
2022,1,Najran Region,"Manufacture of Computers, Electronic and Optical Products",micro,11,1,0,1,25,25,0
2022,1,Eastern Province,Manufacture of Furniture,small,135,381,208,173,1649,1643,6
2022,1,Eastern Province,Manufacture of Furniture,large,3,246,155,91,813,811,2
2022,1,Eastern Province,Manufacture of Furniture,micro,492,133,76,57,1064,1063,1
2022,1,Eastern Province,Manufacture of Furniture,medium,22,437,253,184,1623,1621,2
2022,1,Al Bahah Region,Manufacture of Furniture,small,9,16,12,4,69,69,0
2022,1,Al Bahah Region,Manufacture of Furniture,micro,56,10,8,2,115,115,0
2022,1,Al Jawf Region,Manufacture of Furniture,small,8,11,7,4,73,71,2
2022,1,Al Jawf Region,Manufacture of Furniture,micro,103,14,10,4,221,221,0
2022,1,Northern Borders Region,Manufacture of Furniture,small,4,4,3,1,22,22,0
2022,1,Northern Borders Region,Manufacture of Furniture,micro,70,20,13,7,171,171,0
2022,1,Riyadh Region,Manufacture of Furniture,small,401,943,423,520,5093,5062,31
2022,1,Riyadh Region,Manufacture of Furniture,large,9,756,386,370,2560,2554,6
2022,1,Riyadh Region,Manufacture of Furniture,micro,1184,278,119,159,2756,2749,7
2022,1,Riyadh Region,Manufacture of Furniture,medium,57,1187,551,636,4151,4134,17
2022,1,Qassim Region,Manufacture of Furniture,small,39,54,28,26,535,533,2
2022,1,Qassim Region,Manufacture of Furniture,large,1,74,25,49,327,327,0
2022,1,Qassim Region,Manufacture of Furniture,micro,201,50,36,14,433,431,2
2022,1,Qassim Region,Manufacture of Furniture,medium,7,108,77,31,440,440,0
2022,1,Al Madinah Region,Manufacture of Furniture,small,34,38,26,12,309,308,1
2022,1,Al Madinah Region,Manufacture of Furniture,micro,216,42,21,21,466,463,3
2022,1,Al Madinah Region,Manufacture of Furniture,medium,1,16,13,3,52,52,0
2022,1,Tabuk Region,Manufacture of Furniture,small,16,22,9,13,147,147,0
2022,1,Tabuk Region,Manufacture of Furniture,micro,167,30,14,16,394,394,0
2022,1,Jazan Region,Manufacture of Furniture,small,12,14,7,7,116,116,0
2022,1,Jazan Region,Manufacture of Furniture,micro,242,33,16,17,557,555,2
2022,1,Hail Region,Manufacture of Furniture,small,19,20,13,7,182,181,1
2022,1,Hail Region,Manufacture of Furniture,micro,133,22,13,9,312,312,0
2022,1,Hail Region,Manufacture of Furniture,medium,1,20,14,6,67,67,0
2022,1,Aseer Region,Manufacture of Furniture,small,48,91,68,23,545,545,0
2022,1,Aseer Region,Manufacture of Furniture,micro,418,73,47,26,905,905,0
2022,1,Aseer Region,Manufacture of Furniture,medium,1,21,11,10,43,43,0
2022,1,Makkah Region,Manufacture of Furniture,small,121,259,141,118,1388,1373,15
2022,1,Makkah Region,Manufacture of Furniture,large,1,79,55,24,320,319,1
2022,1,Makkah Region,Manufacture of Furniture,micro,598,128,73,55,1351,1344,7
2022,1,Makkah Region,Manufacture of Furniture,medium,21,539,246,293,1947,1942,5
2022,1,Najran Region,Manufacture of Furniture,small,22,19,9,10,228,228,0
2022,1,Najran Region,Manufacture of Furniture,micro,105,19,2,17,241,241,0
2022,1,Najran Region,Manufacture of Furniture,medium,1,20,10,10,91,91,0
2022,1,Eastern Province,Manufacture of Other Transport Equipment,small,5,26,19,7,91,91,0
2022,1,Eastern Province,Manufacture of Other Transport Equipment,large,3,2198,2157,41,885,884,1
2022,1,Eastern Province,Manufacture of Other Transport Equipment,micro,14,8,6,2,23,23,0
2022,1,Eastern Province,Manufacture of Other Transport Equipment,medium,1,70,70,0,93,93,0
2022,1,Al Bahah Region,Manufacture of Other Transport Equipment,micro,1,0,0,0,1,1,0
2022,1,Al Jawf Region,Manufacture of Other Transport Equipment,small,2,0,0,0,23,23,0
2022,1,Northern Borders Region,Manufacture of Other Transport Equipment,micro,2,1,1,0,5,5,0
2022,1,Riyadh Region,Manufacture of Other Transport Equipment,small,13,73,55,18,141,141,0
2022,1,Riyadh Region,Manufacture of Other Transport Equipment,large,1,1074,1047,27,524,524,0
2022,1,Riyadh Region,Manufacture of Other Transport Equipment,micro,80,25,13,12,178,178,0
2022,1,Riyadh Region,Manufacture of Other Transport Equipment,medium,7,441,364,77,455,455,0
2022,1,Qassim Region,Manufacture of Other Transport Equipment,micro,4,0,0,0,7,6,1
2022,1,Al Madinah Region,Manufacture of Other Transport Equipment,small,1,0,0,0,12,12,0
2022,1,Al Madinah Region,Manufacture of Other Transport Equipment,micro,6,2,1,1,8,8,0
2022,1,Tabuk Region,Manufacture of Other Transport Equipment,micro,3,0,0,0,9,9,0
2022,1,Jazan Region,Manufacture of Other Transport Equipment,small,2,6,5,1,28,28,0
2022,1,Jazan Region,Manufacture of Other Transport Equipment,micro,6,1,0,1,16,16,0
2022,1,Hail Region,Manufacture of Other Transport Equipment,micro,1,0,0,0,3,3,0
2022,1,Aseer Region,Manufacture of Other Transport Equipment,micro,5,0,0,0,12,12,0
2022,1,Makkah Region,Manufacture of Other Transport Equipment,small,7,29,21,8,78,77,1
2022,1,Makkah Region,Manufacture of Other Transport Equipment,micro,32,7,6,1,55,54,1
2022,1,Makkah Region,Manufacture of Other Transport Equipment,medium,1,14,14,0,49,49,0
2022,1,Najran Region,Manufacture of Other Transport Equipment,small,2,3,0,3,17,17,0
2022,1,Najran Region,Manufacture of Other Transport Equipment,micro,4,0,0,0,6,4,2
2022,1,Eastern Province,"Manufacture of Motor Vehicles, Trailers, and Semi-Trailers",small,21,103,74,29,345,345,0
2022,1,Eastern Province,"Manufacture of Motor Vehicles, Trailers, and Semi-Trailers",large,2,341,338,3,470,470,0
2022,1,Eastern Province,"Manufacture of Motor Vehicles, Trailers, and Semi-Trailers",micro,39,8,2,6,79,79,0
2022,1,Eastern Province,"Manufacture of Motor Vehicles, Trailers, and Semi-Trailers",medium,12,397,332,65,908,907,1
2022,1,Al Jawf Region,"Manufacture of Motor Vehicles, Trailers, and Semi-Trailers",small,1,2,2,0,8,8,0
2022,1,Al Jawf Region,"Manufacture of Motor Vehicles, Trailers, and Semi-Trailers",micro,8,0,0,0,16,16,0
2022,1,Northern Borders Region,"Manufacture of Motor Vehicles, Trailers, and Semi-Trailers",micro,1,0,0,0,2,2,0
2022,1,Riyadh Region,"Manufacture of Motor Vehicles, Trailers, and Semi-Trailers",small,35,182,92,90,653,650,3
2022,1,Riyadh Region,"Manufacture of Motor Vehicles, Trailers, and Semi-Trailers",large,2,266,80,186,1700,1692,8
2022,1,Riyadh Region,"Manufacture of Motor Vehicles, Trailers, and Semi-Trailers",micro,55,12,7,5,120,120,0
2022,1,Riyadh Region,"Manufacture of Motor Vehicles, Trailers, and Semi-Trailers",medium,6,103,45,58,374,371,3
2022,1,Qassim Region,"Manufacture of Motor Vehicles, Trailers, and Semi-Trailers",small,2,11,7,4,36,36,0
2022,1,Qassim Region,"Manufacture of Motor Vehicles, Trailers, and Semi-Trailers",large,1,105,86,19,262,262,0
2022,1,Qassim Region,"Manufacture of Motor Vehicles, Trailers, and Semi-Trailers",micro,11,1,0,1,26,26,0
2022,1,Al Madinah Region,"Manufacture of Motor Vehicles, Trailers, and Semi-Trailers",small,1,3,3,0,16,16,0
2022,1,Al Madinah Region,"Manufacture of Motor Vehicles, Trailers, and Semi-Trailers",micro,13,2,1,1,27,27,0
2022,1,Tabuk Region,"Manufacture of Motor Vehicles, Trailers, and Semi-Trailers",large,1,46,22,24,375,375,0
2022,1,Tabuk Region,"Manufacture of Motor Vehicles, Trailers, and Semi-Trailers",micro,9,1,1,0,22,22,0
2022,1,Jazan Region,"Manufacture of Motor Vehicles, Trailers, and Semi-Trailers",small,3,14,2,12,33,33,0
2022,1,Jazan Region,"Manufacture of Motor Vehicles, Trailers, and Semi-Trailers",micro,19,1,1,0,53,53,0
2022,1,Hail Region,"Manufacture of Motor Vehicles, Trailers, and Semi-Trailers",micro,9,1,1,0,23,23,0
2022,1,Aseer Region,"Manufacture of Motor Vehicles, Trailers, and Semi-Trailers",small,1,3,1,2,7,7,0
2022,1,Aseer Region,"Manufacture of Motor Vehicles, Trailers, and Semi-Trailers",micro,11,3,3,0,28,28,0
2022,1,Makkah Region,"Manufacture of Motor Vehicles, Trailers, and Semi-Trailers",small,14,66,50,16,160,160,0
2022,1,Makkah Region,"Manufacture of Motor Vehicles, Trailers, and Semi-Trailers",micro,38,7,4,3,94,94,0
2022,1,Makkah Region,"Manufacture of Motor Vehicles, Trailers, and Semi-Trailers",medium,8,304,210,94,781,781,0
2022,1,Najran Region,"Manufacture of Motor Vehicles, Trailers, and Semi-Trailers",small,2,0,0,0,16,16,0
2022,1,Najran Region,"Manufacture of Motor Vehicles, Trailers, and Semi-Trailers",micro,7,0,0,0,19,19,0
2022,1,Eastern Province,Manufacture of Other Machinery and Equipment Not Classified Elsewhere,small,72,500,423,77,973,970,3
2022,1,Eastern Province,Manufacture of Other Machinery and Equipment Not Classified Elsewhere,large,6,1352,1267,85,1872,1870,2
2022,1,Eastern Province,Manufacture of Other Machinery and Equipment Not Classified Elsewhere,micro,70,45,35,10,109,107,2
2022,1,Eastern Province,Manufacture of Other Machinery and Equipment Not Classified Elsewhere,medium,29,1511,1288,223,2106,2100,6
2022,1,Al Bahah Region,Manufacture of Other Machinery and Equipment Not Classified Elsewhere,micro,2,1,0,1,7,7,0
2022,1,Al Jawf Region,Manufacture of Other Machinery and Equipment Not Classified Elsewhere,micro,3,0,0,0,3,3,0
2022,1,Northern Borders Region,Manufacture of Other Machinery and Equipment Not Classified Elsewhere,micro,4,0,0,0,12,12,0
2022,1,Riyadh Region,Manufacture of Other Machinery and Equipment Not Classified Elsewhere,small,76,247,149,98,1133,1130,3
2022,1,Riyadh Region,Manufacture of Other Machinery and Equipment Not Classified Elsewhere,large,3,158,85,73,751,750,1
2022,1,Riyadh Region,Manufacture of Other Machinery and Equipment Not Classified Elsewhere,micro,268,63,30,33,547,545,2
2022,1,Riyadh Region,Manufacture of Other Machinery and Equipment Not Classified Elsewhere,medium,17,674,423,251,1842,1836,6
2022,1,Qassim Region,Manufacture of Other Machinery and Equipment Not Classified Elsewhere,small,3,4,3,1,15,15,0
2022,1,Qassim Region,Manufacture of Other Machinery and Equipment Not Classified Elsewhere,micro,31,1,0,1,53,53,0
2022,1,Qassim Region,Manufacture of Other Machinery and Equipment Not Classified Elsewhere,medium,4,75,39,36,289,289,0
2022,1,Al Madinah Region,Manufacture of Other Machinery and Equipment Not Classified Elsewhere,small,6,23,15,8,65,65,0
2022,1,Al Madinah Region,Manufacture of Other Machinery and Equipment Not Classified Elsewhere,micro,18,6,3,3,37,37,0
2022,1,Al Madinah Region,Manufacture of Other Machinery and Equipment Not Classified Elsewhere,medium,2,25,24,1,104,104,0
2022,1,Tabuk Region,Manufacture of Other Machinery and Equipment Not Classified Elsewhere,micro,5,0,0,0,16,16,0
2022,1,Jazan Region,Manufacture of Other Machinery and Equipment Not Classified Elsewhere,small,5,5,4,1,47,47,0
2022,1,Jazan Region,Manufacture of Other Machinery and Equipment Not Classified Elsewhere,micro,20,1,0,1,48,48,0
2022,1,Hail Region,Manufacture of Other Machinery and Equipment Not Classified Elsewhere,small,1,16,16,0,1,1,0
2022,1,Hail Region,Manufacture of Other Machinery and Equipment Not Classified Elsewhere,micro,11,1,1,0,28,28,0
2022,1,Aseer Region,Manufacture of Other Machinery and Equipment Not Classified Elsewhere,small,2,23,23,0,41,41,0
2022,1,Aseer Region,Manufacture of Other Machinery and Equipment Not Classified Elsewhere,micro,15,5,3,2,38,38,0
2022,1,Aseer Region,Manufacture of Other Machinery and Equipment Not Classified Elsewhere,medium,1,44,44,0,159,159,0
2022,1,Makkah Region,Manufacture of Other Machinery and Equipment Not Classified Elsewhere,small,31,117,61,56,428,427,1
2022,1,Makkah Region,Manufacture of Other Machinery and Equipment Not Classified Elsewhere,large,3,793,782,11,1614,1612,2
2022,1,Makkah Region,Manufacture of Other Machinery and Equipment Not Classified Elsewhere,micro,89,32,16,16,173,172,1
2022,1,Makkah Region,Manufacture of Other Machinery and Equipment Not Classified Elsewhere,medium,12,328,238,90,939,939,0
2022,1,Najran Region,Manufacture of Other Machinery and Equipment Not Classified Elsewhere,small,1,0,0,0,6,6,0
2022,1,Najran Region,Manufacture of Other Machinery and Equipment Not Classified Elsewhere,micro,8,0,0,0,19,19,0
2022,1,Najran Region,Manufacture of Other Machinery and Equipment Not Classified Elsewhere,medium,1,1,0,1,54,54,0
2022,1,Eastern Province,"Electricity, Gas, Steam, and Air Conditioning Supply",small,47,284,215,69,556,555,1
2022,1,Eastern Province,"Electricity, Gas, Steam, and Air Conditioning Supply",large,1,6374,6371,3,459,459,0
2022,1,Eastern Province,"Electricity, Gas, Steam, and Air Conditioning Supply",micro,51,26,15,11,75,75,0
2022,1,Eastern Province,"Electricity, Gas, Steam, and Air Conditioning Supply",medium,4,191,170,21,163,162,1
2022,1,Al Bahah Region,"Electricity, Gas, Steam, and Air Conditioning Supply",micro,2,2,2,0,4,4,0
2022,1,Al Jawf Region,"Electricity, Gas, Steam, and Air Conditioning Supply",micro,7,2,1,1,13,13,0
2022,1,Northern Borders Region,"Electricity, Gas, Steam, and Air Conditioning Supply",small,1,1,0,1,6,6,0
2022,1,Northern Borders Region,"Electricity, Gas, Steam, and Air Conditioning Supply",micro,2,0,0,0,3,3,0
2022,1,Riyadh Region,"Electricity, Gas, Steam, and Air Conditioning Supply",small,56,273,176,97,600,599,1
2022,1,Riyadh Region,"Electricity, Gas, Steam, and Air Conditioning Supply",large,2,11167,10965,202,1587,1585,2
2022,1,Riyadh Region,"Electricity, Gas, Steam, and Air Conditioning Supply",micro,86,64,42,22,156,156,0
2022,1,Riyadh Region,"Electricity, Gas, Steam, and Air Conditioning Supply",medium,8,530,457,73,263,262,1
2022,1,Qassim Region,"Electricity, Gas, Steam, and Air Conditioning Supply",small,5,38,33,5,82,82,0
2022,1,Qassim Region,"Electricity, Gas, Steam, and Air Conditioning Supply",micro,12,2,1,1,25,25,0
2022,1,Al Madinah Region,"Electricity, Gas, Steam, and Air Conditioning Supply",small,2,32,32,0,20,20,0
2022,1,Al Madinah Region,"Electricity, Gas, Steam, and Air Conditioning Supply",micro,17,6,5,1,44,44,0
2022,1,Tabuk Region,"Electricity, Gas, Steam, and Air Conditioning Supply",small,3,9,5,4,28,28,0
2022,1,Tabuk Region,"Electricity, Gas, Steam, and Air Conditioning Supply",micro,13,2,2,0,32,32,0
2022,1,Jazan Region,"Electricity, Gas, Steam, and Air Conditioning Supply",small,6,18,12,6,74,73,1
2022,1,Jazan Region,"Electricity, Gas, Steam, and Air Conditioning Supply",micro,13,8,5,3,26,26,0
2022,1,Hail Region,"Electricity, Gas, Steam, and Air Conditioning Supply",small,2,3,1,2,17,17,0
2022,1,Hail Region,"Electricity, Gas, Steam, and Air Conditioning Supply",micro,10,4,2,2,22,22,0
2022,1,Aseer Region,"Electricity, Gas, Steam, and Air Conditioning Supply",small,8,50,39,11,50,50,0
2022,1,Aseer Region,"Electricity, Gas, Steam, and Air Conditioning Supply",large,1,4659,4659,0,266,266,0
2022,1,Aseer Region,"Electricity, Gas, Steam, and Air Conditioning Supply",micro,15,3,3,0,27,27,0
2022,1,Aseer Region,"Electricity, Gas, Steam, and Air Conditioning Supply",medium,2,15,15,0,210,210,0
2022,1,Makkah Region,"Electricity, Gas, Steam, and Air Conditioning Supply",small,30,184,132,52,443,441,2
2022,1,Makkah Region,"Electricity, Gas, Steam, and Air Conditioning Supply",large,1,9454,9452,2,542,542,0
2022,1,Makkah Region,"Electricity, Gas, Steam, and Air Conditioning Supply",micro,55,36,19,17,91,91,0
2022,1,Makkah Region,"Electricity, Gas, Steam, and Air Conditioning Supply",medium,6,92,48,44,434,434,0
2022,1,Najran Region,"Electricity, Gas, Steam, and Air Conditioning Supply",small,2,15,10,5,27,19,8
2022,1,Najran Region,"Electricity, Gas, Steam, and Air Conditioning Supply",micro,5,1,1,0,13,13,0
2022,1,Eastern Province,"Activities of Financial Services, Except Mandatory Social Security",small,3,22,18,4,13,13,0
2022,1,Eastern Province,"Activities of Financial Services, Except Mandatory Social Security",large,2,599,436,163,169,159,10
2022,1,Eastern Province,"Activities of Financial Services, Except Mandatory Social Security",micro,1,4,2,2,1,1,0
2022,1,Eastern Province,"Activities of Financial Services, Except Mandatory Social Security",medium,2,129,85,44,47,44,3
2022,1,Riyadh Region,"Activities of Financial Services, Except Mandatory Social Security",small,4,67,53,14,17,16,1
2022,1,Riyadh Region,"Activities of Financial Services, Except Mandatory Social Security",large,5,2407,1461,946,662,630,32
2022,1,Riyadh Region,"Activities of Financial Services, Except Mandatory Social Security",micro,24,22,9,13,15,15,0
2022,1,Riyadh Region,"Activities of Financial Services, Except Mandatory Social Security",medium,6,632,497,135,242,241,1
2022,1,Al Madinah Region,"Activities of Financial Services, Except Mandatory Social Security",micro,2,0,0,0,3,3,0
2022,1,Jazan Region,"Activities of Financial Services, Except Mandatory Social Security",micro,1,1,0,1,0,0,0
2022,1,Aseer Region,"Activities of Financial Services, Except Mandatory Social Security",micro,1,0,0,0,3,3,0
2022,1,Aseer Region,"Activities of Financial Services, Except Mandatory Social Security",medium,1,99,97,2,21,21,0
2022,1,Makkah Region,"Activities of Financial Services, Except Mandatory Social Security",small,5,59,36,23,29,27,2
2022,1,Makkah Region,"Activities of Financial Services, Except Mandatory Social Security",large,2,1289,763,526,477,400,77
2022,1,Makkah Region,"Activities of Financial Services, Except Mandatory Social Security",micro,8,1,1,0,12,11,1
2022,1,Makkah Region,"Activities of Financial Services, Except Mandatory Social Security",medium,3,409,242,167,82,79,3
2022,1,Najran Region,"Activities of Financial Services, Except Mandatory Social Security",micro,2,0,0,0,8,8,0
2022,1,Eastern Province,Mining of Metal Ores,small,17,29,16,13,160,160,0
2022,1,Eastern Province,Mining of Metal Ores,micro,91,23,12,11,194,194,0
2022,1,Eastern Province,Mining of Metal Ores,medium,3,133,90,43,237,236,1
2022,1,Al Bahah Region,Mining of Metal Ores,micro,4,1,1,0,9,9,0
2022,1,Al Jawf Region,Mining of Metal Ores,micro,3,0,0,0,7,7,0
2022,1,Northern Borders Region,Mining of Metal Ores,micro,5,1,1,0,14,14,0
2022,1,Riyadh Region,Mining of Metal Ores,small,9,17,7,10,106,106,0
2022,1,Riyadh Region,Mining of Metal Ores,micro,30,15,8,7,57,57,0
2022,1,Riyadh Region,Mining of Metal Ores,medium,1,0,0,0,81,81,0
2022,1,Qassim Region,Mining of Metal Ores,small,1,2,2,0,4,4,0
2022,1,Qassim Region,Mining of Metal Ores,micro,19,3,2,1,50,50,0
2022,1,Al Madinah Region,Mining of Metal Ores,small,2,3,2,1,17,17,0
2022,1,Al Madinah Region,Mining of Metal Ores,micro,10,0,0,0,17,17,0
2022,1,Tabuk Region,Mining of Metal Ores,small,1,1,1,0,7,7,0
2022,1,Tabuk Region,Mining of Metal Ores,micro,1,0,0,0,1,1,0
2022,1,Jazan Region,Mining of Metal Ores,micro,12,2,2,0,40,40,0
2022,1,Hail Region,Mining of Metal Ores,micro,2,0,0,0,3,3,0
2022,1,Aseer Region,Mining of Metal Ores,small,9,20,13,7,85,85,0
2022,1,Aseer Region,Mining of Metal Ores,micro,48,5,3,2,104,103,1
2022,1,Makkah Region,Mining of Metal Ores,small,7,25,9,16,114,112,2
2022,1,Makkah Region,Mining of Metal Ores,micro,36,9,3,6,75,75,0
2022,1,Najran Region,Mining of Metal Ores,micro,8,0,0,0,21,21,0
2022,1,Eastern Province,Mining of Coal and Lignite,small,1,5,5,0,11,11,0
2022,1,Eastern Province,Mining of Coal and Lignite,micro,5,4,3,1,9,9,0
2022,1,Riyadh Region,Mining of Coal and Lignite,micro,11,3,3,0,26,25,1
2022,1,Qassim Region,Mining of Coal and Lignite,small,1,2,0,2,13,13,0
2022,1,Qassim Region,Mining of Coal and Lignite,micro,3,4,1,3,4,4,0
2022,1,Hail Region,Mining of Coal and Lignite,micro,1,0,0,0,1,1,0
2022,1,Makkah Region,Mining of Coal and Lignite,small,1,3,1,2,16,16,0
2022,1,Makkah Region,Mining of Coal and Lignite,micro,8,2,1,1,17,17,0
2022,1,Najran Region,Mining of Coal and Lignite,micro,1,0,0,0,4,4,0
2022,1,Eastern Province,Construction of Buildings,small,4960,11319,6400,4919,66981,66794,187
2022,1,Eastern Province,Construction of Buildings,large,138,22853,17308,5545,113247,112108,1139
2022,1,Eastern Province,Construction of Buildings,micro,11098,3202,1689,1513,24901,24820,81
2022,1,Eastern Province,Construction of Buildings,medium,682,10267,6724,3543,56171,56051,120
2022,1,Al Bahah Region,Construction of Buildings,small,304,558,411,147,3047,3041,6
2022,1,Al Bahah Region,Construction of Buildings,micro,1087,266,172,94,2589,2586,3
2022,1,Al Bahah Region,Construction of Buildings,medium,8,129,97,32,628,628,0
2022,1,Al Jawf Region,Construction of Buildings,small,307,449,309,140,3126,3117,9
2022,1,Al Jawf Region,Construction of Buildings,large,2,338,221,117,745,665,80
2022,1,Al Jawf Region,Construction of Buildings,micro,1338,232,168,64,3309,3306,3
2022,1,Al Jawf Region,Construction of Buildings,medium,17,217,168,49,1067,1064,3
2022,1,Northern Borders Region,Construction of Buildings,small,236,406,224,182,2543,2537,6
2022,1,Northern Borders Region,Construction of Buildings,large,3,277,136,141,1415,1374,41
2022,1,Northern Borders Region,Construction of Buildings,micro,1475,181,109,72,3721,3709,12
2022,1,Northern Borders Region,Construction of Buildings,medium,12,126,76,50,715,715,0
2022,1,Riyadh Region,Construction of Buildings,small,7640,14814,6845,7969,97147,96338,809
2022,1,Riyadh Region,Construction of Buildings,large,228,18933,11092,7841,145149,143941,1208
2022,1,Riyadh Region,Construction of Buildings,micro,21614,5423,2595,2828,47856,47502,354
2022,1,Riyadh Region,Construction of Buildings,medium,1018,13633,6602,7031,91872,91236,636
2022,1,Qassim Region,Construction of Buildings,small,1840,2422,1510,912,21971,21869,102
2022,1,Qassim Region,Construction of Buildings,large,14,159,92,67,5512,5495,17
2022,1,Qassim Region,Construction of Buildings,micro,9540,1362,813,549,22713,22646,67
2022,1,Qassim Region,Construction of Buildings,medium,155,1330,862,468,13133,13103,30
2022,1,Al Madinah Region,Construction of Buildings,small,1417,2618,1582,1036,16140,16050,90
2022,1,Al Madinah Region,Construction of Buildings,large,8,1209,787,422,5047,4578,469
2022,1,Al Madinah Region,Construction of Buildings,micro,5198,1066,595,471,12595,12543,52
2022,1,Al Madinah Region,Construction of Buildings,medium,92,1431,933,498,6717,6706,11
2022,1,Tabuk Region,Construction of Buildings,small,400,729,446,283,3981,3966,15
2022,1,Tabuk Region,Construction of Buildings,large,1,8,6,2,267,264,3
2022,1,Tabuk Region,Construction of Buildings,micro,2636,468,259,209,6561,6551,10
2022,1,Tabuk Region,Construction of Buildings,medium,14,139,75,64,1059,1059,0
2022,1,Jazan Region,Construction of Buildings,small,512,889,466,423,5256,5236,20
2022,1,Jazan Region,Construction of Buildings,large,1,74,52,22,216,216,0
2022,1,Jazan Region,Construction of Buildings,micro,3324,581,313,268,8268,8245,23
2022,1,Jazan Region,Construction of Buildings,medium,18,261,139,122,1448,1443,5
2022,1,Hail Region,Construction of Buildings,small,550,829,415,414,5948,5926,22
2022,1,Hail Region,Construction of Buildings,large,3,190,156,34,818,818,0
2022,1,Hail Region,Construction of Buildings,micro,3220,523,294,229,7693,7666,27
2022,1,Hail Region,Construction of Buildings,medium,39,548,379,169,2930,2926,4
2022,1,Aseer Region,Construction of Buildings,small,1480,2879,1847,1032,15190,15143,47
2022,1,Aseer Region,Construction of Buildings,large,5,415,363,52,2557,2557,0
2022,1,Aseer Region,Construction of Buildings,micro,7734,1398,847,551,18491,18468,23
2022,1,Aseer Region,Construction of Buildings,medium,72,1288,873,415,5597,5470,127
2022,1,Makkah Region,Construction of Buildings,small,6116,10755,5557,5198,72792,72241,551
2022,1,Makkah Region,Construction of Buildings,large,84,11565,8739,2826,83648,83016,632
2022,1,Makkah Region,Construction of Buildings,micro,19255,4285,2132,2153,47006,46639,367
2022,1,Makkah Region,Construction of Buildings,medium,499,7661,4525,3136,38910,38521,389
2022,1,Najran Region,Construction of Buildings,small,574,848,456,392,6275,6244,31
2022,1,Najran Region,Construction of Buildings,large,12,788,761,27,3948,3937,11
2022,1,Najran Region,Construction of Buildings,micro,2827,372,185,187,6746,6714,32
2022,1,Najran Region,Construction of Buildings,medium,49,902,445,457,4174,4161,13
2022,1,Eastern Province,"Water Collection, Treatment, and Supply",small,32,155,115,40,380,380,0
2022,1,Eastern Province,"Water Collection, Treatment, and Supply",large,2,1622,1619,3,463,463,0
2022,1,Eastern Province,"Water Collection, Treatment, and Supply",micro,49,23,16,7,93,93,0
2022,1,Eastern Province,"Water Collection, Treatment, and Supply",medium,3,160,156,4,189,189,0
2022,1,Al Bahah Region,"Water Collection, Treatment, and Supply",small,2,4,4,0,9,9,0
2022,1,Al Bahah Region,"Water Collection, Treatment, and Supply",micro,17,4,1,3,33,33,0
2022,1,Al Jawf Region,"Water Collection, Treatment, and Supply",small,4,25,20,5,69,69,0
2022,1,Al Jawf Region,"Water Collection, Treatment, and Supply",micro,11,0,0,0,25,25,0
2022,1,Northern Borders Region,"Water Collection, Treatment, and Supply",small,4,7,5,2,26,26,0
2022,1,Northern Borders Region,"Water Collection, Treatment, and Supply",micro,17,2,2,0,42,42,0
2022,1,Riyadh Region,"Water Collection, Treatment, and Supply",small,51,190,118,72,598,598,0
2022,1,Riyadh Region,"Water Collection, Treatment, and Supply",large,2,84,52,32,553,553,0
2022,1,Riyadh Region,"Water Collection, Treatment, and Supply",micro,144,48,23,25,299,297,2
2022,1,Riyadh Region,"Water Collection, Treatment, and Supply",medium,10,484,334,150,685,682,3
2022,1,Qassim Region,"Water Collection, Treatment, and Supply",small,12,31,15,16,142,142,0
2022,1,Qassim Region,"Water Collection, Treatment, and Supply",micro,43,10,7,3,93,93,0
2022,1,Qassim Region,"Water Collection, Treatment, and Supply",medium,1,41,41,0,172,172,0
2022,1,Al Madinah Region,"Water Collection, Treatment, and Supply",small,6,32,27,5,77,77,0
2022,1,Al Madinah Region,"Water Collection, Treatment, and Supply",large,1,352,352,0,1,1,0
2022,1,Al Madinah Region,"Water Collection, Treatment, and Supply",micro,39,12,7,5,64,64,0
2022,1,Al Madinah Region,"Water Collection, Treatment, and Supply",medium,1,32,16,16,77,77,0
2022,1,Tabuk Region,"Water Collection, Treatment, and Supply",small,4,4,4,0,52,52,0
2022,1,Tabuk Region,"Water Collection, Treatment, and Supply",micro,36,10,6,4,70,70,0
2022,1,Tabuk Region,"Water Collection, Treatment, and Supply",medium,1,22,16,6,81,81,0
2022,1,Jazan Region,"Water Collection, Treatment, and Supply",small,7,57,55,2,45,45,0
2022,1,Jazan Region,"Water Collection, Treatment, and Supply",micro,58,19,10,9,112,112,0
2022,1,Jazan Region,"Water Collection, Treatment, and Supply",medium,1,53,51,2,23,23,0
2022,1,Hail Region,"Water Collection, Treatment, and Supply",micro,28,7,1,6,61,61,0
2022,1,Hail Region,"Water Collection, Treatment, and Supply",medium,3,67,47,20,291,291,0
2022,1,Aseer Region,"Water Collection, Treatment, and Supply",small,18,49,27,22,194,194,0
2022,1,Aseer Region,"Water Collection, Treatment, and Supply",micro,116,22,10,12,219,219,0
2022,1,Makkah Region,"Water Collection, Treatment, and Supply",small,66,279,211,68,522,521,1
2022,1,Makkah Region,"Water Collection, Treatment, and Supply",large,2,324,312,12,585,585,0
2022,1,Makkah Region,"Water Collection, Treatment, and Supply",micro,310,72,41,31,619,617,2
2022,1,Makkah Region,"Water Collection, Treatment, and Supply",medium,11,462,397,65,628,627,1
2022,1,Najran Region,"Water Collection, Treatment, and Supply",small,3,3,2,1,20,20,0
2022,1,Najran Region,"Water Collection, Treatment, and Supply",micro,22,4,1,3,42,42,0
2022,1,Najran Region,"Water Collection, Treatment, and Supply",medium,3,68,64,4,257,254,3
2022,1,Eastern Province,"Wholesale and Retail Trade, Repair of Motor Vehicles and Motorcycles",small,1496,3662,2353,1309,14780,14758,22
2022,1,Eastern Province,"Wholesale and Retail Trade, Repair of Motor Vehicles and Motorcycles",large,10,2325,2116,209,4139,4134,5
2022,1,Eastern Province,"Wholesale and Retail Trade, Repair of Motor Vehicles and Motorcycles",micro,5987,2080,1281,799,12754,12732,22
2022,1,Eastern Province,"Wholesale and Retail Trade, Repair of Motor Vehicles and Motorcycles",medium,59,1282,974,308,4060,4057,3
2022,1,Al Bahah Region,"Wholesale and Retail Trade, Repair of Motor Vehicles and Motorcycles",small,83,156,118,38,654,654,0
2022,1,Al Bahah Region,"Wholesale and Retail Trade, Repair of Motor Vehicles and Motorcycles",micro,483,125,105,20,1021,1018,3
2022,1,Al Bahah Region,"Wholesale and Retail Trade, Repair of Motor Vehicles and Motorcycles",medium,2,32,23,9,118,118,0
2022,1,Al Jawf Region,"Wholesale and Retail Trade, Repair of Motor Vehicles and Motorcycles",small,122,190,153,37,1133,1132,1
2022,1,Al Jawf Region,"Wholesale and Retail Trade, Repair of Motor Vehicles and Motorcycles",micro,794,179,143,36,1790,1789,1
2022,1,Northern Borders Region,"Wholesale and Retail Trade, Repair of Motor Vehicles and Motorcycles",small,74,120,79,41,653,650,3
2022,1,Northern Borders Region,"Wholesale and Retail Trade, Repair of Motor Vehicles and Motorcycles",micro,599,100,71,29,1352,1350,2
2022,1,Northern Borders Region,"Wholesale and Retail Trade, Repair of Motor Vehicles and Motorcycles",medium,1,19,12,7,56,56,0
2022,1,Riyadh Region,"Wholesale and Retail Trade, Repair of Motor Vehicles and Motorcycles",small,2498,6495,3220,3275,25735,25615,120
2022,1,Riyadh Region,"Wholesale and Retail Trade, Repair of Motor Vehicles and Motorcycles",large,11,1571,1287,284,4643,4639,4
2022,1,Riyadh Region,"Wholesale and Retail Trade, Repair of Motor Vehicles and Motorcycles",micro,12610,3225,1734,1491,28945,28815,130
2022,1,Riyadh Region,"Wholesale and Retail Trade, Repair of Motor Vehicles and Motorcycles",medium,126,2802,1702,1100,9078,9047,31
2022,1,Qassim Region,"Wholesale and Retail Trade, Repair of Motor Vehicles and Motorcycles",small,487,996,691,305,4921,4891,30
2022,1,Qassim Region,"Wholesale and Retail Trade, Repair of Motor Vehicles and Motorcycles",large,1,0,0,0,313,313,0
2022,1,Qassim Region,"Wholesale and Retail Trade, Repair of Motor Vehicles and Motorcycles",micro,2984,610,400,210,6934,6926,8
2022,1,Qassim Region,"Wholesale and Retail Trade, Repair of Motor Vehicles and Motorcycles",medium,21,282,190,92,1522,1522,0
2022,1,Al Madinah Region,"Wholesale and Retail Trade, Repair of Motor Vehicles and Motorcycles",small,359,719,491,228,2868,2858,10
2022,1,Al Madinah Region,"Wholesale and Retail Trade, Repair of Motor Vehicles and Motorcycles",micro,2783,642,426,216,6281,6268,13
2022,1,Al Madinah Region,"Wholesale and Retail Trade, Repair of Motor Vehicles and Motorcycles",medium,11,120,92,28,590,590,0
2022,1,Tabuk Region,"Wholesale and Retail Trade, Repair of Motor Vehicles and Motorcycles",small,185,385,253,132,1561,1559,2
2022,1,Tabuk Region,"Wholesale and Retail Trade, Repair of Motor Vehicles and Motorcycles",micro,1353,270,179,91,3092,3087,5
2022,1,Tabuk Region,"Wholesale and Retail Trade, Repair of Motor Vehicles and Motorcycles",medium,3,96,76,20,242,242,0
2022,1,Jazan Region,"Wholesale and Retail Trade, Repair of Motor Vehicles and Motorcycles",small,178,396,271,125,1620,1616,4
2022,1,Jazan Region,"Wholesale and Retail Trade, Repair of Motor Vehicles and Motorcycles",large,1,68,31,37,337,337,0
2022,1,Jazan Region,"Wholesale and Retail Trade, Repair of Motor Vehicles and Motorcycles",micro,2231,389,281,108,5277,5271,6
2022,1,Jazan Region,"Wholesale and Retail Trade, Repair of Motor Vehicles and Motorcycles",medium,5,83,61,22,338,337,1
2022,1,Hail Region,"Wholesale and Retail Trade, Repair of Motor Vehicles and Motorcycles",small,211,405,241,164,1903,1900,3
2022,1,Hail Region,"Wholesale and Retail Trade, Repair of Motor Vehicles and Motorcycles",micro,1129,216,132,84,2516,2511,5
2022,1,Hail Region,"Wholesale and Retail Trade, Repair of Motor Vehicles and Motorcycles",medium,4,76,57,19,197,196,1
2022,1,Aseer Region,"Wholesale and Retail Trade, Repair of Motor Vehicles and Motorcycles",small,466,1029,686,343,4271,4262,9
2022,1,Aseer Region,"Wholesale and Retail Trade, Repair of Motor Vehicles and Motorcycles",micro,3137,679,445,234,6940,6918,22
2022,1,Aseer Region,"Wholesale and Retail Trade, Repair of Motor Vehicles and Motorcycles",medium,14,363,311,52,1114,1113,1
2022,1,Makkah Region,"Wholesale and Retail Trade, Repair of Motor Vehicles and Motorcycles",small,1582,3818,2394,1424,15056,14961,95
2022,1,Makkah Region,"Wholesale and Retail Trade, Repair of Motor Vehicles and Motorcycles",large,15,4915,4242,673,9812,9778,34
2022,1,Makkah Region,"Wholesale and Retail Trade, Repair of Motor Vehicles and Motorcycles",micro,9274,2147,1302,845,21278,21176,102
2022,1,Makkah Region,"Wholesale and Retail Trade, Repair of Motor Vehicles and Motorcycles",medium,73,1779,1305,474,4761,4746,15
2022,1,Najran Region,"Wholesale and Retail Trade, Repair of Motor Vehicles and Motorcycles",small,121,243,154,89,1158,1153,5
2022,1,Najran Region,"Wholesale and Retail Trade, Repair of Motor Vehicles and Motorcycles",micro,780,158,90,68,1750,1745,5
2022,1,Najran Region,"Wholesale and Retail Trade, Repair of Motor Vehicles and Motorcycles",medium,6,117,81,36,333,332,1
2022,1,Eastern Province,Wholesale Trade (Except of Motor Vehicles and Motorcycles),small,2162,8408,4930,3478,22617,22478,139
2022,1,Eastern Province,Wholesale Trade (Except of Motor Vehicles and Motorcycles),large,32,6455,4471,1984,11634,11539,95
2022,1,Eastern Province,Wholesale Trade (Except of Motor Vehicles and Motorcycles),micro,5661,3157,1750,1407,10569,10514,55
2022,1,Eastern Province,Wholesale Trade (Except of Motor Vehicles and Motorcycles),medium,196,5933,3807,2126,13558,13452,106
2022,1,Al Bahah Region,Wholesale Trade (Except of Motor Vehicles and Motorcycles),small,107,301,221,80,899,899,0
2022,1,Al Bahah Region,Wholesale Trade (Except of Motor Vehicles and Motorcycles),micro,395,176,136,40,738,735,3
2022,1,Al Bahah Region,Wholesale Trade (Except of Motor Vehicles and Motorcycles),medium,5,117,88,29,253,253,0
2022,1,Al Jawf Region,Wholesale Trade (Except of Motor Vehicles and Motorcycles),small,126,349,259,90,1283,1277,6
2022,1,Al Jawf Region,Wholesale Trade (Except of Motor Vehicles and Motorcycles),micro,537,188,137,51,1127,1118,9
2022,1,Al Jawf Region,Wholesale Trade (Except of Motor Vehicles and Motorcycles),medium,1,60,17,43,112,110,2
2022,1,Northern Borders Region,Wholesale Trade (Except of Motor Vehicles and Motorcycles),small,59,138,66,72,571,557,14
2022,1,Northern Borders Region,Wholesale Trade (Except of Motor Vehicles and Motorcycles),micro,329,113,76,37,746,746,0
2022,1,Northern Borders Region,Wholesale Trade (Except of Motor Vehicles and Motorcycles),medium,4,35,24,11,273,273,0
2022,1,Riyadh Region,Wholesale Trade (Except of Motor Vehicles and Motorcycles),small,5535,20817,9835,10982,59436,58690,746
2022,1,Riyadh Region,Wholesale Trade (Except of Motor Vehicles and Motorcycles),large,71,18919,13491,5428,23587,23352,235
2022,1,Riyadh Region,Wholesale Trade (Except of Motor Vehicles and Motorcycles),micro,15232,6650,3293,3357,30198,29774,424
2022,1,Riyadh Region,Wholesale Trade (Except of Motor Vehicles and Motorcycles),medium,514,15629,8276,7353,33704,33159,545
2022,1,Qassim Region,Wholesale Trade (Except of Motor Vehicles and Motorcycles),small,458,1463,938,525,4608,4570,38
2022,1,Qassim Region,Wholesale Trade (Except of Motor Vehicles and Motorcycles),large,4,896,312,584,985,985,0
2022,1,Qassim Region,Wholesale Trade (Except of Motor Vehicles and Motorcycles),micro,1954,714,469,245,3938,3924,14
2022,1,Qassim Region,Wholesale Trade (Except of Motor Vehicles and Motorcycles),medium,27,463,287,176,1379,1373,6
2022,1,Al Madinah Region,Wholesale Trade (Except of Motor Vehicles and Motorcycles),small,612,1875,1214,661,5877,5835,42
2022,1,Al Madinah Region,Wholesale Trade (Except of Motor Vehicles and Motorcycles),large,2,246,129,117,476,470,6
2022,1,Al Madinah Region,Wholesale Trade (Except of Motor Vehicles and Motorcycles),micro,2606,953,593,360,5405,5369,36
2022,1,Al Madinah Region,Wholesale Trade (Except of Motor Vehicles and Motorcycles),medium,33,831,602,229,2389,2282,107
2022,1,Tabuk Region,Wholesale Trade (Except of Motor Vehicles and Motorcycles),small,158,493,288,205,1575,1566,9
2022,1,Tabuk Region,Wholesale Trade (Except of Motor Vehicles and Motorcycles),large,1,103,68,35,274,274,0
2022,1,Tabuk Region,Wholesale Trade (Except of Motor Vehicles and Motorcycles),micro,781,296,178,118,1533,1526,7
2022,1,Tabuk Region,Wholesale Trade (Except of Motor Vehicles and Motorcycles),medium,10,161,67,94,607,605,2
2022,1,Jazan Region,Wholesale Trade (Except of Motor Vehicles and Motorcycles),small,278,701,393,308,2787,2779,8
2022,1,Jazan Region,Wholesale Trade (Except of Motor Vehicles and Motorcycles),micro,1563,440,270,170,3482,3465,17
2022,1,Jazan Region,Wholesale Trade (Except of Motor Vehicles and Motorcycles),medium,11,240,133,107,937,903,34
2022,1,Hail Region,Wholesale Trade (Except of Motor Vehicles and Motorcycles),small,148,438,270,168,1510,1504,6
2022,1,Hail Region,Wholesale Trade (Except of Motor Vehicles and Motorcycles),micro,694,238,130,108,1550,1544,6
2022,1,Hail Region,Wholesale Trade (Except of Motor Vehicles and Motorcycles),medium,7,116,53,63,330,330,0
2022,1,Aseer Region,Wholesale Trade (Except of Motor Vehicles and Motorcycles),small,442,1489,1037,452,4332,4305,27
2022,1,Aseer Region,Wholesale Trade (Except of Motor Vehicles and Motorcycles),large,2,268,163,105,498,484,14
2022,1,Aseer Region,Wholesale Trade (Except of Motor Vehicles and Motorcycles),micro,1846,672,446,226,3771,3758,13
2022,1,Aseer Region,Wholesale Trade (Except of Motor Vehicles and Motorcycles),medium,30,789,465,324,1919,1898,21
2022,1,Makkah Region,Wholesale Trade (Except of Motor Vehicles and Motorcycles),small,5010,17272,8503,8769,53051,52349,702
2022,1,Makkah Region,Wholesale Trade (Except of Motor Vehicles and Motorcycles),large,62,11656,7864,3792,20638,20370,268
2022,1,Makkah Region,Wholesale Trade (Except of Motor Vehicles and Motorcycles),micro,13400,5247,2702,2545,27759,27259,500
2022,1,Makkah Region,Wholesale Trade (Except of Motor Vehicles and Motorcycles),medium,396,12294,6947,5347,25709,25426,283
2022,1,Najran Region,Wholesale Trade (Except of Motor Vehicles and Motorcycles),small,111,345,219,126,1117,1113,4
2022,1,Najran Region,Wholesale Trade (Except of Motor Vehicles and Motorcycles),micro,576,170,91,79,1312,1302,10
2022,1,Najran Region,Wholesale Trade (Except of Motor Vehicles and Motorcycles),medium,6,198,101,97,402,402,0
2022,1,Eastern Province,Retail Trade (Except of Motor Vehicles and Motorcycles),small,2932,10347,5611,4736,28592,28395,197
2022,1,Eastern Province,Retail Trade (Except of Motor Vehicles and Motorcycles),large,39,10082,5213,4869,18359,17210,1149
2022,1,Eastern Province,Retail Trade (Except of Motor Vehicles and Motorcycles),micro,13452,6212,3395,2817,25139,24992,147
2022,1,Eastern Province,Retail Trade (Except of Motor Vehicles and Motorcycles),medium,229,7046,3687,3359,15100,14930,170
2022,1,Al Bahah Region,Retail Trade (Except of Motor Vehicles and Motorcycles),small,212,561,409,152,1876,1871,5
2022,1,Al Bahah Region,Retail Trade (Except of Motor Vehicles and Motorcycles),micro,1218,493,329,164,2197,2180,17
2022,1,Al Bahah Region,Retail Trade (Except of Motor Vehicles and Motorcycles),medium,4,63,47,16,167,167,0
2022,1,Al Jawf Region,Retail Trade (Except of Motor Vehicles and Motorcycles),small,275,592,404,188,2272,2256,16
2022,1,Al Jawf Region,Retail Trade (Except of Motor Vehicles and Motorcycles),micro,1971,639,444,195,3695,3682,13
2022,1,Al Jawf Region,Retail Trade (Except of Motor Vehicles and Motorcycles),medium,10,218,65,153,587,586,1
2022,1,Northern Borders Region,Retail Trade (Except of Motor Vehicles and Motorcycles),small,149,348,208,140,1234,1217,17
2022,1,Northern Borders Region,Retail Trade (Except of Motor Vehicles and Motorcycles),micro,1511,434,253,181,3009,2997,12
2022,1,Northern Borders Region,Retail Trade (Except of Motor Vehicles and Motorcycles),medium,7,117,83,34,447,425,22
2022,1,Riyadh Region,Retail Trade (Except of Motor Vehicles and Motorcycles),small,6288,23604,11003,12601,64620,63719,901
2022,1,Riyadh Region,Retail Trade (Except of Motor Vehicles and Motorcycles),large,127,47384,26673,20711,81487,80589,898
2022,1,Riyadh Region,Retail Trade (Except of Motor Vehicles and Motorcycles),micro,28274,11199,5653,5546,56052,55382,670
2022,1,Riyadh Region,Retail Trade (Except of Motor Vehicles and Motorcycles),medium,650,18444,8613,9831,45710,44849,861
2022,1,Qassim Region,Retail Trade (Except of Motor Vehicles and Motorcycles),small,977,2992,1986,1006,9800,9728,72
2022,1,Qassim Region,Retail Trade (Except of Motor Vehicles and Motorcycles),large,8,451,157,294,1974,1974,0
2022,1,Qassim Region,Retail Trade (Except of Motor Vehicles and Motorcycles),micro,5131,1912,1283,629,10027,9967,60
2022,1,Qassim Region,Retail Trade (Except of Motor Vehicles and Motorcycles),medium,68,1309,918,391,4712,4708,4
2022,1,Al Madinah Region,Retail Trade (Except of Motor Vehicles and Motorcycles),small,1240,3420,2156,1264,11105,11022,83
2022,1,Al Madinah Region,Retail Trade (Except of Motor Vehicles and Motorcycles),large,4,409,165,244,1247,1221,26
2022,1,Al Madinah Region,Retail Trade (Except of Motor Vehicles and Motorcycles),micro,8087,2655,1696,959,16118,15968,150
2022,1,Al Madinah Region,Retail Trade (Except of Motor Vehicles and Motorcycles),medium,58,1646,770,876,2957,2917,40
2022,1,Tabuk Region,Retail Trade (Except of Motor Vehicles and Motorcycles),small,363,1026,572,454,2950,2931,19
2022,1,Tabuk Region,Retail Trade (Except of Motor Vehicles and Motorcycles),micro,2986,969,580,389,5877,5858,19
2022,1,Tabuk Region,Retail Trade (Except of Motor Vehicles and Motorcycles),medium,11,514,266,248,799,768,31
2022,1,Jazan Region,Retail Trade (Except of Motor Vehicles and Motorcycles),small,679,1783,965,818,6100,6030,70
2022,1,Jazan Region,Retail Trade (Except of Motor Vehicles and Motorcycles),large,1,137,124,13,261,261,0
2022,1,Jazan Region,Retail Trade (Except of Motor Vehicles and Motorcycles),micro,5623,1613,962,651,11486,11430,56
2022,1,Jazan Region,Retail Trade (Except of Motor Vehicles and Motorcycles),medium,27,773,328,445,1804,1740,64
2022,1,Hail Region,Retail Trade (Except of Motor Vehicles and Motorcycles),small,378,1051,563,488,3369,3332,37
2022,1,Hail Region,Retail Trade (Except of Motor Vehicles and Motorcycles),large,2,393,165,228,425,425,0
2022,1,Hail Region,Retail Trade (Except of Motor Vehicles and Motorcycles),micro,2557,813,460,353,5132,5102,30
2022,1,Hail Region,Retail Trade (Except of Motor Vehicles and Motorcycles),medium,17,353,127,226,954,916,38
2022,1,Aseer Region,Retail Trade (Except of Motor Vehicles and Motorcycles),small,1038,2981,1808,1173,9340,9276,64
2022,1,Aseer Region,Retail Trade (Except of Motor Vehicles and Motorcycles),large,3,983,290,693,738,734,4
2022,1,Aseer Region,Retail Trade (Except of Motor Vehicles and Motorcycles),micro,6944,2592,1699,893,13048,12989,59
2022,1,Aseer Region,Retail Trade (Except of Motor Vehicles and Motorcycles),medium,44,1089,488,601,2741,2623,118
2022,1,Makkah Region,Retail Trade (Except of Motor Vehicles and Motorcycles),small,5544,18337,9145,9192,55324,54517,807
2022,1,Makkah Region,Retail Trade (Except of Motor Vehicles and Motorcycles),large,68,20490,10478,10012,28853,28185,668
2022,1,Makkah Region,Retail Trade (Except of Motor Vehicles and Motorcycles),micro,27234,9617,5208,4409,55156,54359,797
2022,1,Makkah Region,Retail Trade (Except of Motor Vehicles and Motorcycles),medium,397,13432,6583,6849,25568,25029,539
2022,1,Najran Region,Retail Trade (Except of Motor Vehicles and Motorcycles),small,350,939,450,489,3428,3386,42
2022,1,Najran Region,Retail Trade (Except of Motor Vehicles and Motorcycles),large,1,76,51,25,176,175,1
2022,1,Najran Region,Retail Trade (Except of Motor Vehicles and Motorcycles),micro,2186,591,340,251,4593,4565,28
2022,1,Najran Region,Retail Trade (Except of Motor Vehicles and Motorcycles),medium,15,235,94,141,1037,1031,6
2022,1,Eastern Province,"Crop and Animal Production, Hunting and Related Services",small,258,530,326,204,2945,2941,4
2022,1,Eastern Province,"Crop and Animal Production, Hunting and Related Services",large,4,2883,2750,133,2502,2502,0
2022,1,Eastern Province,"Crop and Animal Production, Hunting and Related Services",micro,1957,207,123,84,2773,2764,9
2022,1,Eastern Province,"Crop and Animal Production, Hunting and Related Services",medium,16,195,101,94,1173,1171,2
2022,1,Al Bahah Region,"Crop and Animal Production, Hunting and Related Services",small,6,9,4,5,53,53,0
2022,1,Al Bahah Region,"Crop and Animal Production, Hunting and Related Services",micro,159,6,6,0,202,202,0
2022,1,Al Jawf Region,"Crop and Animal Production, Hunting and Related Services",small,33,50,41,9,357,349,8
2022,1,Al Jawf Region,"Crop and Animal Production, Hunting and Related Services",large,2,170,161,9,1297,1294,3
2022,1,Al Jawf Region,"Crop and Animal Production, Hunting and Related Services",micro,626,39,31,8,869,865,4
2022,1,Al Jawf Region,"Crop and Animal Production, Hunting and Related Services",medium,1,11,6,5,127,127,0
2022,1,Northern Borders Region,"Crop and Animal Production, Hunting and Related Services",small,4,3,1,2,38,38,0
2022,1,Northern Borders Region,"Crop and Animal Production, Hunting and Related Services",micro,99,4,3,1,143,143,0
2022,1,Riyadh Region,"Crop and Animal Production, Hunting and Related Services",small,511,849,427,422,6586,6562,24
2022,1,Riyadh Region,"Crop and Animal Production, Hunting and Related Services",large,15,7518,6966,552,27344,27326,18
2022,1,Riyadh Region,"Crop and Animal Production, Hunting and Related Services",micro,6879,498,238,260,13077,13004,73
2022,1,Riyadh Region,"Crop and Animal Production, Hunting and Related Services",medium,77,738,412,326,6750,6744,6
2022,1,Qassim Region,"Crop and Animal Production, Hunting and Related Services",small,113,254,151,103,1323,1316,7
2022,1,Qassim Region,"Crop and Animal Production, Hunting and Related Services",large,3,1543,1109,434,4640,4639,1
2022,1,Qassim Region,"Crop and Animal Production, Hunting and Related Services",micro,1059,133,87,46,1737,1729,8
2022,1,Qassim Region,"Crop and Animal Production, Hunting and Related Services",medium,18,180,120,60,1475,1474,1
2022,1,Al Madinah Region,"Crop and Animal Production, Hunting and Related Services",small,66,157,97,60,782,779,3
2022,1,Al Madinah Region,"Crop and Animal Production, Hunting and Related Services",micro,782,54,32,22,1084,1078,6
2022,1,Al Madinah Region,"Crop and Animal Production, Hunting and Related Services",medium,3,75,56,19,227,226,1
2022,1,Tabuk Region,"Crop and Animal Production, Hunting and Related Services",small,42,71,32,39,463,463,0
2022,1,Tabuk Region,"Crop and Animal Production, Hunting and Related Services",large,2,273,176,97,1359,1358,1
2022,1,Tabuk Region,"Crop and Animal Production, Hunting and Related Services",micro,798,43,26,17,1138,1135,3
2022,1,Tabuk Region,"Crop and Animal Production, Hunting and Related Services",medium,3,131,56,75,75,74,1
2022,1,Jazan Region,"Crop and Animal Production, Hunting and Related Services",small,34,43,21,22,346,345,1
2022,1,Jazan Region,"Crop and Animal Production, Hunting and Related Services",micro,523,31,21,10,854,850,4
2022,1,Jazan Region,"Crop and Animal Production, Hunting and Related Services",medium,2,12,7,5,163,161,2
2022,1,Hail Region,"Crop and Animal Production, Hunting and Related Services",small,65,58,34,24,662,660,2
2022,1,Hail Region,"Crop and Animal Production, Hunting and Related Services",large,1,479,429,50,2281,2280,1
2022,1,Hail Region,"Crop and Animal Production, Hunting and Related Services",micro,1357,82,50,32,2773,2766,7
2022,1,Hail Region,"Crop and Animal Production, Hunting and Related Services",medium,5,87,77,10,406,404,2
2022,1,Aseer Region,"Crop and Animal Production, Hunting and Related Services",small,48,103,65,38,607,605,2
2022,1,Aseer Region,"Crop and Animal Production, Hunting and Related Services",large,1,0,0,0,254,254,0
2022,1,Aseer Region,"Crop and Animal Production, Hunting and Related Services",micro,946,52,28,24,1297,1292,5
2022,1,Aseer Region,"Crop and Animal Production, Hunting and Related Services",medium,1,7,7,0,63,63,0
2022,1,Makkah Region,"Crop and Animal Production, Hunting and Related Services",small,113,154,88,66,1233,1227,6
2022,1,Makkah Region,"Crop and Animal Production, Hunting and Related Services",large,2,771,504,267,3056,3055,1
2022,1,Makkah Region,"Crop and Animal Production, Hunting and Related Services",micro,1678,107,61,46,2462,2441,21
2022,1,Makkah Region,"Crop and Animal Production, Hunting and Related Services",medium,12,246,150,96,963,886,77
2022,1,Najran Region,"Crop and Animal Production, Hunting and Related Services",small,18,11,7,4,155,153,2
2022,1,Najran Region,"Crop and Animal Production, Hunting and Related Services",micro,538,20,12,8,864,863,1
2022,1,Najran Region,"Crop and Animal Production, Hunting and Related Services",medium,2,9,9,0,206,206,0
2022,1,Eastern Province,Support Services to Mining,small,59,391,325,66,492,485,7
2022,1,Eastern Province,Support Services to Mining,large,25,24375,23309,1066,10202,10191,11
2022,1,Eastern Province,Support Services to Mining,micro,74,72,58,14,89,88,1
2022,1,Eastern Province,Support Services to Mining,medium,26,1380,1220,160,1322,1317,5
2022,1,Al Bahah Region,Support Services to Mining,micro,3,0,0,0,7,7,0
2022,1,Al Jawf Region,Support Services to Mining,micro,5,0,0,0,14,14,0
2022,1,Northern Borders Region,Support Services to Mining,small,1,2,1,1,17,17,0
2022,1,Riyadh Region,Support Services to Mining,small,14,131,97,34,115,115,0
2022,1,Riyadh Region,Support Services to Mining,large,1,472,390,82,90,90,0
2022,1,Riyadh Region,Support Services to Mining,micro,45,58,46,12,39,38,1
2022,1,Riyadh Region,Support Services to Mining,medium,2,60,55,5,104,101,3
2022,1,Qassim Region,Support Services to Mining,small,1,0,0,0,7,7,0
2022,1,Qassim Region,Support Services to Mining,micro,2,1,0,1,5,5,0
2022,1,Al Madinah Region,Support Services to Mining,small,4,23,10,13,44,44,0
2022,1,Al Madinah Region,Support Services to Mining,micro,7,2,1,1,11,11,0
2022,1,Tabuk Region,Support Services to Mining,small,1,4,3,1,24,24,0
2022,1,Tabuk Region,Support Services to Mining,micro,1,0,0,0,4,4,0
2022,1,Jazan Region,Support Services to Mining,small,1,0,0,0,22,22,0
2022,1,Jazan Region,Support Services to Mining,micro,5,1,1,0,14,14,0
2022,1,Hail Region,Support Services to Mining,small,2,0,0,0,25,25,0
2022,1,Hail Region,Support Services to Mining,micro,4,0,0,0,10,10,0
2022,1,Aseer Region,Support Services to Mining,small,2,12,11,1,33,33,0
2022,1,Aseer Region,Support Services to Mining,micro,16,4,3,1,37,37,0
2022,1,Makkah Region,Support Services to Mining,small,11,32,18,14,83,82,1
2022,1,Makkah Region,Support Services to Mining,large,2,336,200,136,624,620,4
2022,1,Makkah Region,Support Services to Mining,micro,29,10,7,3,51,50,1
2022,1,Makkah Region,Support Services to Mining,medium,3,73,73,0,349,349,0
2022,1,Najran Region,Support Services to Mining,micro,1,1,1,0,0,0,0
2022,1,Eastern Province,Information Service Activities,small,15,82,57,25,112,112,0
2022,1,Eastern Province,Information Service Activities,large,1,419,277,142,25,22,3
2022,1,Eastern Province,Information Service Activities,micro,51,46,17,29,65,64,1
2022,1,Eastern Province,Information Service Activities,medium,5,295,127,168,140,137,3
2022,1,Al Bahah Region,Information Service Activities,small,1,19,13,6,7,7,0
2022,1,Al Jawf Region,Information Service Activities,small,2,1,1,0,18,18,0
2022,1,Al Jawf Region,Information Service Activities,micro,6,4,2,2,9,9,0
2022,1,Northern Borders Region,Information Service Activities,micro,1,1,1,0,2,2,0
2022,1,Riyadh Region,Information Service Activities,small,166,1122,567,555,1365,1318,47
2022,1,Riyadh Region,Information Service Activities,large,10,8253,5024,3229,3004,2913,91
2022,1,Riyadh Region,Information Service Activities,micro,303,308,171,137,405,380,25
2022,1,Riyadh Region,Information Service Activities,medium,40,2336,1299,1037,2022,1962,60
2022,1,Qassim Region,Information Service Activities,small,1,3,2,1,15,15,0
2022,1,Qassim Region,Information Service Activities,micro,7,6,1,5,12,12,0
2022,1,Al Madinah Region,Information Service Activities,small,4,4,0,4,22,22,0
2022,1,Al Madinah Region,Information Service Activities,micro,15,8,4,4,27,26,1
2022,1,Al Madinah Region,Information Service Activities,medium,1,63,20,43,3,3,0
2022,1,Tabuk Region,Information Service Activities,small,1,1,1,0,5,5,0
2022,1,Tabuk Region,Information Service Activities,micro,5,1,0,1,9,9,0
2022,1,Jazan Region,Information Service Activities,micro,7,3,1,2,16,16,0
2022,1,Hail Region,Information Service Activities,small,1,9,9,0,6,6,0
2022,1,Hail Region,Information Service Activities,micro,5,1,0,1,12,12,0
2022,1,Aseer Region,Information Service Activities,small,1,4,1,3,4,4,0
2022,1,Aseer Region,Information Service Activities,micro,7,7,4,3,10,10,0
2022,1,Makkah Region,Information Service Activities,small,39,230,112,118,344,334,10
2022,1,Makkah Region,Information Service Activities,micro,115,66,38,28,170,166,4
2022,1,Makkah Region,Information Service Activities,medium,2,183,57,126,93,83,10
2022,1,Najran Region,Information Service Activities,small,1,7,7,0,35,35,0
2022,1,Najran Region,Information Service Activities,micro,1,0,0,0,1,1,0
2022,1,Eastern Province,Food and Beverage Service Activities,small,2649,7652,3806,3846,28255,28154,101
2022,1,Eastern Province,Food and Beverage Service Activities,large,27,4134,2769,1365,10993,10932,61
2022,1,Eastern Province,Food and Beverage Service Activities,micro,7884,3281,1576,1705,15742,15663,79
2022,1,Eastern Province,Food and Beverage Service Activities,medium,204,4620,2185,2435,15387,15360,27
2022,1,Al Bahah Region,Food and Beverage Service Activities,small,159,363,284,79,1658,1656,2
2022,1,Al Bahah Region,Food and Beverage Service Activities,micro,685,248,171,77,1371,1364,7
2022,1,Al Bahah Region,Food and Beverage Service Activities,medium,5,101,72,29,377,376,1
2022,1,Al Jawf Region,Food and Beverage Service Activities,small,189,390,263,127,1744,1743,1
2022,1,Al Jawf Region,Food and Beverage Service Activities,micro,976,303,217,86,2080,2066,14
2022,1,Al Jawf Region,Food and Beverage Service Activities,medium,5,72,69,3,246,246,0
2022,1,Northern Borders Region,Food and Beverage Service Activities,small,129,258,149,109,1345,1343,2
2022,1,Northern Borders Region,Food and Beverage Service Activities,micro,910,215,143,72,2147,2140,7
2022,1,Northern Borders Region,Food and Beverage Service Activities,medium,2,39,11,28,129,124,5
2022,1,Riyadh Region,Food and Beverage Service Activities,small,3619,10958,4778,6180,40724,40367,357
2022,1,Riyadh Region,Food and Beverage Service Activities,large,71,16159,10679,5480,43165,42618,547
2022,1,Riyadh Region,Food and Beverage Service Activities,micro,12102,4391,1962,2429,25296,25084,212
2022,1,Riyadh Region,Food and Beverage Service Activities,medium,413,9464,4324,5140,31191,30762,429
2022,1,Qassim Region,Food and Beverage Service Activities,small,800,1729,1151,578,8160,8144,16
2022,1,Qassim Region,Food and Beverage Service Activities,large,3,168,92,76,883,883,0
2022,1,Qassim Region,Food and Beverage Service Activities,micro,3355,877,529,348,7689,7656,33
2022,1,Qassim Region,Food and Beverage Service Activities,medium,50,840,505,335,3390,3386,4
2022,1,Al Madinah Region,Food and Beverage Service Activities,small,965,2439,1360,1079,9494,9440,54
2022,1,Al Madinah Region,Food and Beverage Service Activities,large,2,216,184,32,420,419,1
2022,1,Al Madinah Region,Food and Beverage Service Activities,micro,4437,1309,818,491,9189,9120,69
2022,1,Al Madinah Region,Food and Beverage Service Activities,medium,37,719,453,266,2697,2686,11
2022,1,Tabuk Region,Food and Beverage Service Activities,small,365,817,392,425,3833,3828,5
2022,1,Tabuk Region,Food and Beverage Service Activities,large,1,108,27,81,295,252,43
2022,1,Tabuk Region,Food and Beverage Service Activities,micro,1962,563,300,263,4122,4108,14
2022,1,Tabuk Region,Food and Beverage Service Activities,medium,19,345,154,191,1405,1401,4
2022,1,Jazan Region,Food and Beverage Service Activities,small,544,1215,673,542,5367,5351,16
2022,1,Jazan Region,Food and Beverage Service Activities,micro,3568,895,519,376,7831,7815,16
2022,1,Jazan Region,Food and Beverage Service Activities,medium,16,295,177,118,955,947,8
2022,1,Hail Region,Food and Beverage Service Activities,small,267,586,364,222,2522,2510,12
2022,1,Hail Region,Food and Beverage Service Activities,large,2,134,67,67,509,504,5
2022,1,Hail Region,Food and Beverage Service Activities,micro,1736,387,219,168,3897,3878,19
2022,1,Hail Region,Food and Beverage Service Activities,medium,15,191,110,81,961,961,0
2022,1,Aseer Region,Food and Beverage Service Activities,small,953,2207,1284,923,9689,9656,33
2022,1,Aseer Region,Food and Beverage Service Activities,large,3,199,147,52,656,655,1
2022,1,Aseer Region,Food and Beverage Service Activities,micro,4783,1425,802,623,9914,9877,37
2022,1,Aseer Region,Food and Beverage Service Activities,medium,56,1184,790,394,3952,3949,3
2022,1,Makkah Region,Food and Beverage Service Activities,small,3450,9686,4600,5086,37938,37520,418
2022,1,Makkah Region,Food and Beverage Service Activities,large,33,8061,5650,2411,19599,19386,213
2022,1,Makkah Region,Food and Beverage Service Activities,micro,14011,4477,2301,2176,28450,28106,344
2022,1,Makkah Region,Food and Beverage Service Activities,medium,294,5799,2947,2852,20123,19863,260
2022,1,Najran Region,Food and Beverage Service Activities,small,223,485,224,261,2454,2451,3
2022,1,Najran Region,Food and Beverage Service Activities,large,1,198,119,79,508,505,3
2022,1,Najran Region,Food and Beverage Service Activities,micro,1340,296,137,159,3012,2997,15
2022,1,Najran Region,Food and Beverage Service Activities,medium,10,240,130,110,934,929,5
2022,1,Eastern Province,"Waste Collection, Treatment, and Disposal, Materials Recovery",small,33,126,69,57,462,461,1
2022,1,Eastern Province,"Waste Collection, Treatment, and Disposal, Materials Recovery",large,3,1148,774,374,6674,5103,1571
2022,1,Eastern Province,"Waste Collection, Treatment, and Disposal, Materials Recovery",micro,38,30,18,12,57,57,0
2022,1,Eastern Province,"Waste Collection, Treatment, and Disposal, Materials Recovery",medium,10,299,230,69,1131,1124,7
2022,1,Al Bahah Region,"Waste Collection, Treatment, and Disposal, Materials Recovery",micro,2,1,1,0,3,3,0
2022,1,Al Jawf Region,"Waste Collection, Treatment, and Disposal, Materials Recovery",small,1,4,2,2,19,19,0
2022,1,Al Jawf Region,"Waste Collection, Treatment, and Disposal, Materials Recovery",micro,2,1,0,1,4,4,0
2022,1,Riyadh Region,"Waste Collection, Treatment, and Disposal, Materials Recovery",small,29,102,46,56,393,390,3
2022,1,Riyadh Region,"Waste Collection, Treatment, and Disposal, Materials Recovery",large,11,5715,3102,2613,31383,29495,1888
2022,1,Riyadh Region,"Waste Collection, Treatment, and Disposal, Materials Recovery",micro,74,35,20,15,131,127,4
2022,1,Riyadh Region,"Waste Collection, Treatment, and Disposal, Materials Recovery",medium,11,195,136,59,1103,1101,2
2022,1,Qassim Region,"Waste Collection, Treatment, and Disposal, Materials Recovery",small,8,51,28,23,141,141,0
2022,1,Qassim Region,"Waste Collection, Treatment, and Disposal, Materials Recovery",micro,11,3,2,1,20,20,0
2022,1,Al Madinah Region,"Waste Collection, Treatment, and Disposal, Materials Recovery",small,4,14,7,7,66,66,0
2022,1,Al Madinah Region,"Waste Collection, Treatment, and Disposal, Materials Recovery",large,1,3,3,0,831,830,1
2022,1,Al Madinah Region,"Waste Collection, Treatment, and Disposal, Materials Recovery",micro,9,10,4,6,13,12,1
2022,1,Al Madinah Region,"Waste Collection, Treatment, and Disposal, Materials Recovery",medium,2,70,56,14,222,221,1
2022,1,Tabuk Region,"Waste Collection, Treatment, and Disposal, Materials Recovery",micro,1,2,1,1,0,0,0
2022,1,Jazan Region,"Waste Collection, Treatment, and Disposal, Materials Recovery",small,1,8,5,3,4,4,0
2022,1,Jazan Region,"Waste Collection, Treatment, and Disposal, Materials Recovery",micro,4,0,0,0,6,6,0
2022,1,Jazan Region,"Waste Collection, Treatment, and Disposal, Materials Recovery",medium,2,23,16,7,196,196,0
2022,1,Hail Region,"Waste Collection, Treatment, and Disposal, Materials Recovery",small,1,2,1,1,8,7,1
2022,1,Hail Region,"Waste Collection, Treatment, and Disposal, Materials Recovery",micro,6,1,1,0,11,11,0
2022,1,Aseer Region,"Waste Collection, Treatment, and Disposal, Materials Recovery",micro,10,2,2,0,19,19,0
2022,1,Aseer Region,"Waste Collection, Treatment, and Disposal, Materials Recovery",medium,2,77,73,4,131,131,0
2022,1,Makkah Region,"Waste Collection, Treatment, and Disposal, Materials Recovery",small,33,136,75,61,465,457,8
2022,1,Makkah Region,"Waste Collection, Treatment, and Disposal, Materials Recovery",large,4,2056,896,1160,8107,8040,67
2022,1,Makkah Region,"Waste Collection, Treatment, and Disposal, Materials Recovery",micro,59,40,19,21,96,93,3
2022,1,Najran Region,"Waste Collection, Treatment, and Disposal, Materials Recovery",small,3,3,2,1,19,19,0
2022,1,Najran Region,"Waste Collection, Treatment, and Disposal, Materials Recovery",micro,9,2,1,1,23,23,0
2022,1,Eastern Province,Services to Buildings and Landscape Activities,small,523,1900,1113,787,6707,6654,53
2022,1,Eastern Province,Services to Buildings and Landscape Activities,large,58,12734,9162,3572,42680,41650,1030
2022,1,Eastern Province,Services to Buildings and Landscape Activities,micro,1271,427,219,208,2679,2663,16
2022,1,Eastern Province,Services to Buildings and Landscape Activities,medium,129,3143,2174,969,11017,10984,33
2022,1,Al Bahah Region,Services to Buildings and Landscape Activities,small,12,30,21,9,130,130,0
2022,1,Al Bahah Region,Services to Buildings and Landscape Activities,micro,51,12,6,6,100,100,0
2022,1,Al Bahah Region,Services to Buildings and Landscape Activities,medium,2,16,8,8,93,92,1
2022,1,Al Jawf Region,Services to Buildings and Landscape Activities,small,41,129,66,63,414,414,0
2022,1,Al Jawf Region,Services to Buildings and Landscape Activities,micro,205,31,18,13,465,462,3
2022,1,Al Jawf Region,Services to Buildings and Landscape Activities,medium,3,40,21,19,172,172,0
2022,1,Northern Borders Region,Services to Buildings and Landscape Activities,small,13,34,13,21,121,121,0
2022,1,Northern Borders Region,Services to Buildings and Landscape Activities,large,1,212,112,100,538,517,21
2022,1,Northern Borders Region,Services to Buildings and Landscape Activities,micro,80,10,7,3,192,192,0
2022,1,Northern Borders Region,Services to Buildings and Landscape Activities,medium,2,64,52,12,165,165,0
2022,1,Riyadh Region,Services to Buildings and Landscape Activities,small,1429,3966,1963,2003,19571,19250,321
2022,1,Riyadh Region,Services to Buildings and Landscape Activities,large,130,34114,20633,13481,156992,146157,10835
2022,1,Riyadh Region,Services to Buildings and Landscape Activities,micro,3746,1149,568,581,8122,8040,82
2022,1,Riyadh Region,Services to Buildings and Landscape Activities,medium,410,8119,4179,3940,36904,36090,814
2022,1,Qassim Region,Services to Buildings and Landscape Activities,small,219,347,190,157,3444,3433,11
2022,1,Qassim Region,Services to Buildings and Landscape Activities,large,22,1504,733,771,8266,7951,315
2022,1,Qassim Region,Services to Buildings and Landscape Activities,micro,1039,194,112,82,2569,2555,14
2022,1,Qassim Region,Services to Buildings and Landscape Activities,medium,94,1376,737,639,11353,11160,193
2022,1,Al Madinah Region,Services to Buildings and Landscape Activities,small,165,439,283,156,1893,1877,16
2022,1,Al Madinah Region,Services to Buildings and Landscape Activities,large,2,56,29,27,772,755,17
2022,1,Al Madinah Region,Services to Buildings and Landscape Activities,micro,705,168,101,67,1580,1568,12
2022,1,Al Madinah Region,Services to Buildings and Landscape Activities,medium,26,669,507,162,2212,2212,0
2022,1,Tabuk Region,Services to Buildings and Landscape Activities,small,42,129,62,67,424,423,1
2022,1,Tabuk Region,Services to Buildings and Landscape Activities,large,2,1636,1563,73,1627,1572,55
2022,1,Tabuk Region,Services to Buildings and Landscape Activities,micro,283,56,33,23,693,689,4
2022,1,Tabuk Region,Services to Buildings and Landscape Activities,medium,7,88,28,60,609,609,0
2022,1,Jazan Region,Services to Buildings and Landscape Activities,small,45,125,54,71,467,455,12
2022,1,Jazan Region,Services to Buildings and Landscape Activities,micro,308,51,23,28,820,818,2
2022,1,Jazan Region,Services to Buildings and Landscape Activities,medium,5,131,69,62,449,436,13
2022,1,Hail Region,Services to Buildings and Landscape Activities,small,43,109,49,60,546,542,4
2022,1,Hail Region,Services to Buildings and Landscape Activities,large,2,732,499,233,1373,1275,98
2022,1,Hail Region,Services to Buildings and Landscape Activities,micro,308,58,29,29,709,704,5
2022,1,Hail Region,Services to Buildings and Landscape Activities,medium,13,211,130,81,913,884,29
2022,1,Aseer Region,Services to Buildings and Landscape Activities,small,73,213,133,80,963,936,27
2022,1,Aseer Region,Services to Buildings and Landscape Activities,large,4,1477,1206,271,4011,3987,24
2022,1,Aseer Region,Services to Buildings and Landscape Activities,micro,474,105,52,53,1163,1157,6
2022,1,Aseer Region,Services to Buildings and Landscape Activities,medium,11,234,158,76,1033,1029,4
2022,1,Makkah Region,Services to Buildings and Landscape Activities,small,908,2708,1354,1354,10847,10636,211
2022,1,Makkah Region,Services to Buildings and Landscape Activities,large,45,7306,5113,2193,31926,31064,862
2022,1,Makkah Region,Services to Buildings and Landscape Activities,micro,2746,876,476,400,6353,6253,100
2022,1,Makkah Region,Services to Buildings and Landscape Activities,medium,214,5201,2877,2324,17105,16604,501
2022,1,Najran Region,Services to Buildings and Landscape Activities,small,46,103,61,42,750,748,2
2022,1,Najran Region,Services to Buildings and Landscape Activities,large,8,1682,1161,521,7988,7930,58
2022,1,Najran Region,Services to Buildings and Landscape Activities,micro,193,40,24,16,431,419,12
2022,1,Najran Region,Services to Buildings and Landscape Activities,medium,15,383,296,87,1118,1087,31
2022,1,Eastern Province,Publishing Activities,small,26,105,66,39,233,231,2
2022,1,Eastern Province,Publishing Activities,micro,65,44,18,26,113,111,2
2022,1,Eastern Province,Publishing Activities,medium,2,120,106,14,127,127,0
2022,1,Al Bahah Region,Publishing Activities,small,1,4,3,1,13,13,0
2022,1,Al Bahah Region,Publishing Activities,micro,4,3,3,0,10,10,0
2022,1,Al Jawf Region,Publishing Activities,micro,1,0,0,0,2,2,0
2022,1,Northern Borders Region,Publishing Activities,micro,2,2,0,2,3,3,0
2022,1,Riyadh Region,Publishing Activities,small,55,359,170,189,475,470,5
2022,1,Riyadh Region,Publishing Activities,large,3,425,185,240,1606,1586,20
2022,1,Riyadh Region,Publishing Activities,micro,149,103,47,56,189,188,1
2022,1,Riyadh Region,Publishing Activities,medium,12,535,297,238,698,675,23
2022,1,Qassim Region,Publishing Activities,small,2,2,1,1,17,17,0
2022,1,Qassim Region,Publishing Activities,micro,6,2,1,1,8,8,0
2022,1,Qassim Region,Publishing Activities,medium,1,0,0,0,151,151,0
2022,1,Al Madinah Region,Publishing Activities,small,3,4,3,1,16,16,0
2022,1,Al Madinah Region,Publishing Activities,micro,14,7,3,4,23,23,0
2022,1,Tabuk Region,Publishing Activities,micro,1,0,0,0,4,4,0
2022,1,Jazan Region,Publishing Activities,micro,7,1,0,1,9,9,0
2022,1,Hail Region,Publishing Activities,micro,31,3,1,2,88,88,0
2022,1,Aseer Region,Publishing Activities,small,2,1,1,0,13,13,0
2022,1,Aseer Region,Publishing Activities,micro,9,6,5,1,16,16,0
2022,1,Aseer Region,Publishing Activities,medium,1,26,16,10,65,65,0
2022,1,Makkah Region,Publishing Activities,small,17,65,28,37,244,242,2
2022,1,Makkah Region,Publishing Activities,micro,80,40,20,20,122,121,1
2022,1,Makkah Region,Publishing Activities,medium,4,95,73,22,272,217,55
2022,1,Najran Region,Publishing Activities,small,1,1,1,0,5,5,0
2022,1,Najran Region,Publishing Activities,micro,3,0,0,0,6,5,1
2022,1,Najran Region,Publishing Activities,medium,1,0,0,0,170,170,0
2022,1,Eastern Province,Activities of Membership Organizations,small,24,215,75,140,153,153,0
2022,1,Eastern Province,Activities of Membership Organizations,micro,60,43,30,13,90,85,5
2022,1,Eastern Province,Activities of Membership Organizations,medium,3,157,77,80,93,91,2
2022,1,Al Bahah Region,Activities of Membership Organizations,small,1,9,9,0,0,0,0
2022,1,Al Bahah Region,Activities of Membership Organizations,micro,9,15,12,3,4,4,0
2022,1,Al Jawf Region,Activities of Membership Organizations,small,4,39,36,3,25,24,1
2022,1,Al Jawf Region,Activities of Membership Organizations,micro,21,22,12,10,35,35,0
2022,1,Northern Borders Region,Activities of Membership Organizations,small,1,29,25,4,13,11,2
2022,1,Northern Borders Region,Activities of Membership Organizations,micro,5,5,4,1,3,3,0
2022,1,Riyadh Region,Activities of Membership Organizations,small,89,558,330,228,651,633,18
2022,1,Riyadh Region,Activities of Membership Organizations,large,9,12044,7632,4412,2112,1123,989
2022,1,Riyadh Region,Activities of Membership Organizations,micro,1858,309,168,141,3659,3610,49
2022,1,Riyadh Region,Activities of Membership Organizations,medium,21,2461,1723,738,366,309,57
2022,1,Qassim Region,Activities of Membership Organizations,small,13,119,78,41,46,44,2
2022,1,Qassim Region,Activities of Membership Organizations,micro,64,51,39,12,109,109,0
2022,1,Al Madinah Region,Activities of Membership Organizations,small,8,49,38,11,51,49,2
2022,1,Al Madinah Region,Activities of Membership Organizations,large,1,268,257,11,15,15,0
2022,1,Al Madinah Region,Activities of Membership Organizations,micro,58,15,11,4,101,99,2
2022,1,Al Madinah Region,Activities of Membership Organizations,medium,1,30,14,16,35,35,0
2022,1,Tabuk Region,Activities of Membership Organizations,small,4,81,48,33,15,14,1
2022,1,Tabuk Region,Activities of Membership Organizations,micro,18,26,9,17,16,16,0
2022,1,Tabuk Region,Activities of Membership Organizations,medium,2,100,49,51,107,106,1
2022,1,Jazan Region,Activities of Membership Organizations,small,8,99,66,33,37,37,0
2022,1,Jazan Region,Activities of Membership Organizations,micro,109,50,27,23,149,144,5
2022,1,Hail Region,Activities of Membership Organizations,small,4,21,13,8,13,13,0
2022,1,Hail Region,Activities of Membership Organizations,micro,18,13,5,8,20,20,0
2022,1,Hail Region,Activities of Membership Organizations,medium,1,76,64,12,0,0,0
2022,1,Aseer Region,Activities of Membership Organizations,small,8,65,31,34,41,38,3
2022,1,Aseer Region,Activities of Membership Organizations,micro,39,48,33,15,38,37,1
2022,1,Aseer Region,Activities of Membership Organizations,medium,1,47,12,35,31,30,1
2022,1,Makkah Region,Activities of Membership Organizations,small,40,234,152,82,326,322,4
2022,1,Makkah Region,Activities of Membership Organizations,large,1,427,194,233,88,88,0
2022,1,Makkah Region,Activities of Membership Organizations,micro,200,162,105,57,283,273,10
2022,1,Makkah Region,Activities of Membership Organizations,medium,4,502,330,172,34,26,8
2022,1,Najran Region,Activities of Membership Organizations,small,1,44,42,2,3,3,0
2022,1,Najran Region,Activities of Membership Organizations,micro,31,14,9,5,52,50,2
2022,1,Eastern Province,"Libraries, Archives, Museums, and Other Cultural Activities",small,11,31,17,14,106,105,1
2022,1,Eastern Province,"Libraries, Archives, Museums, and Other Cultural Activities",micro,37,11,6,5,62,60,2
2022,1,Al Bahah Region,"Libraries, Archives, Museums, and Other Cultural Activities",micro,5,2,1,1,9,9,0
2022,1,Al Jawf Region,"Libraries, Archives, Museums, and Other Cultural Activities",micro,3,0,0,0,3,3,0
2022,1,Northern Borders Region,"Libraries, Archives, Museums, and Other Cultural Activities",micro,4,0,0,0,8,8,0
2022,1,Riyadh Region,"Libraries, Archives, Museums, and Other Cultural Activities",small,9,34,17,17,100,95,5
2022,1,Riyadh Region,"Libraries, Archives, Museums, and Other Cultural Activities",micro,28,18,6,12,44,43,1
2022,1,Riyadh Region,"Libraries, Archives, Museums, and Other Cultural Activities",medium,1,64,41,23,0,0,0
2022,1,Qassim Region,"Libraries, Archives, Museums, and Other Cultural Activities",small,4,8,7,1,18,18,0
2022,1,Qassim Region,"Libraries, Archives, Museums, and Other Cultural Activities",micro,8,2,1,1,13,13,0
2022,1,Al Madinah Region,"Libraries, Archives, Museums, and Other Cultural Activities",small,6,16,13,3,34,34,0
2022,1,Al Madinah Region,"Libraries, Archives, Museums, and Other Cultural Activities",micro,32,14,10,4,63,63,0
2022,1,Tabuk Region,"Libraries, Archives, Museums, and Other Cultural Activities",small,3,6,4,2,21,21,0
2022,1,Tabuk Region,"Libraries, Archives, Museums, and Other Cultural Activities",micro,9,3,3,0,23,23,0
2022,1,Jazan Region,"Libraries, Archives, Museums, and Other Cultural Activities",small,2,4,3,1,20,20,0
2022,1,Jazan Region,"Libraries, Archives, Museums, and Other Cultural Activities",micro,14,2,1,1,33,33,0
2022,1,Hail Region,"Libraries, Archives, Museums, and Other Cultural Activities",micro,6,3,1,2,8,8,0
2022,1,Aseer Region,"Libraries, Archives, Museums, and Other Cultural Activities",small,3,13,8,5,31,31,0
2022,1,Aseer Region,"Libraries, Archives, Museums, and Other Cultural Activities",micro,13,3,2,1,21,21,0
2022,1,Makkah Region,"Libraries, Archives, Museums, and Other Cultural Activities",small,8,14,8,6,68,66,2
2022,1,Makkah Region,"Libraries, Archives, Museums, and Other Cultural Activities",micro,91,32,23,9,165,160,5
2022,1,Makkah Region,"Libraries, Archives, Museums, and Other Cultural Activities",medium,2,35,10,25,132,132,0
2022,1,Najran Region,"Libraries, Archives, Museums, and Other Cultural Activities",micro,7,1,1,0,20,20,0
2022,1,Eastern Province,"Head Office Activities, Management Consultancy Activities",small,36,253,161,92,349,338,11
2022,1,Eastern Province,"Head Office Activities, Management Consultancy Activities",micro,105,104,65,39,140,136,4
2022,1,Eastern Province,"Head Office Activities, Management Consultancy Activities",medium,6,216,145,71,298,289,9
2022,1,Al Bahah Region,"Head Office Activities, Management Consultancy Activities",small,1,2,2,0,6,6,0
2022,1,Al Bahah Region,"Head Office Activities, Management Consultancy Activities",micro,2,1,0,1,3,3,0
2022,1,Al Jawf Region,"Head Office Activities, Management Consultancy Activities",large,1,88,17,71,196,142,54
2022,1,Al Jawf Region,"Head Office Activities, Management Consultancy Activities",micro,3,1,1,0,3,3,0
2022,1,Northern Borders Region,"Head Office Activities, Management Consultancy Activities",small,1,8,6,2,5,5,0
2022,1,Northern Borders Region,"Head Office Activities, Management Consultancy Activities",micro,3,1,0,1,5,5,0
2022,1,Riyadh Region,"Head Office Activities, Management Consultancy Activities",small,195,1381,751,630,1511,1382,129
2022,1,Riyadh Region,"Head Office Activities, Management Consultancy Activities",large,12,9139,6235,2904,3436,3288,148
2022,1,Riyadh Region,"Head Office Activities, Management Consultancy Activities",micro,610,542,279,263,807,769,38
2022,1,Riyadh Region,"Head Office Activities, Management Consultancy Activities",medium,28,1636,975,661,1543,1467,76
2022,1,Qassim Region,"Head Office Activities, Management Consultancy Activities",small,6,15,11,4,53,53,0
2022,1,Qassim Region,"Head Office Activities, Management Consultancy Activities",large,1,496,371,125,1235,1235,0
2022,1,Qassim Region,"Head Office Activities, Management Consultancy Activities",micro,12,6,5,1,20,20,0
2022,1,Al Madinah Region,"Head Office Activities, Management Consultancy Activities",small,4,11,7,4,26,26,0
2022,1,Al Madinah Region,"Head Office Activities, Management Consultancy Activities",micro,26,13,5,8,34,34,0
2022,1,Al Madinah Region,"Head Office Activities, Management Consultancy Activities",medium,1,131,94,37,1,1,0
2022,1,Tabuk Region,"Head Office Activities, Management Consultancy Activities",micro,4,2,1,1,2,2,0
2022,1,Jazan Region,"Head Office Activities, Management Consultancy Activities",small,3,13,6,7,8,8,0
2022,1,Jazan Region,"Head Office Activities, Management Consultancy Activities",micro,4,4,0,4,7,7,0
2022,1,Jazan Region,"Head Office Activities, Management Consultancy Activities",medium,1,35,26,9,42,42,0
2022,1,Hail Region,"Head Office Activities, Management Consultancy Activities",micro,7,3,2,1,15,15,0
2022,1,Aseer Region,"Head Office Activities, Management Consultancy Activities",micro,17,11,4,7,24,23,1
2022,1,Makkah Region,"Head Office Activities, Management Consultancy Activities",small,73,337,188,149,515,482,33
2022,1,Makkah Region,"Head Office Activities, Management Consultancy Activities",large,1,659,331,328,834,793,41
2022,1,Makkah Region,"Head Office Activities, Management Consultancy Activities",micro,218,185,90,95,303,289,14
2022,1,Makkah Region,"Head Office Activities, Management Consultancy Activities",medium,5,164,115,49,341,320,21
2022,1,Najran Region,"Head Office Activities, Management Consultancy Activities",small,1,0,0,0,8,8,0
2022,1,Najran Region,"Head Office Activities, Management Consultancy Activities",micro,3,0,0,0,8,8,0
2022,1,Eastern Province,"Architectural and Engineering Activities, Technical Testing, and Analysis",small,236,1459,944,515,2310,2282,28
2022,1,Eastern Province,"Architectural and Engineering Activities, Technical Testing, and Analysis",large,25,5244,4320,924,7095,7073,22
2022,1,Eastern Province,"Architectural and Engineering Activities, Technical Testing, and Analysis",micro,398,340,197,143,609,599,10
2022,1,Eastern Province,"Architectural and Engineering Activities, Technical Testing, and Analysis",medium,63,2484,1901,583,4056,4040,16
2022,1,Al Bahah Region,"Architectural and Engineering Activities, Technical Testing, and Analysis",small,14,45,30,15,156,156,0
2022,1,Al Bahah Region,"Architectural and Engineering Activities, Technical Testing, and Analysis",micro,93,21,14,7,182,182,0
2022,1,Al Bahah Region,"Architectural and Engineering Activities, Technical Testing, and Analysis",medium,1,28,19,9,64,63,1
2022,1,Al Jawf Region,"Architectural and Engineering Activities, Technical Testing, and Analysis",small,21,53,42,11,201,200,1
2022,1,Al Jawf Region,"Architectural and Engineering Activities, Technical Testing, and Analysis",micro,79,20,14,6,150,150,0
2022,1,Al Jawf Region,"Architectural and Engineering Activities, Technical Testing, and Analysis",medium,1,18,14,4,45,45,0
2022,1,Northern Borders Region,"Architectural and Engineering Activities, Technical Testing, and Analysis",small,8,15,8,7,67,66,1
2022,1,Northern Borders Region,"Architectural and Engineering Activities, Technical Testing, and Analysis",micro,56,12,7,5,113,113,0
2022,1,Riyadh Region,"Architectural and Engineering Activities, Technical Testing, and Analysis",small,448,2592,1558,1034,4636,4566,70
2022,1,Riyadh Region,"Architectural and Engineering Activities, Technical Testing, and Analysis",large,22,4679,3565,1114,7163,7107,56
2022,1,Riyadh Region,"Architectural and Engineering Activities, Technical Testing, and Analysis",micro,2432,732,383,349,4236,4190,46
2022,1,Riyadh Region,"Architectural and Engineering Activities, Technical Testing, and Analysis",medium,104,4740,3142,1598,7129,7044,85
2022,1,Qassim Region,"Architectural and Engineering Activities, Technical Testing, and Analysis",small,36,168,118,50,413,412,1
2022,1,Qassim Region,"Architectural and Engineering Activities, Technical Testing, and Analysis",micro,151,57,37,20,274,274,0
2022,1,Qassim Region,"Architectural and Engineering Activities, Technical Testing, and Analysis",medium,7,194,157,37,397,396,1
2022,1,Al Madinah Region,"Architectural and Engineering Activities, Technical Testing, and Analysis",small,63,288,167,121,580,574,6
2022,1,Al Madinah Region,"Architectural and Engineering Activities, Technical Testing, and Analysis",large,1,129,70,59,179,178,1
2022,1,Al Madinah Region,"Architectural and Engineering Activities, Technical Testing, and Analysis",micro,121,57,30,27,219,217,2
2022,1,Al Madinah Region,"Architectural and Engineering Activities, Technical Testing, and Analysis",medium,4,158,137,21,225,224,1
2022,1,Tabuk Region,"Architectural and Engineering Activities, Technical Testing, and Analysis",small,19,93,58,35,161,158,3
2022,1,Tabuk Region,"Architectural and Engineering Activities, Technical Testing, and Analysis",micro,58,35,24,11,118,118,0
2022,1,Tabuk Region,"Architectural and Engineering Activities, Technical Testing, and Analysis",medium,1,27,18,9,57,57,0
2022,1,Jazan Region,"Architectural and Engineering Activities, Technical Testing, and Analysis",small,18,87,54,33,127,126,1
2022,1,Jazan Region,"Architectural and Engineering Activities, Technical Testing, and Analysis",micro,89,52,29,23,142,137,5
2022,1,Jazan Region,"Architectural and Engineering Activities, Technical Testing, and Analysis",medium,1,37,19,18,60,60,0
2022,1,Hail Region,"Architectural and Engineering Activities, Technical Testing, and Analysis",small,16,66,43,23,148,148,0
2022,1,Hail Region,"Architectural and Engineering Activities, Technical Testing, and Analysis",micro,130,32,21,11,238,237,1
2022,1,Hail Region,"Architectural and Engineering Activities, Technical Testing, and Analysis",medium,2,50,41,9,130,130,0
2022,1,Aseer Region,"Architectural and Engineering Activities, Technical Testing, and Analysis",small,45,163,103,60,325,321,4
2022,1,Aseer Region,"Architectural and Engineering Activities, Technical Testing, and Analysis",micro,169,108,74,34,297,295,2
2022,1,Aseer Region,"Architectural and Engineering Activities, Technical Testing, and Analysis",medium,2,63,55,8,118,117,1
2022,1,Makkah Region,"Architectural and Engineering Activities, Technical Testing, and Analysis",small,367,1601,945,656,3284,3245,39
2022,1,Makkah Region,"Architectural and Engineering Activities, Technical Testing, and Analysis",large,11,1448,958,490,3169,3154,15
2022,1,Makkah Region,"Architectural and Engineering Activities, Technical Testing, and Analysis",micro,790,488,268,220,1375,1352,23
2022,1,Makkah Region,"Architectural and Engineering Activities, Technical Testing, and Analysis",medium,25,686,455,231,1469,1462,7
2022,1,Najran Region,"Architectural and Engineering Activities, Technical Testing, and Analysis",small,14,59,44,15,116,116,0
2022,1,Najran Region,"Architectural and Engineering Activities, Technical Testing, and Analysis",micro,127,29,19,10,225,225,0
2022,1,Najran Region,"Architectural and Engineering Activities, Technical Testing, and Analysis",medium,1,30,22,8,78,78,0
2022,1,Eastern Province,"Treatment and Disposal of Non-Hazardous Waste, Other Waste Management Services",small,5,29,19,10,99,99,0
2022,1,Eastern Province,"Treatment and Disposal of Non-Hazardous Waste, Other Waste Management Services",micro,4,4,2,2,5,5,0
2022,1,Riyadh Region,"Treatment and Disposal of Non-Hazardous Waste, Other Waste Management Services",small,2,20,19,1,17,17,0
2022,1,Riyadh Region,"Treatment and Disposal of Non-Hazardous Waste, Other Waste Management Services",micro,3,2,1,1,7,7,0
2022,1,Riyadh Region,"Treatment and Disposal of Non-Hazardous Waste, Other Waste Management Services",medium,1,2,2,0,87,87,0
2022,1,Makkah Region,"Treatment and Disposal of Non-Hazardous Waste, Other Waste Management Services",small,1,4,2,2,15,15,0
2022,1,Makkah Region,"Treatment and Disposal of Non-Hazardous Waste, Other Waste Management Services",micro,2,2,1,1,2,2,0
2022,1,Najran Region,"Treatment and Disposal of Non-Hazardous Waste, Other Waste Management Services",small,1,2,1,1,20,20,0
2022,1,Eastern Province,Social Work Activities Without Accommodation,small,159,1820,320,1500,438,371,67
2022,1,Eastern Province,Social Work Activities Without Accommodation,large,2,293,136,157,364,258,106
2022,1,Eastern Province,Social Work Activities Without Accommodation,micro,171,321,56,265,105,93,12
2022,1,Eastern Province,Social Work Activities Without Accommodation,medium,15,981,293,688,320,217,103
2022,1,Al Bahah Region,Social Work Activities Without Accommodation,small,24,249,125,124,55,55,0
2022,1,Al Bahah Region,Social Work Activities Without Accommodation,micro,38,74,63,11,41,41,0
2022,1,Al Jawf Region,Social Work Activities Without Accommodation,small,21,194,114,80,107,99,8
2022,1,Al Jawf Region,Social Work Activities Without Accommodation,micro,20,37,22,15,13,13,0
2022,1,Northern Borders Region,Social Work Activities Without Accommodation,small,12,112,45,67,33,31,2
2022,1,Northern Borders Region,Social Work Activities Without Accommodation,micro,22,33,22,11,23,22,1
2022,1,Riyadh Region,Social Work Activities Without Accommodation,small,257,2490,715,1775,1483,1327,156
2022,1,Riyadh Region,Social Work Activities Without Accommodation,large,10,4020,2069,1951,1864,1445,419
2022,1,Riyadh Region,Social Work Activities Without Accommodation,micro,390,511,216,295,438,408,30
2022,1,Riyadh Region,Social Work Activities Without Accommodation,medium,35,2743,1538,1205,1070,914,156
2022,1,Qassim Region,Social Work Activities Without Accommodation,small,66,673,312,361,305,289,16
2022,1,Qassim Region,Social Work Activities Without Accommodation,micro,82,126,84,42,94,93,1
2022,1,Qassim Region,Social Work Activities Without Accommodation,medium,5,315,143,172,184,143,41
2022,1,Al Madinah Region,Social Work Activities Without Accommodation,small,67,653,345,308,217,189,28
2022,1,Al Madinah Region,Social Work Activities Without Accommodation,large,1,556,330,226,27,19,8
2022,1,Al Madinah Region,Social Work Activities Without Accommodation,micro,145,265,159,106,112,101,11
2022,1,Al Madinah Region,Social Work Activities Without Accommodation,medium,13,683,316,367,266,228,38
2022,1,Tabuk Region,Social Work Activities Without Accommodation,small,10,88,47,41,21,20,1
2022,1,Tabuk Region,Social Work Activities Without Accommodation,micro,33,87,57,30,15,15,0
2022,1,Tabuk Region,Social Work Activities Without Accommodation,medium,2,124,62,62,165,158,7
2022,1,Jazan Region,Social Work Activities Without Accommodation,small,28,218,136,82,65,62,3
2022,1,Jazan Region,Social Work Activities Without Accommodation,micro,71,104,70,34,61,60,1
2022,1,Jazan Region,Social Work Activities Without Accommodation,medium,3,115,32,83,70,65,5
2022,1,Hail Region,Social Work Activities Without Accommodation,small,22,243,93,150,64,60,4
2022,1,Hail Region,Social Work Activities Without Accommodation,micro,68,103,66,37,63,62,1
2022,1,Aseer Region,Social Work Activities Without Accommodation,small,55,396,195,201,268,257,11
2022,1,Aseer Region,Social Work Activities Without Accommodation,micro,107,217,158,59,66,66,0
2022,1,Aseer Region,Social Work Activities Without Accommodation,medium,5,213,55,158,104,90,14
2022,1,Makkah Region,Social Work Activities Without Accommodation,small,248,2459,766,1693,1304,1006,298
2022,1,Makkah Region,Social Work Activities Without Accommodation,micro,366,521,238,283,340,306,34
2022,1,Makkah Region,Social Work Activities Without Accommodation,medium,21,1235,653,582,872,779,93
2022,1,Najran Region,Social Work Activities Without Accommodation,small,7,39,22,17,76,76,0
2022,1,Najran Region,Social Work Activities Without Accommodation,micro,33,50,28,22,41,40,1
2022,1,Eastern Province,"Financial Service Activities, Except Insurance and Pension Funding",small,81,488,304,184,772,771,1
2022,1,Eastern Province,"Financial Service Activities, Except Insurance and Pension Funding",large,2,669,410,259,119,105,14
2022,1,Eastern Province,"Financial Service Activities, Except Insurance and Pension Funding",micro,195,141,81,60,302,295,7
2022,1,Eastern Province,"Financial Service Activities, Except Insurance and Pension Funding",medium,27,1279,845,434,1178,1160,18
2022,1,Al Bahah Region,"Financial Service Activities, Except Insurance and Pension Funding",small,1,6,3,3,13,13,0
2022,1,Al Bahah Region,"Financial Service Activities, Except Insurance and Pension Funding",micro,8,3,2,1,13,13,0
2022,1,Al Jawf Region,"Financial Service Activities, Except Insurance and Pension Funding",micro,10,3,1,2,19,19,0
2022,1,Northern Borders Region,"Financial Service Activities, Except Insurance and Pension Funding",small,5,4,2,2,50,50,0
2022,1,Northern Borders Region,"Financial Service Activities, Except Insurance and Pension Funding",micro,6,4,0,4,9,9,0
2022,1,Riyadh Region,"Financial Service Activities, Except Insurance and Pension Funding",small,181,1377,869,508,1456,1416,40
2022,1,Riyadh Region,"Financial Service Activities, Except Insurance and Pension Funding",large,8,7395,5552,1843,964,945,19
2022,1,Riyadh Region,"Financial Service Activities, Except Insurance and Pension Funding",micro,400,388,247,141,548,538,10
2022,1,Riyadh Region,"Financial Service Activities, Except Insurance and Pension Funding",medium,35,2464,1740,724,1134,1033,101
2022,1,Qassim Region,"Financial Service Activities, Except Insurance and Pension Funding",small,3,39,39,0,14,14,0
2022,1,Qassim Region,"Financial Service Activities, Except Insurance and Pension Funding",micro,25,5,4,1,63,63,0
2022,1,Al Madinah Region,"Financial Service Activities, Except Insurance and Pension Funding",small,6,27,23,4,45,45,0
2022,1,Al Madinah Region,"Financial Service Activities, Except Insurance and Pension Funding",micro,43,28,14,14,77,73,4
2022,1,Al Madinah Region,"Financial Service Activities, Except Insurance and Pension Funding",medium,1,48,40,8,53,53,0
2022,1,Tabuk Region,"Financial Service Activities, Except Insurance and Pension Funding",micro,17,4,2,2,35,35,0
2022,1,Jazan Region,"Financial Service Activities, Except Insurance and Pension Funding",small,3,13,12,1,13,13,0
2022,1,Jazan Region,"Financial Service Activities, Except Insurance and Pension Funding",micro,19,3,3,0,50,50,0
2022,1,Hail Region,"Financial Service Activities, Except Insurance and Pension Funding",small,3,12,12,0,10,10,0
2022,1,Hail Region,"Financial Service Activities, Except Insurance and Pension Funding",micro,23,3,2,1,55,55,0
2022,1,Aseer Region,"Financial Service Activities, Except Insurance and Pension Funding",small,7,42,18,24,74,74,0
2022,1,Aseer Region,"Financial Service Activities, Except Insurance and Pension Funding",micro,26,17,9,8,46,46,0
2022,1,Makkah Region,"Financial Service Activities, Except Insurance and Pension Funding",small,143,775,451,324,1351,1302,49
2022,1,Makkah Region,"Financial Service Activities, Except Insurance and Pension Funding",large,3,12308,10596,1712,448,448,0
2022,1,Makkah Region,"Financial Service Activities, Except Insurance and Pension Funding",micro,324,199,127,72,607,590,17
2022,1,Makkah Region,"Financial Service Activities, Except Insurance and Pension Funding",medium,21,1053,700,353,841,830,11
2022,1,Najran Region,"Financial Service Activities, Except Insurance and Pension Funding",small,1,2,0,2,4,4,0
2022,1,Najran Region,"Financial Service Activities, Except Insurance and Pension Funding",micro,15,3,2,1,36,36,0
2022,1,Eastern Province,Other Personal Service Activities,small,663,1447,413,1034,5765,4210,1555
2022,1,Eastern Province,Other Personal Service Activities,large,1,280,130,150,2261,2261,0
2022,1,Eastern Province,Other Personal Service Activities,micro,5222,1203,460,743,11058,10057,1001
2022,1,Eastern Province,Other Personal Service Activities,medium,16,399,149,250,1228,1180,48
2022,1,Al Bahah Region,Other Personal Service Activities,small,14,18,13,5,99,93,6
2022,1,Al Bahah Region,Other Personal Service Activities,micro,361,59,38,21,758,722,36
2022,1,Al Jawf Region,Other Personal Service Activities,small,47,58,41,17,351,324,27
2022,1,Al Jawf Region,Other Personal Service Activities,micro,638,87,48,39,1281,1194,87
2022,1,Al Jawf Region,Other Personal Service Activities,medium,2,22,16,6,112,111,1
2022,1,Northern Borders Region,Other Personal Service Activities,small,25,35,14,21,228,183,45
2022,1,Northern Borders Region,Other Personal Service Activities,micro,495,60,28,32,1130,1079,51
2022,1,Riyadh Region,Other Personal Service Activities,small,1166,2746,651,2095,10568,7666,2902
2022,1,Riyadh Region,Other Personal Service Activities,large,5,2271,1456,815,1480,1016,464
2022,1,Riyadh Region,Other Personal Service Activities,micro,8363,2013,700,1313,17347,15420,1927
2022,1,Riyadh Region,Other Personal Service Activities,medium,40,776,173,603,2732,2124,608
2022,1,Qassim Region,Other Personal Service Activities,small,127,182,50,132,1169,864,305
2022,1,Qassim Region,Other Personal Service Activities,micro,1715,229,111,118,3846,3551,295
2022,1,Qassim Region,Other Personal Service Activities,medium,8,74,34,40,574,514,60
2022,1,Al Madinah Region,Other Personal Service Activities,small,165,337,106,231,1350,986,364
2022,1,Al Madinah Region,Other Personal Service Activities,micro,2357,337,171,166,4789,4490,299
2022,1,Al Madinah Region,Other Personal Service Activities,medium,1,9,6,3,44,44,0
2022,1,Tabuk Region,Other Personal Service Activities,small,67,101,36,65,547,471,76
2022,1,Tabuk Region,Other Personal Service Activities,micro,1192,161,74,87,2445,2348,97
2022,1,Tabuk Region,Other Personal Service Activities,medium,1,0,0,0,50,50,0
2022,1,Jazan Region,Other Personal Service Activities,small,77,198,77,121,540,436,104
2022,1,Jazan Region,Other Personal Service Activities,micro,1635,217,121,96,3632,3498,134
2022,1,Jazan Region,Other Personal Service Activities,medium,2,37,36,1,201,201,0
2022,1,Hail Region,Other Personal Service Activities,small,64,124,32,92,554,422,132
2022,1,Hail Region,Other Personal Service Activities,micro,940,130,65,65,2088,1941,147
2022,1,Hail Region,Other Personal Service Activities,medium,2,59,11,48,103,51,52
2022,1,Aseer Region,Other Personal Service Activities,small,124,209,98,111,1034,941,93
2022,1,Aseer Region,Other Personal Service Activities,micro,2030,323,146,177,4238,4013,225
2022,1,Aseer Region,Other Personal Service Activities,medium,1,11,7,4,40,40,0
2022,1,Makkah Region,Other Personal Service Activities,small,758,1682,438,1244,6669,4768,1901
2022,1,Makkah Region,Other Personal Service Activities,large,2,290,203,87,262,35,227
2022,1,Makkah Region,Other Personal Service Activities,micro,7613,1557,660,897,15761,14278,1483
2022,1,Makkah Region,Other Personal Service Activities,medium,17,308,85,223,949,527,422
2022,1,Najran Region,Other Personal Service Activities,small,31,32,10,22,235,206,29
2022,1,Najran Region,Other Personal Service Activities,micro,715,117,47,70,1622,1513,109
2022,1,Eastern Province,Specialized Construction Activities,small,1662,4372,2474,1898,21028,20966,62
2022,1,Eastern Province,Specialized Construction Activities,large,84,15035,12265,2770,73067,72994,73
2022,1,Eastern Province,Specialized Construction Activities,micro,5295,1693,806,887,11347,11326,21
2022,1,Eastern Province,Specialized Construction Activities,medium,228,4666,3063,1603,18815,18775,40
2022,1,Al Bahah Region,Specialized Construction Activities,small,44,71,46,25,433,430,3
2022,1,Al Bahah Region,Specialized Construction Activities,large,1,32,18,14,250,250,0
2022,1,Al Bahah Region,Specialized Construction Activities,micro,391,75,51,24,840,838,2
2022,1,Al Bahah Region,Specialized Construction Activities,medium,3,68,45,23,236,236,0
2022,1,Al Jawf Region,Specialized Construction Activities,small,86,145,98,47,875,866,9
2022,1,Al Jawf Region,Specialized Construction Activities,micro,608,93,65,28,1336,1332,4
2022,1,Al Jawf Region,Specialized Construction Activities,medium,4,49,30,19,297,296,1
2022,1,Northern Borders Region,Specialized Construction Activities,small,35,70,45,25,355,355,0
2022,1,Northern Borders Region,Specialized Construction Activities,micro,373,71,43,28,871,871,0
2022,1,Northern Borders Region,Specialized Construction Activities,medium,1,5,5,0,94,94,0
2022,1,Riyadh Region,Specialized Construction Activities,small,2831,7790,3575,4215,36233,35924,309
2022,1,Riyadh Region,Specialized Construction Activities,large,130,32508,24246,8262,104123,102175,1948
2022,1,Riyadh Region,Specialized Construction Activities,micro,10255,2897,1312,1585,22677,22483,194
2022,1,Riyadh Region,Specialized Construction Activities,medium,454,8650,4852,3798,37562,37377,185
2022,1,Qassim Region,Specialized Construction Activities,small,396,570,336,234,4694,4679,15
2022,1,Qassim Region,Specialized Construction Activities,large,8,821,576,245,4634,4412,222
2022,1,Qassim Region,Specialized Construction Activities,micro,2467,444,248,196,5697,5675,22
2022,1,Qassim Region,Specialized Construction Activities,medium,53,374,246,128,4744,4742,2
2022,1,Al Madinah Region,Specialized Construction Activities,small,345,641,361,280,3634,3618,16
2022,1,Al Madinah Region,Specialized Construction Activities,large,6,758,555,203,4290,4124,166
2022,1,Al Madinah Region,Specialized Construction Activities,micro,2285,487,302,185,5167,5144,23
2022,1,Al Madinah Region,Specialized Construction Activities,medium,26,439,262,177,1879,1874,5
2022,1,Tabuk Region,Specialized Construction Activities,small,71,158,89,69,642,642,0
2022,1,Tabuk Region,Specialized Construction Activities,large,1,83,75,8,536,536,0
2022,1,Tabuk Region,Specialized Construction Activities,micro,1123,198,99,99,2609,2607,2
2022,1,Tabuk Region,Specialized Construction Activities,medium,5,61,31,30,301,301,0
2022,1,Jazan Region,Specialized Construction Activities,small,91,195,96,99,895,882,13
2022,1,Jazan Region,Specialized Construction Activities,micro,1616,253,147,106,3748,3737,11
2022,1,Jazan Region,Specialized Construction Activities,medium,2,26,25,1,282,282,0
2022,1,Hail Region,Specialized Construction Activities,small,132,191,82,109,1320,1316,4
2022,1,Hail Region,Specialized Construction Activities,large,2,177,128,49,810,806,4
2022,1,Hail Region,Specialized Construction Activities,micro,1045,155,70,85,2421,2414,7
2022,1,Hail Region,Specialized Construction Activities,medium,9,164,124,40,654,654,0
2022,1,Aseer Region,Specialized Construction Activities,small,307,642,403,239,2980,2953,27
2022,1,Aseer Region,Specialized Construction Activities,large,3,558,173,385,2102,2102,0
2022,1,Aseer Region,Specialized Construction Activities,micro,2407,420,240,180,5099,5087,12
2022,1,Aseer Region,Specialized Construction Activities,medium,20,424,324,100,1444,1434,10
2022,1,Makkah Region,Specialized Construction Activities,small,1844,4441,2233,2208,21774,21607,167
2022,1,Makkah Region,Specialized Construction Activities,large,48,4958,3525,1433,24571,24442,129
2022,1,Makkah Region,Specialized Construction Activities,micro,9174,2285,1112,1173,19856,19649,207
2022,1,Makkah Region,Specialized Construction Activities,medium,201,3751,2428,1323,16650,16582,68
2022,1,Najran Region,Specialized Construction Activities,small,152,241,143,98,1647,1629,18
2022,1,Najran Region,Specialized Construction Activities,large,4,202,131,71,1097,1097,0
2022,1,Najran Region,Specialized Construction Activities,micro,1127,146,70,76,2484,2469,15
2022,1,Najran Region,Specialized Construction Activities,medium,10,244,171,73,872,872,0
2022,1,Eastern Province,Postal and Courier Activities,small,7,34,15,19,37,37,0
2022,1,Eastern Province,Postal and Courier Activities,micro,33,27,11,16,39,39,0
2022,1,Eastern Province,Postal and Courier Activities,medium,2,61,23,38,92,91,1
2022,1,Al Jawf Region,Postal and Courier Activities,micro,2,2,2,0,3,3,0
2022,1,Riyadh Region,Postal and Courier Activities,small,82,406,180,226,870,856,14
2022,1,Riyadh Region,Postal and Courier Activities,large,5,1104,592,512,1733,1706,27
2022,1,Riyadh Region,Postal and Courier Activities,micro,224,176,92,84,358,347,11
2022,1,Riyadh Region,Postal and Courier Activities,medium,6,125,67,58,342,332,10
2022,1,Qassim Region,Postal and Courier Activities,micro,9,1,0,1,28,28,0
2022,1,Al Madinah Region,Postal and Courier Activities,small,2,0,0,0,15,15,0
2022,1,Al Madinah Region,Postal and Courier Activities,micro,11,5,3,2,25,25,0
2022,1,Tabuk Region,Postal and Courier Activities,micro,7,1,0,1,12,11,1
2022,1,Jazan Region,Postal and Courier Activities,micro,2,0,0,0,3,3,0
2022,1,Hail Region,Postal and Courier Activities,micro,2,1,0,1,8,8,0
2022,1,Aseer Region,Postal and Courier Activities,small,2,33,31,2,9,8,1
2022,1,Aseer Region,Postal and Courier Activities,micro,10,4,3,1,24,24,0
2022,1,Makkah Region,Postal and Courier Activities,small,11,66,27,39,143,140,3
2022,1,Makkah Region,Postal and Courier Activities,micro,64,54,25,29,98,95,3
2022,1,Makkah Region,Postal and Courier Activities,medium,1,13,0,13,38,38,0
2022,1,Najran Region,Postal and Courier Activities,micro,1,0,0,0,1,1,0
2022,1,Eastern Province,Programming and Broadcasting Activities,small,3,10,5,5,25,25,0
2022,1,Eastern Province,Programming and Broadcasting Activities,micro,9,7,3,4,21,20,1
2022,1,Al Jawf Region,Programming and Broadcasting Activities,micro,1,0,0,0,1,1,0
2022,1,Riyadh Region,Programming and Broadcasting Activities,small,10,27,12,15,73,72,1
2022,1,Riyadh Region,Programming and Broadcasting Activities,micro,53,40,19,21,94,93,1
2022,1,Riyadh Region,Programming and Broadcasting Activities,medium,2,55,28,27,87,80,7
2022,1,Qassim Region,Programming and Broadcasting Activities,micro,2,0,0,0,5,5,0
2022,1,Al Madinah Region,Programming and Broadcasting Activities,micro,2,0,0,0,9,9,0
2022,1,Tabuk Region,Programming and Broadcasting Activities,micro,2,1,0,1,8,8,0
2022,1,Jazan Region,Programming and Broadcasting Activities,micro,1,1,0,1,4,4,0
2022,1,Hail Region,Programming and Broadcasting Activities,micro,1,2,1,1,3,3,0
2022,1,Aseer Region,Programming and Broadcasting Activities,micro,8,4,4,0,14,14,0
2022,1,Makkah Region,Programming and Broadcasting Activities,small,14,73,45,28,113,108,5
2022,1,Makkah Region,Programming and Broadcasting Activities,micro,19,7,5,2,40,37,3
2022,1,Makkah Region,Programming and Broadcasting Activities,medium,1,55,29,26,72,72,0
2022,1,Najran Region,Programming and Broadcasting Activities,micro,1,1,1,0,4,4,0
2022,1,Eastern Province,"Computer Programming, Consultancy, and Related Activities",small,100,668,359,309,866,855,11
2022,1,Eastern Province,"Computer Programming, Consultancy, and Related Activities",large,3,938,834,104,732,727,5
2022,1,Eastern Province,"Computer Programming, Consultancy, and Related Activities",micro,243,207,107,100,323,319,4
2022,1,Eastern Province,"Computer Programming, Consultancy, and Related Activities",medium,11,483,295,188,492,483,9
2022,1,Al Bahah Region,"Computer Programming, Consultancy, and Related Activities",micro,1,1,0,1,2,2,0
2022,1,Al Jawf Region,"Computer Programming, Consultancy, and Related Activities",micro,14,5,4,1,27,27,0
2022,1,Northern Borders Region,"Computer Programming, Consultancy, and Related Activities",micro,5,2,2,0,13,13,0
2022,1,Riyadh Region,"Computer Programming, Consultancy, and Related Activities",small,572,3868,1967,1901,5339,5148,191
2022,1,Riyadh Region,"Computer Programming, Consultancy, and Related Activities",large,23,13046,8407,4639,6913,6630,283
2022,1,Riyadh Region,"Computer Programming, Consultancy, and Related Activities",micro,1230,940,442,498,1847,1794,53
2022,1,Riyadh Region,"Computer Programming, Consultancy, and Related Activities",medium,98,4944,2870,2074,4852,4734,118
2022,1,Qassim Region,"Computer Programming, Consultancy, and Related Activities",small,19,90,50,40,180,169,11
2022,1,Qassim Region,"Computer Programming, Consultancy, and Related Activities",micro,67,20,9,11,145,145,0
2022,1,Al Madinah Region,"Computer Programming, Consultancy, and Related Activities",small,7,29,12,17,47,47,0
2022,1,Al Madinah Region,"Computer Programming, Consultancy, and Related Activities",micro,78,36,15,21,138,134,4
2022,1,Al Madinah Region,"Computer Programming, Consultancy, and Related Activities",medium,1,33,32,1,22,22,0
2022,1,Tabuk Region,"Computer Programming, Consultancy, and Related Activities",micro,19,10,4,6,34,34,0
2022,1,Jazan Region,"Computer Programming, Consultancy, and Related Activities",small,1,3,3,0,7,7,0
2022,1,Jazan Region,"Computer Programming, Consultancy, and Related Activities",micro,24,5,3,2,61,61,0
2022,1,Hail Region,"Computer Programming, Consultancy, and Related Activities",small,3,5,1,4,29,29,0
2022,1,Hail Region,"Computer Programming, Consultancy, and Related Activities",micro,14,7,4,3,29,29,0
2022,1,Aseer Region,"Computer Programming, Consultancy, and Related Activities",small,9,19,11,8,62,61,1
2022,1,Aseer Region,"Computer Programming, Consultancy, and Related Activities",micro,47,16,11,5,95,94,1
2022,1,Makkah Region,"Computer Programming, Consultancy, and Related Activities",small,147,664,331,333,1277,1229,48
2022,1,Makkah Region,"Computer Programming, Consultancy, and Related Activities",large,2,686,649,37,329,326,3
2022,1,Makkah Region,"Computer Programming, Consultancy, and Related Activities",micro,472,288,132,156,766,745,21
2022,1,Makkah Region,"Computer Programming, Consultancy, and Related Activities",medium,14,476,229,247,669,622,47
2022,1,Najran Region,"Computer Programming, Consultancy, and Related Activities",micro,10,1,0,1,22,22,0
2022,1,Eastern Province,Public Order and Safety Activities,small,21,427,369,58,41,41,0
2022,1,Eastern Province,Public Order and Safety Activities,large,7,4006,3737,269,1,1,0
2022,1,Eastern Province,Public Order and Safety Activities,micro,42,55,49,6,47,47,0
2022,1,Eastern Province,Public Order and Safety Activities,medium,15,1535,1417,118,68,68,0
2022,1,Al Jawf Region,Public Order and Safety Activities,small,2,63,46,17,0,0,0
2022,1,Al Jawf Region,Public Order and Safety Activities,micro,1,3,3,0,0,0,0
2022,1,Northern Borders Region,Public Order and Safety Activities,small,2,15,12,3,7,4,3
2022,1,Northern Borders Region,Public Order and Safety Activities,large,1,0,0,0,338,338,0
2022,1,Northern Borders Region,Public Order and Safety Activities,medium,1,201,153,48,0,0,0
2022,1,Riyadh Region,Public Order and Safety Activities,small,45,571,502,69,203,202,1
2022,1,Riyadh Region,Public Order and Safety Activities,large,18,16428,14718,1710,341,340,1
2022,1,Riyadh Region,Public Order and Safety Activities,micro,100,119,83,36,112,112,0
2022,1,Riyadh Region,Public Order and Safety Activities,medium,23,3097,2719,378,157,151,6
2022,1,Qassim Region,Public Order and Safety Activities,small,6,94,87,7,17,17,0
2022,1,Qassim Region,Public Order and Safety Activities,micro,12,7,6,1,18,18,0
2022,1,Al Madinah Region,Public Order and Safety Activities,small,3,57,53,4,22,22,0
2022,1,Al Madinah Region,Public Order and Safety Activities,micro,10,6,5,1,7,7,0
2022,1,Al Madinah Region,Public Order and Safety Activities,medium,2,267,234,33,45,42,3
2022,1,Tabuk Region,Public Order and Safety Activities,micro,3,1,1,0,3,3,0
2022,1,Jazan Region,Public Order and Safety Activities,small,2,24,21,3,11,9,2
2022,1,Jazan Region,Public Order and Safety Activities,micro,7,4,4,0,14,14,0
2022,1,Hail Region,Public Order and Safety Activities,small,1,10,10,0,0,0,0
2022,1,Hail Region,Public Order and Safety Activities,micro,6,2,1,1,9,9,0
2022,1,Aseer Region,Public Order and Safety Activities,small,2,40,39,1,0,0,0
2022,1,Aseer Region,Public Order and Safety Activities,large,2,1855,1806,49,0,0,0
2022,1,Aseer Region,Public Order and Safety Activities,micro,7,9,7,2,2,2,0
2022,1,Aseer Region,Public Order and Safety Activities,medium,2,150,142,8,0,0,0
2022,1,Makkah Region,Public Order and Safety Activities,small,31,316,255,61,49,48,1
2022,1,Makkah Region,Public Order and Safety Activities,large,6,2224,2001,223,1,1,0
2022,1,Makkah Region,Public Order and Safety Activities,micro,52,63,50,13,48,45,3
2022,1,Makkah Region,Public Order and Safety Activities,medium,10,1231,1093,138,5,5,0
2022,1,Najran Region,Public Order and Safety Activities,large,1,346,311,35,0,0,0
2022,1,Najran Region,Public Order and Safety Activities,micro,2,1,1,0,3,3,0
2022,1,Eastern Province,Activities of Households as Employers of Domestic Personnel,micro,9,2,2,0,16,16,0
2022,1,Al Bahah Region,Activities of Households as Employers of Domestic Personnel,micro,1,0,0,0,1,1,0
2022,1,Riyadh Region,Activities of Households as Employers of Domestic Personnel,micro,10,1,1,0,18,17,1
2022,1,Qassim Region,Activities of Households as Employers of Domestic Personnel,micro,7,1,1,0,17,16,1
2022,1,Al Madinah Region,Activities of Households as Employers of Domestic Personnel,micro,2,1,0,1,3,3,0
2022,1,Hail Region,Activities of Households as Employers of Domestic Personnel,micro,3,0,0,0,5,5,0
2022,1,Aseer Region,Activities of Households as Employers of Domestic Personnel,small,1,0,0,0,7,7,0
2022,1,Aseer Region,Activities of Households as Employers of Domestic Personnel,micro,1,0,0,0,1,1,0
2022,1,Makkah Region,Activities of Households as Employers of Domestic Personnel,micro,2,0,0,0,2,2,0
2022,1,Najran Region,Activities of Households as Employers of Domestic Personnel,micro,1,0,0,0,1,1,0
2022,1,Eastern Province,Extraction of Natural Gas,small,65,237,134,103,507,461,46
2022,1,Eastern Province,Extraction of Natural Gas,large,17,607,446,161,36318,28134,8184
2022,1,Eastern Province,Extraction of Natural Gas,micro,257,300,179,121,339,306,33
2022,1,Eastern Province,Extraction of Natural Gas,medium,15,52,24,28,1989,980,1009
2022,1,Al Bahah Region,Extraction of Natural Gas,micro,12,8,5,3,20,20,0
2022,1,Al Jawf Region,Extraction of Natural Gas,small,4,20,11,9,17,17,0
2022,1,Al Jawf Region,Extraction of Natural Gas,micro,21,24,11,13,19,19,0
2022,1,Northern Borders Region,Extraction of Natural Gas,small,5,16,2,14,43,13,30
2022,1,Northern Borders Region,Extraction of Natural Gas,micro,13,7,4,3,19,19,0
2022,1,Riyadh Region,Extraction of Natural Gas,small,179,906,362,544,1306,1085,221
2022,1,Riyadh Region,Extraction of Natural Gas,large,51,7954,3048,4906,170771,100347,70424
2022,1,Riyadh Region,Extraction of Natural Gas,micro,696,639,342,297,969,915,54
2022,1,Riyadh Region,Extraction of Natural Gas,medium,26,807,484,323,2658,1600,1058
2022,1,Qassim Region,Extraction of Natural Gas,small,19,60,23,37,173,145,28
2022,1,Qassim Region,Extraction of Natural Gas,micro,56,49,32,17,87,85,2
2022,1,Al Madinah Region,Extraction of Natural Gas,small,12,59,32,27,72,41,31
2022,1,Al Madinah Region,Extraction of Natural Gas,micro,80,78,49,29,114,109,5
2022,1,Tabuk Region,Extraction of Natural Gas,small,6,45,12,33,49,49,0
2022,1,Tabuk Region,Extraction of Natural Gas,micro,39,38,20,18,65,60,5
2022,1,Tabuk Region,Extraction of Natural Gas,medium,1,6,0,6,48,48,0
2022,1,Jazan Region,Extraction of Natural Gas,small,3,4,1,3,19,19,0
2022,1,Jazan Region,Extraction of Natural Gas,micro,32,10,6,4,55,55,0
2022,1,Hail Region,Extraction of Natural Gas,small,11,55,25,30,101,52,49
2022,1,Hail Region,Extraction of Natural Gas,micro,31,30,22,8,50,48,2
2022,1,Aseer Region,Extraction of Natural Gas,small,14,29,14,15,87,39,48
2022,1,Aseer Region,Extraction of Natural Gas,large,3,122,48,74,13143,8912,4231
2022,1,Aseer Region,Extraction of Natural Gas,micro,86,61,38,23,127,118,9
2022,1,Aseer Region,Extraction of Natural Gas,medium,3,91,39,52,409,357,52
2022,1,Makkah Region,Extraction of Natural Gas,small,64,189,103,86,361,337,24
2022,1,Makkah Region,Extraction of Natural Gas,large,7,140,54,86,15855,12523,3332
2022,1,Makkah Region,Extraction of Natural Gas,micro,293,254,147,107,450,432,18
2022,1,Makkah Region,Extraction of Natural Gas,medium,8,212,62,150,673,394,279
2022,1,Najran Region,Extraction of Natural Gas,small,11,10,3,7,98,64,34
2022,1,Najran Region,Extraction of Natural Gas,micro,38,33,16,17,52,46,6
2022,1,Eastern Province,Civil Engineering,small,356,1362,817,545,5002,4985,17
2022,1,Eastern Province,Civil Engineering,large,94,24100,20143,3957,99795,99692,103
2022,1,Eastern Province,Civil Engineering,micro,457,299,162,137,908,904,4
2022,1,Eastern Province,Civil Engineering,medium,152,3289,2451,838,13785,13773,12
2022,1,Al Bahah Region,Civil Engineering,small,6,23,16,7,92,92,0
2022,1,Al Bahah Region,Civil Engineering,large,1,51,45,6,289,289,0
2022,1,Al Bahah Region,Civil Engineering,micro,18,4,2,2,35,35,0
2022,1,Al Bahah Region,Civil Engineering,medium,1,43,43,0,52,52,0
2022,1,Al Jawf Region,Civil Engineering,small,16,54,31,23,192,192,0
2022,1,Al Jawf Region,Civil Engineering,large,1,117,81,36,299,268,31
2022,1,Al Jawf Region,Civil Engineering,micro,40,16,13,3,79,79,0
2022,1,Al Jawf Region,Civil Engineering,medium,6,154,113,41,454,453,1
2022,1,Northern Borders Region,Civil Engineering,small,8,23,18,5,119,119,0
2022,1,Northern Borders Region,Civil Engineering,micro,27,5,2,3,54,54,0
2022,1,Northern Borders Region,Civil Engineering,medium,2,47,23,24,208,208,0
2022,1,Riyadh Region,Civil Engineering,small,610,1992,1026,966,8648,8608,40
2022,1,Riyadh Region,Civil Engineering,large,109,24778,18055,6723,129060,128225,835
2022,1,Riyadh Region,Civil Engineering,micro,1049,463,217,246,2222,2199,23
2022,1,Riyadh Region,Civil Engineering,medium,202,4678,3047,1631,19307,19250,57
2022,1,Qassim Region,Civil Engineering,small,67,213,128,85,932,931,1
2022,1,Qassim Region,Civil Engineering,large,7,1297,851,446,7915,7914,1
2022,1,Qassim Region,Civil Engineering,micro,135,54,30,24,302,300,2
2022,1,Qassim Region,Civil Engineering,medium,20,371,283,88,1767,1757,10
2022,1,Al Madinah Region,Civil Engineering,small,64,211,139,72,790,790,0
2022,1,Al Madinah Region,Civil Engineering,large,9,1032,639,393,3636,3627,9
2022,1,Al Madinah Region,Civil Engineering,micro,146,60,33,27,309,307,2
2022,1,Al Madinah Region,Civil Engineering,medium,20,339,256,83,1339,1338,1
2022,1,Tabuk Region,Civil Engineering,small,17,71,39,32,254,254,0
2022,1,Tabuk Region,Civil Engineering,large,1,69,55,14,341,341,0
2022,1,Tabuk Region,Civil Engineering,micro,45,18,5,13,98,98,0
2022,1,Tabuk Region,Civil Engineering,medium,3,74,55,19,233,233,0
2022,1,Jazan Region,Civil Engineering,small,22,51,32,19,308,306,2
2022,1,Jazan Region,Civil Engineering,large,1,105,84,21,478,478,0
2022,1,Jazan Region,Civil Engineering,micro,86,24,11,13,216,216,0
2022,1,Jazan Region,Civil Engineering,medium,7,224,148,76,808,808,0
2022,1,Hail Region,Civil Engineering,small,25,47,26,21,328,321,7
2022,1,Hail Region,Civil Engineering,large,1,112,94,18,771,771,0
2022,1,Hail Region,Civil Engineering,micro,49,15,9,6,107,107,0
2022,1,Hail Region,Civil Engineering,medium,7,172,130,42,687,662,25
2022,1,Aseer Region,Civil Engineering,small,56,186,120,66,798,796,2
2022,1,Aseer Region,Civil Engineering,large,8,622,533,89,3709,3709,0
2022,1,Aseer Region,Civil Engineering,micro,109,43,26,17,233,233,0
2022,1,Aseer Region,Civil Engineering,medium,17,469,367,102,1827,1827,0
2022,1,Makkah Region,Civil Engineering,small,325,1073,595,478,4375,4339,36
2022,1,Makkah Region,Civil Engineering,large,36,7419,5981,1438,36756,36518,238
2022,1,Makkah Region,Civil Engineering,micro,515,238,131,107,1121,1106,15
2022,1,Makkah Region,Civil Engineering,medium,88,1744,1155,589,7716,7687,29
2022,1,Najran Region,Civil Engineering,small,25,106,63,43,380,379,1
2022,1,Najran Region,Civil Engineering,large,6,689,555,134,2725,2723,2
2022,1,Najran Region,Civil Engineering,micro,47,29,12,17,111,111,0
2022,1,Najran Region,Civil Engineering,medium,8,150,102,48,581,581,0
2022,1,Eastern Province,Water Transport,small,18,181,160,21,132,129,3
2022,1,Eastern Province,Water Transport,micro,53,42,36,6,79,79,0
2022,1,Eastern Province,Water Transport,medium,11,701,545,156,388,380,8
2022,1,Al Bahah Region,Water Transport,micro,1,0,0,0,2,2,0
2022,1,Al Jawf Region,Water Transport,micro,1,1,0,1,0,0,0
2022,1,Northern Borders Region,Water Transport,micro,1,0,0,0,1,1,0
2022,1,Riyadh Region,Water Transport,small,16,134,51,83,162,160,2
2022,1,Riyadh Region,Water Transport,micro,115,25,15,10,237,237,0
2022,1,Riyadh Region,Water Transport,medium,2,106,95,11,53,53,0
2022,1,Qassim Region,Water Transport,small,1,1,1,0,17,17,0
2022,1,Qassim Region,Water Transport,micro,7,1,1,0,18,18,0
2022,1,Al Madinah Region,Water Transport,small,6,85,65,20,60,59,1
2022,1,Al Madinah Region,Water Transport,micro,18,9,8,1,30,29,1
2022,1,Tabuk Region,Water Transport,small,3,28,22,6,25,13,12
2022,1,Tabuk Region,Water Transport,micro,11,3,3,0,10,10,0
2022,1,Jazan Region,Water Transport,small,2,39,24,15,27,27,0
2022,1,Jazan Region,Water Transport,micro,5,3,2,1,12,12,0
2022,1,Jazan Region,Water Transport,medium,1,14,5,9,56,56,0
2022,1,Aseer Region,Water Transport,micro,10,2,1,1,21,21,0
2022,1,Makkah Region,Water Transport,small,26,131,83,48,232,224,8
2022,1,Makkah Region,Water Transport,large,1,109,81,28,160,159,1
2022,1,Makkah Region,Water Transport,micro,100,51,28,23,161,160,1
2022,1,Makkah Region,Water Transport,medium,4,119,69,50,243,243,0
2022,1,Najran Region,Water Transport,small,1,0,0,0,6,6,0
2022,1,Najran Region,Water Transport,micro,7,1,0,1,14,14,0
2022,1,Eastern Province,Air Transport,small,23,114,68,46,296,295,1
2022,1,Eastern Province,Air Transport,micro,59,25,16,9,117,115,2
2022,1,Al Bahah Region,Air Transport,small,1,1,1,0,5,5,0
2022,1,Al Jawf Region,Air Transport,micro,10,1,1,0,27,27,0
2022,1,Northern Borders Region,Air Transport,small,2,11,10,1,29,29,0
2022,1,Riyadh Region,Air Transport,small,24,161,128,33,256,254,2
2022,1,Riyadh Region,Air Transport,large,5,2489,2283,206,1754,1411,343
2022,1,Riyadh Region,Air Transport,micro,241,52,26,26,586,578,8
2022,1,Riyadh Region,Air Transport,medium,7,439,376,63,318,314,4
2022,1,Qassim Region,Air Transport,micro,9,3,0,3,15,15,0
2022,1,Al Madinah Region,Air Transport,small,1,0,0,0,9,9,0
2022,1,Al Madinah Region,Air Transport,micro,11,2,1,1,19,19,0
2022,1,Tabuk Region,Air Transport,small,1,3,2,1,7,7,0
2022,1,Tabuk Region,Air Transport,micro,6,0,0,0,12,12,0
2022,1,Tabuk Region,Air Transport,medium,1,19,17,2,50,50,0
2022,1,Jazan Region,Air Transport,small,2,1,1,0,15,15,0
2022,1,Jazan Region,Air Transport,micro,8,1,1,0,22,22,0
2022,1,Hail Region,Air Transport,small,2,8,5,3,18,18,0
2022,1,Hail Region,Air Transport,micro,16,1,0,1,44,44,0
2022,1,Aseer Region,Air Transport,small,1,3,2,1,8,8,0
2022,1,Aseer Region,Air Transport,micro,11,6,3,3,31,31,0
2022,1,Makkah Region,Air Transport,small,32,146,96,50,381,376,5
2022,1,Makkah Region,Air Transport,large,2,5612,5055,557,148,96,52
2022,1,Makkah Region,Air Transport,micro,63,31,19,12,120,116,4
2022,1,Makkah Region,Air Transport,medium,4,130,112,18,207,207,0
2022,1,Najran Region,Air Transport,micro,2,0,0,0,8,8,0
2022,1,Eastern Province,Land Transport and Transport Via Pipelines,small,662,2293,1319,974,9535,9522,13
2022,1,Eastern Province,Land Transport and Transport Via Pipelines,large,48,8941,7429,1512,23072,23061,11
2022,1,Eastern Province,Land Transport and Transport Via Pipelines,micro,2134,626,300,326,4108,4098,10
2022,1,Eastern Province,Land Transport and Transport Via Pipelines,medium,147,3548,2405,1143,11956,11933,23
2022,1,Al Bahah Region,Land Transport and Transport Via Pipelines,small,15,30,18,12,118,117,1
2022,1,Al Bahah Region,Land Transport and Transport Via Pipelines,micro,173,28,16,12,331,331,0
2022,1,Al Bahah Region,Land Transport and Transport Via Pipelines,medium,3,56,31,25,136,120,16
2022,1,Al Jawf Region,Land Transport and Transport Via Pipelines,small,67,155,108,47,808,807,1
2022,1,Al Jawf Region,Land Transport and Transport Via Pipelines,micro,568,82,57,25,1144,1141,3
2022,1,Al Jawf Region,Land Transport and Transport Via Pipelines,medium,3,92,44,48,254,254,0
2022,1,Northern Borders Region,Land Transport and Transport Via Pipelines,small,54,108,51,57,579,578,1
2022,1,Northern Borders Region,Land Transport and Transport Via Pipelines,micro,338,43,23,20,645,645,0
2022,1,Northern Borders Region,Land Transport and Transport Via Pipelines,medium,3,71,53,18,268,268,0
2022,1,Riyadh Region,Land Transport and Transport Via Pipelines,small,1086,2939,1348,1591,13446,13388,58
2022,1,Riyadh Region,Land Transport and Transport Via Pipelines,large,45,13876,11612,2264,23856,23827,29
2022,1,Riyadh Region,Land Transport and Transport Via Pipelines,micro,12730,1861,863,998,31112,30963,149
2022,1,Riyadh Region,Land Transport and Transport Via Pipelines,medium,184,4001,2189,1812,15434,15417,17
2022,1,Qassim Region,Land Transport and Transport Via Pipelines,small,218,518,313,205,2504,2503,1
2022,1,Qassim Region,Land Transport and Transport Via Pipelines,large,5,660,578,82,2107,2107,0
2022,1,Qassim Region,Land Transport and Transport Via Pipelines,micro,1052,245,143,102,2117,2115,2
2022,1,Qassim Region,Land Transport and Transport Via Pipelines,medium,27,640,489,151,2196,2196,0
2022,1,Al Madinah Region,Land Transport and Transport Via Pipelines,small,123,367,226,141,1553,1551,2
2022,1,Al Madinah Region,Land Transport and Transport Via Pipelines,large,1,91,40,51,288,287,1
2022,1,Al Madinah Region,Land Transport and Transport Via Pipelines,micro,1066,168,83,85,2058,2054,4
2022,1,Al Madinah Region,Land Transport and Transport Via Pipelines,medium,17,298,217,81,1134,1134,0
2022,1,Tabuk Region,Land Transport and Transport Via Pipelines,small,64,131,65,66,636,636,0
2022,1,Tabuk Region,Land Transport and Transport Via Pipelines,micro,533,89,42,47,990,990,0
2022,1,Tabuk Region,Land Transport and Transport Via Pipelines,medium,5,139,116,23,331,331,0
2022,1,Jazan Region,Land Transport and Transport Via Pipelines,small,40,46,25,21,379,379,0
2022,1,Jazan Region,Land Transport and Transport Via Pipelines,large,1,712,535,177,638,606,32
2022,1,Jazan Region,Land Transport and Transport Via Pipelines,micro,498,86,57,29,1030,1025,5
2022,1,Jazan Region,Land Transport and Transport Via Pipelines,medium,5,117,76,41,518,517,1
2022,1,Hail Region,Land Transport and Transport Via Pipelines,small,49,109,37,72,547,546,1
2022,1,Hail Region,Land Transport and Transport Via Pipelines,micro,571,72,26,46,1283,1280,3
2022,1,Hail Region,Land Transport and Transport Via Pipelines,medium,3,26,12,14,180,180,0
2022,1,Aseer Region,Land Transport and Transport Via Pipelines,small,242,528,315,213,2491,2490,1
2022,1,Aseer Region,Land Transport and Transport Via Pipelines,large,1,55,53,2,230,230,0
2022,1,Aseer Region,Land Transport and Transport Via Pipelines,micro,1770,315,166,149,3427,3419,8
2022,1,Aseer Region,Land Transport and Transport Via Pipelines,medium,18,372,217,155,1449,1449,0
2022,1,Makkah Region,Land Transport and Transport Via Pipelines,small,803,2532,1326,1206,10380,10331,49
2022,1,Makkah Region,Land Transport and Transport Via Pipelines,large,14,2692,1888,804,7088,7052,36
2022,1,Makkah Region,Land Transport and Transport Via Pipelines,micro,3502,809,414,395,6976,6887,89
2022,1,Makkah Region,Land Transport and Transport Via Pipelines,medium,114,2295,1436,859,9036,8994,42
2022,1,Najran Region,Land Transport and Transport Via Pipelines,small,92,187,101,86,1071,1069,2
2022,1,Najran Region,Land Transport and Transport Via Pipelines,micro,966,132,60,72,2218,2214,4
2022,1,Najran Region,Land Transport and Transport Via Pipelines,medium,3,57,45,12,192,192,0
2022,1,Eastern Province,Printing and Reproduction of Recorded Media,small,51,253,128,125,571,571,0
2022,1,Eastern Province,Printing and Reproduction of Recorded Media,large,1,1455,1101,354,993,987,6
2022,1,Eastern Province,Printing and Reproduction of Recorded Media,micro,92,67,30,37,124,124,0
2022,1,Eastern Province,Printing and Reproduction of Recorded Media,medium,4,124,78,46,258,258,0
2022,1,Al Bahah Region,Printing and Reproduction of Recorded Media,small,4,11,7,4,26,26,0
2022,1,Al Bahah Region,Printing and Reproduction of Recorded Media,micro,7,4,1,3,16,16,0
2022,1,Al Jawf Region,Printing and Reproduction of Recorded Media,small,1,1,0,1,5,5,0
2022,1,Al Jawf Region,Printing and Reproduction of Recorded Media,micro,9,2,2,0,16,16,0
2022,1,Northern Borders Region,Printing and Reproduction of Recorded Media,small,3,9,6,3,27,27,0
2022,1,Northern Borders Region,Printing and Reproduction of Recorded Media,micro,6,0,0,0,7,7,0
2022,1,Riyadh Region,Printing and Reproduction of Recorded Media,small,144,775,329,446,1610,1603,7
2022,1,Riyadh Region,Printing and Reproduction of Recorded Media,large,1,111,111,0,276,276,0
2022,1,Riyadh Region,Printing and Reproduction of Recorded Media,micro,237,156,65,91,414,406,8
2022,1,Riyadh Region,Printing and Reproduction of Recorded Media,medium,20,601,285,316,1428,1422,6
2022,1,Qassim Region,Printing and Reproduction of Recorded Media,small,12,60,38,22,134,134,0
2022,1,Qassim Region,Printing and Reproduction of Recorded Media,micro,28,8,5,3,50,50,0
2022,1,Qassim Region,Printing and Reproduction of Recorded Media,medium,2,49,12,37,91,91,0
2022,1,Al Madinah Region,Printing and Reproduction of Recorded Media,small,7,10,7,3,67,59,8
2022,1,Al Madinah Region,Printing and Reproduction of Recorded Media,large,1,864,864,0,111,111,0
2022,1,Al Madinah Region,Printing and Reproduction of Recorded Media,micro,54,17,12,5,107,107,0
2022,1,Al Madinah Region,Printing and Reproduction of Recorded Media,medium,1,46,37,9,34,34,0
2022,1,Tabuk Region,Printing and Reproduction of Recorded Media,small,5,15,7,8,31,31,0
2022,1,Tabuk Region,Printing and Reproduction of Recorded Media,micro,15,7,5,2,28,26,2
2022,1,Jazan Region,Printing and Reproduction of Recorded Media,small,3,9,4,5,23,23,0
2022,1,Jazan Region,Printing and Reproduction of Recorded Media,micro,11,3,3,0,23,23,0
2022,1,Hail Region,Printing and Reproduction of Recorded Media,small,5,21,14,7,62,62,0
2022,1,Hail Region,Printing and Reproduction of Recorded Media,micro,24,14,7,7,42,42,0
2022,1,Aseer Region,Printing and Reproduction of Recorded Media,small,11,53,20,33,143,142,1
2022,1,Aseer Region,Printing and Reproduction of Recorded Media,micro,27,19,11,8,51,50,1
2022,1,Makkah Region,Printing and Reproduction of Recorded Media,small,91,384,167,217,996,983,13
2022,1,Makkah Region,Printing and Reproduction of Recorded Media,micro,217,98,57,41,408,399,9
2022,1,Makkah Region,Printing and Reproduction of Recorded Media,medium,11,316,145,171,710,696,14
2022,1,Najran Region,Printing and Reproduction of Recorded Media,small,3,9,3,6,27,26,1
2022,1,Najran Region,Printing and Reproduction of Recorded Media,micro,4,0,0,0,9,9,0
2022,1,Eastern Province,Other Manufacturing,small,75,413,335,78,997,996,1
2022,1,Eastern Province,Other Manufacturing,large,3,693,670,23,740,737,3
2022,1,Eastern Province,Other Manufacturing,micro,93,61,47,14,150,147,3
2022,1,Eastern Province,Other Manufacturing,medium,19,572,372,200,1061,1060,1
2022,1,Al Bahah Region,Other Manufacturing,small,2,2,0,2,15,14,1
2022,1,Al Bahah Region,Other Manufacturing,micro,5,1,1,0,14,14,0
2022,1,Al Jawf Region,Other Manufacturing,micro,5,2,2,0,6,6,0
2022,1,Northern Borders Region,Other Manufacturing,micro,3,1,1,0,4,4,0
2022,1,Riyadh Region,Other Manufacturing,small,133,589,291,298,1923,1894,29
2022,1,Riyadh Region,Other Manufacturing,large,7,918,399,519,3458,3430,28
2022,1,Riyadh Region,Other Manufacturing,micro,193,94,61,33,381,376,5
2022,1,Riyadh Region,Other Manufacturing,medium,42,916,584,332,3041,3029,12
2022,1,Qassim Region,Other Manufacturing,small,7,26,16,10,120,120,0
2022,1,Qassim Region,Other Manufacturing,micro,24,22,19,3,38,38,0
2022,1,Al Madinah Region,Other Manufacturing,small,8,28,20,8,69,68,1
2022,1,Al Madinah Region,Other Manufacturing,large,1,301,298,3,218,218,0
2022,1,Al Madinah Region,Other Manufacturing,micro,33,18,13,5,58,58,0
2022,1,Al Madinah Region,Other Manufacturing,medium,2,34,22,12,187,186,1
2022,1,Tabuk Region,Other Manufacturing,micro,11,3,1,2,26,24,2
2022,1,Jazan Region,Other Manufacturing,small,4,6,4,2,32,32,0
2022,1,Jazan Region,Other Manufacturing,micro,15,3,3,0,31,31,0
2022,1,Hail Region,Other Manufacturing,small,3,17,11,6,15,15,0
2022,1,Hail Region,Other Manufacturing,micro,9,2,1,1,22,21,1
2022,1,Aseer Region,Other Manufacturing,small,13,42,30,12,151,150,1
2022,1,Aseer Region,Other Manufacturing,micro,29,14,10,4,54,52,2
2022,1,Makkah Region,Other Manufacturing,small,94,431,210,221,1386,1373,13
2022,1,Makkah Region,Other Manufacturing,large,6,706,545,161,2340,2329,11
2022,1,Makkah Region,Other Manufacturing,micro,154,83,40,43,274,261,13
2022,1,Makkah Region,Other Manufacturing,medium,20,478,306,172,1496,1492,4
2022,1,Najran Region,Other Manufacturing,small,1,2,1,1,6,6,0
2022,1,Najran Region,Other Manufacturing,micro,3,3,3,0,6,6,0
2022,1,Najran Region,Other Manufacturing,medium,1,30,30,0,119,119,0
2022,1,Eastern Province,Sewerage,small,12,36,19,17,149,149,0
2022,1,Eastern Province,Sewerage,large,2,339,293,46,1796,1796,0
2022,1,Eastern Province,Sewerage,micro,27,23,12,11,52,51,1
2022,1,Eastern Province,Sewerage,medium,2,20,10,10,100,99,1
2022,1,Al Bahah Region,Sewerage,small,1,0,0,0,10,10,0
2022,1,Al Bahah Region,Sewerage,micro,3,2,1,1,11,11,0
2022,1,Al Jawf Region,Sewerage,micro,7,1,0,1,13,13,0
2022,1,Northern Borders Region,Sewerage,micro,3,0,0,0,12,12,0
2022,1,Riyadh Region,Sewerage,small,31,70,33,37,449,448,1
2022,1,Riyadh Region,Sewerage,large,1,37,16,21,228,227,1
2022,1,Riyadh Region,Sewerage,micro,98,27,9,18,231,231,0
2022,1,Riyadh Region,Sewerage,medium,5,69,56,13,398,398,0
2022,1,Qassim Region,Sewerage,small,7,9,4,5,55,54,1
2022,1,Qassim Region,Sewerage,micro,18,8,5,3,43,43,0
2022,1,Al Madinah Region,Sewerage,small,7,14,13,1,77,77,0
2022,1,Al Madinah Region,Sewerage,micro,13,3,1,2,33,32,1
2022,1,Tabuk Region,Sewerage,small,1,1,0,1,6,6,0
2022,1,Tabuk Region,Sewerage,micro,6,1,1,0,17,17,0
2022,1,Jazan Region,Sewerage,micro,17,2,1,1,45,45,0
2022,1,Hail Region,Sewerage,small,3,18,14,4,58,58,0
2022,1,Hail Region,Sewerage,micro,13,3,1,2,39,39,0
2022,1,Aseer Region,Sewerage,small,3,7,4,3,51,51,0
2022,1,Aseer Region,Sewerage,micro,8,1,1,0,22,22,0
2022,1,Aseer Region,Sewerage,medium,1,26,20,6,92,92,0
2022,1,Makkah Region,Sewerage,small,20,72,37,35,200,200,0
2022,1,Makkah Region,Sewerage,micro,70,22,8,14,158,156,2
2022,1,Makkah Region,Sewerage,medium,6,47,35,12,414,413,1
2022,1,Najran Region,Sewerage,micro,2,0,0,0,5,5,0
2022,1,Eastern Province,Human Health Activities,small,277,2214,517,1697,3405,1790,1615
2022,1,Eastern Province,Human Health Activities,large,49,22434,10394,12040,19221,8776,10445
2022,1,Eastern Province,Human Health Activities,micro,221,203,61,142,351,254,97
2022,1,Eastern Province,Human Health Activities,medium,106,4676,1408,3268,6863,3819,3044
2022,1,Al Bahah Region,Human Health Activities,small,26,213,82,131,363,145,218
2022,1,Al Bahah Region,Human Health Activities,large,1,806,674,132,3,2,1
2022,1,Al Bahah Region,Human Health Activities,micro,22,20,11,9,28,19,9
2022,1,Al Bahah Region,Human Health Activities,medium,2,208,175,33,66,27,39
2022,1,Al Jawf Region,Human Health Activities,small,36,319,132,187,421,228,193
2022,1,Al Jawf Region,Human Health Activities,large,3,1350,888,462,1,1,0
2022,1,Al Jawf Region,Human Health Activities,micro,24,16,6,10,43,31,12
2022,1,Al Jawf Region,Human Health Activities,medium,12,659,378,281,423,219,204
2022,1,Northern Borders Region,Human Health Activities,small,24,125,40,85,250,138,112
2022,1,Northern Borders Region,Human Health Activities,micro,21,22,9,13,47,31,16
2022,1,Northern Borders Region,Human Health Activities,medium,9,739,427,312,168,101,67
2022,1,Riyadh Region,Human Health Activities,small,782,5879,1988,3891,10353,5164,5189
2022,1,Riyadh Region,Human Health Activities,large,86,47448,25953,21495,42172,18748,23424
2022,1,Riyadh Region,Human Health Activities,micro,678,501,191,310,1056,709,347
2022,1,Riyadh Region,Human Health Activities,medium,231,9779,3861,5918,14623,7508,7115
2022,1,Qassim Region,Human Health Activities,small,100,800,318,482,1362,636,726
2022,1,Qassim Region,Human Health Activities,large,14,4370,3199,1171,3533,832,2701
2022,1,Qassim Region,Human Health Activities,micro,56,38,19,19,94,76,18
2022,1,Qassim Region,Human Health Activities,medium,39,1448,862,586,2675,1476,1199
2022,1,Al Madinah Region,Human Health Activities,small,138,1027,385,642,1799,853,946
2022,1,Al Madinah Region,Human Health Activities,large,22,10922,7704,3218,4698,2222,2476
2022,1,Al Madinah Region,Human Health Activities,micro,77,69,31,38,121,79,42
2022,1,Al Madinah Region,Human Health Activities,medium,32,1088,371,717,1833,915,918
2022,1,Tabuk Region,Human Health Activities,small,53,385,97,288,578,321,257
2022,1,Tabuk Region,Human Health Activities,large,3,4185,2536,1649,2208,958,1250
2022,1,Tabuk Region,Human Health Activities,micro,29,22,4,18,53,36,17
2022,1,Tabuk Region,Human Health Activities,medium,11,444,197,247,634,343,291
2022,1,Jazan Region,Human Health Activities,small,89,1079,358,721,1012,511,501
2022,1,Jazan Region,Human Health Activities,large,6,2973,1719,1254,1276,386,890
2022,1,Jazan Region,Human Health Activities,micro,68,37,11,26,131,109,22
2022,1,Jazan Region,Human Health Activities,medium,17,889,303,586,681,375,306
2022,1,Hail Region,Human Health Activities,small,52,371,134,237,556,315,241
2022,1,Hail Region,Human Health Activities,large,6,1914,1146,768,1515,461,1054
2022,1,Hail Region,Human Health Activities,micro,47,46,17,29,62,49,13
2022,1,Hail Region,Human Health Activities,medium,19,1027,556,471,1235,562,673
2022,1,Aseer Region,Human Health Activities,small,129,902,258,644,1613,766,847
2022,1,Aseer Region,Human Health Activities,large,13,4128,2522,1606,4534,2418,2116
2022,1,Aseer Region,Human Health Activities,micro,117,86,32,54,184,131,53
2022,1,Aseer Region,Human Health Activities,medium,47,1966,789,1177,2935,1360,1575
2022,1,Makkah Region,Human Health Activities,small,629,4862,1338,3524,7643,3753,3890
2022,1,Makkah Region,Human Health Activities,large,48,21928,12326,9602,20749,9772,10977
2022,1,Makkah Region,Human Health Activities,micro,448,330,129,201,713,529,184
2022,1,Makkah Region,Human Health Activities,medium,182,6920,2331,4589,11706,5801,5905
2022,1,Najran Region,Human Health Activities,small,57,405,194,211,663,343,320
2022,1,Najran Region,Human Health Activities,large,3,689,633,56,192,110,82
2022,1,Najran Region,Human Health Activities,micro,32,18,10,8,49,37,12
2022,1,Najran Region,Human Health Activities,medium,18,936,695,241,949,563,386
2022,1,Eastern Province,Residential Care Activities,small,8,130,4,126,27,11,16
2022,1,Eastern Province,Residential Care Activities,micro,6,12,5,7,4,1,3
2022,1,Eastern Province,Residential Care Activities,medium,1,72,21,51,62,44,18
2022,1,Al Jawf Region,Residential Care Activities,small,1,30,2,28,0,0,0
2022,1,Al Jawf Region,Residential Care Activities,micro,3,1,1,0,4,4,0
2022,1,Riyadh Region,Residential Care Activities,small,28,445,37,408,117,54,63
2022,1,Riyadh Region,Residential Care Activities,micro,15,10,3,7,18,18,0
2022,1,Riyadh Region,Residential Care Activities,medium,5,283,50,233,167,103,64
2022,1,Qassim Region,Residential Care Activities,small,4,69,11,58,45,35,10
2022,1,Qassim Region,Residential Care Activities,micro,2,1,0,1,3,3,0
2022,1,Qassim Region,Residential Care Activities,medium,1,51,33,18,10,10,0
2022,1,Al Madinah Region,Residential Care Activities,small,3,74,22,52,13,8,5
2022,1,Al Madinah Region,Residential Care Activities,micro,6,13,11,2,5,4,1
2022,1,Al Madinah Region,Residential Care Activities,medium,1,23,10,13,27,22,5
2022,1,Tabuk Region,Residential Care Activities,small,1,13,1,12,1,0,1
2022,1,Tabuk Region,Residential Care Activities,micro,1,4,1,3,0,0,0
2022,1,Tabuk Region,Residential Care Activities,medium,1,73,24,49,20,17,3
2022,1,Jazan Region,Residential Care Activities,small,4,55,14,41,5,3,2
2022,1,Jazan Region,Residential Care Activities,micro,2,3,1,2,1,1,0
2022,1,Hail Region,Residential Care Activities,small,2,23,6,17,7,5,2
2022,1,Hail Region,Residential Care Activities,micro,1,2,0,2,0,0,0
2022,1,Aseer Region,Residential Care Activities,small,3,88,2,86,21,8,13
2022,1,Aseer Region,Residential Care Activities,micro,5,5,1,4,6,6,0
2022,1,Aseer Region,Residential Care Activities,medium,1,49,1,48,4,2,2
2022,1,Makkah Region,Residential Care Activities,small,21,325,36,289,114,62,52
2022,1,Makkah Region,Residential Care Activities,micro,10,15,3,12,8,5,3
2022,1,Makkah Region,Residential Care Activities,medium,2,121,9,112,20,10,10
2022,1,Najran Region,Residential Care Activities,small,1,8,0,8,4,0,4
2022,1,Eastern Province,Forestry and Logging,micro,3,0,0,0,4,4,0
2022,1,Riyadh Region,Forestry and Logging,micro,4,1,0,1,7,7,0
2022,1,Qassim Region,Forestry and Logging,micro,1,0,0,0,2,2,0
2022,1,Jazan Region,Forestry and Logging,micro,1,1,0,1,0,0,0
2022,1,Makkah Region,Forestry and Logging,micro,3,0,0,0,9,9,0
2022,1,Eastern Province,Education,small,269,3308,877,2431,1891,1657,234
2022,1,Eastern Province,Education,large,17,5023,2607,2416,1636,1284,352
2022,1,Eastern Province,Education,micro,339,362,127,235,405,357,48
2022,1,Eastern Province,Education,medium,92,5512,1933,3579,4637,3923,714
2022,1,Al Bahah Region,Education,small,9,122,49,73,87,81,6
2022,1,Al Bahah Region,Education,micro,23,21,7,14,29,25,4
2022,1,Al Bahah Region,Education,medium,1,175,103,72,0,0,0
2022,1,Al Jawf Region,Education,small,28,363,112,251,182,164,18
2022,1,Al Jawf Region,Education,micro,39,20,3,17,51,46,5
2022,1,Al Jawf Region,Education,medium,13,547,292,255,432,410,22
2022,1,Northern Borders Region,Education,small,19,201,146,55,180,179,1
2022,1,Northern Borders Region,Education,large,1,56,39,17,450,266,184
2022,1,Northern Borders Region,Education,micro,20,22,3,19,25,24,1
2022,1,Northern Borders Region,Education,medium,3,183,53,130,62,47,15
2022,1,Riyadh Region,Education,small,548,5544,1468,4076,4291,3571,720
2022,1,Riyadh Region,Education,large,58,22533,10670,11863,14381,11375,3006
2022,1,Riyadh Region,Education,micro,4470,1017,404,613,8409,8259,150
2022,1,Riyadh Region,Education,medium,213,13983,5011,8972,10733,9306,1427
2022,1,Qassim Region,Education,small,50,644,165,479,304,278,26
2022,1,Qassim Region,Education,large,4,666,352,314,1523,949,574
2022,1,Qassim Region,Education,micro,102,70,20,50,165,157,8
2022,1,Qassim Region,Education,medium,20,1022,500,522,605,517,88
2022,1,Al Madinah Region,Education,small,87,1233,246,987,428,370,58
2022,1,Al Madinah Region,Education,large,2,1272,690,582,114,79,35
2022,1,Al Madinah Region,Education,micro,137,129,28,101,184,169,15
2022,1,Al Madinah Region,Education,medium,35,2476,1027,1449,1684,1388,296
2022,1,Tabuk Region,Education,small,40,464,119,345,244,215,29
2022,1,Tabuk Region,Education,large,3,435,181,254,830,610,220
2022,1,Tabuk Region,Education,micro,37,37,9,28,52,51,1
2022,1,Tabuk Region,Education,medium,17,908,489,419,714,673,41
2022,1,Jazan Region,Education,small,36,391,148,243,193,163,30
2022,1,Jazan Region,Education,large,1,29,23,6,1408,745,663
2022,1,Jazan Region,Education,micro,95,74,29,45,134,128,6
2022,1,Jazan Region,Education,medium,4,119,71,48,178,119,59
2022,1,Hail Region,Education,small,28,366,74,292,97,80,17
2022,1,Hail Region,Education,large,1,31,13,18,811,452,359
2022,1,Hail Region,Education,micro,88,32,11,21,164,164,0
2022,1,Hail Region,Education,medium,4,303,215,88,236,234,2
2022,1,Aseer Region,Education,small,58,835,248,587,372,338,34
2022,1,Aseer Region,Education,large,2,150,74,76,593,396,197
2022,1,Aseer Region,Education,micro,95,60,16,44,140,131,9
2022,1,Aseer Region,Education,medium,13,835,434,401,431,412,19
2022,1,Makkah Region,Education,small,349,4087,847,3240,2492,1877,615
2022,1,Makkah Region,Education,large,20,6555,3532,3023,4725,3187,1538
2022,1,Makkah Region,Education,micro,573,426,125,301,840,717,123
2022,1,Makkah Region,Education,medium,136,7487,2990,4497,6373,5169,1204
2022,1,Najran Region,Education,small,18,176,56,120,110,104,6
2022,1,Najran Region,Education,micro,67,32,7,25,123,121,2
2022,1,Najran Region,Education,medium,7,268,154,114,237,232,5
2022,1,Eastern Province,Warehousing and Support Activities for Transportation,small,218,1042,793,249,2096,2088,8
2022,1,Eastern Province,Warehousing and Support Activities for Transportation,large,10,3161,2857,304,6085,6041,44
2022,1,Eastern Province,Warehousing and Support Activities for Transportation,micro,642,445,341,104,1030,1024,6
2022,1,Eastern Province,Warehousing and Support Activities for Transportation,medium,54,2070,1480,590,3501,3482,19
2022,1,Al Bahah Region,Warehousing and Support Activities for Transportation,small,1,7,3,4,1,1,0
2022,1,Al Bahah Region,Warehousing and Support Activities for Transportation,micro,25,5,3,2,41,40,1
2022,1,Al Jawf Region,Warehousing and Support Activities for Transportation,small,20,79,68,11,186,185,1
2022,1,Al Jawf Region,Warehousing and Support Activities for Transportation,micro,103,39,33,6,189,189,0
2022,1,Al Jawf Region,Warehousing and Support Activities for Transportation,medium,1,9,9,0,44,44,0
2022,1,Northern Borders Region,Warehousing and Support Activities for Transportation,small,4,5,3,2,38,38,0
2022,1,Northern Borders Region,Warehousing and Support Activities for Transportation,micro,26,1,1,0,46,46,0
2022,1,Riyadh Region,Warehousing and Support Activities for Transportation,small,366,1599,846,753,4312,4266,46
2022,1,Riyadh Region,Warehousing and Support Activities for Transportation,large,29,11984,8607,3377,11437,11342,95
2022,1,Riyadh Region,Warehousing and Support Activities for Transportation,micro,1317,448,270,178,2674,2663,11
2022,1,Riyadh Region,Warehousing and Support Activities for Transportation,medium,89,2947,1710,1237,6531,6438,93
2022,1,Qassim Region,Warehousing and Support Activities for Transportation,small,29,76,56,20,338,338,0
2022,1,Qassim Region,Warehousing and Support Activities for Transportation,micro,137,29,17,12,275,274,1
2022,1,Qassim Region,Warehousing and Support Activities for Transportation,medium,4,111,69,42,519,519,0
2022,1,Al Madinah Region,Warehousing and Support Activities for Transportation,small,32,113,82,31,322,319,3
2022,1,Al Madinah Region,Warehousing and Support Activities for Transportation,large,2,938,897,41,330,330,0
2022,1,Al Madinah Region,Warehousing and Support Activities for Transportation,micro,231,48,31,17,431,430,1
2022,1,Al Madinah Region,Warehousing and Support Activities for Transportation,medium,3,104,94,10,178,178,0
2022,1,Tabuk Region,Warehousing and Support Activities for Transportation,small,14,43,32,11,111,111,0
2022,1,Tabuk Region,Warehousing and Support Activities for Transportation,micro,71,27,20,7,112,112,0
2022,1,Tabuk Region,Warehousing and Support Activities for Transportation,medium,1,45,12,33,23,23,0
2022,1,Jazan Region,Warehousing and Support Activities for Transportation,small,11,56,36,20,87,86,1
2022,1,Jazan Region,Warehousing and Support Activities for Transportation,micro,69,22,15,7,151,151,0
2022,1,Hail Region,Warehousing and Support Activities for Transportation,small,10,13,11,2,73,73,0
2022,1,Hail Region,Warehousing and Support Activities for Transportation,micro,59,14,6,8,118,118,0
2022,1,Aseer Region,Warehousing and Support Activities for Transportation,small,21,77,59,18,248,248,0
2022,1,Aseer Region,Warehousing and Support Activities for Transportation,micro,124,43,28,15,242,242,0
2022,1,Aseer Region,Warehousing and Support Activities for Transportation,medium,6,244,222,22,312,312,0
2022,1,Makkah Region,Warehousing and Support Activities for Transportation,small,348,1466,943,523,3863,3809,54
2022,1,Makkah Region,Warehousing and Support Activities for Transportation,large,22,6770,5969,801,10983,10956,27
2022,1,Makkah Region,Warehousing and Support Activities for Transportation,micro,771,428,295,133,1318,1299,19
2022,1,Makkah Region,Warehousing and Support Activities for Transportation,medium,78,3172,2437,735,5631,5602,29
2022,1,Najran Region,Warehousing and Support Activities for Transportation,small,68,40,29,11,635,635,0
2022,1,Najran Region,Warehousing and Support Activities for Transportation,micro,391,67,38,29,920,916,4
2022,1,Najran Region,Warehousing and Support Activities for Transportation,medium,1,13,3,10,38,38,0
2022,1,Eastern Province,"Research and Development in the Physical, Engineering, and Life Sciences",small,8,29,24,5,40,39,1
2022,1,Eastern Province,"Research and Development in the Physical, Engineering, and Life Sciences",micro,13,16,7,9,9,9,0
2022,1,Eastern Province,"Research and Development in the Physical, Engineering, and Life Sciences",medium,2,104,70,34,125,124,1
2022,1,Northern Borders Region,"Research and Development in the Physical, Engineering, and Life Sciences",micro,1,1,1,0,3,3,0
2022,1,Riyadh Region,"Research and Development in the Physical, Engineering, and Life Sciences",small,33,245,151,94,196,181,15
2022,1,Riyadh Region,"Research and Development in the Physical, Engineering, and Life Sciences",micro,71,72,43,29,70,64,6
2022,1,Riyadh Region,"Research and Development in the Physical, Engineering, and Life Sciences",medium,5,297,179,118,238,231,7
2022,1,Qassim Region,"Research and Development in the Physical, Engineering, and Life Sciences",micro,4,1,0,1,6,6,0
2022,1,Al Madinah Region,"Research and Development in the Physical, Engineering, and Life Sciences",small,1,4,4,0,3,3,0
2022,1,Al Madinah Region,"Research and Development in the Physical, Engineering, and Life Sciences",micro,7,4,1,3,12,10,2
2022,1,Tabuk Region,"Research and Development in the Physical, Engineering, and Life Sciences",small,1,1,1,0,8,8,0
2022,1,Tabuk Region,"Research and Development in the Physical, Engineering, and Life Sciences",micro,2,0,0,0,2,2,0
2022,1,Jazan Region,"Research and Development in the Physical, Engineering, and Life Sciences",micro,3,6,3,3,3,3,0
2022,1,Hail Region,"Research and Development in the Physical, Engineering, and Life Sciences",micro,1,4,0,4,0,0,0
2022,1,Aseer Region,"Research and Development in the Physical, Engineering, and Life Sciences",micro,2,0,0,0,2,2,0
2022,1,Makkah Region,"Research and Development in the Physical, Engineering, and Life Sciences",small,8,40,18,22,57,55,2
2022,1,Makkah Region,"Research and Development in the Physical, Engineering, and Life Sciences",micro,43,35,10,25,60,54,6
2022,1,Makkah Region,"Research and Development in the Physical, Engineering, and Life Sciences",medium,5,312,299,13,191,186,5
2022,1,Eastern Province,Undifferentiated Goods-Producing Activities of Private Households for Own Use,small,1,0,0,0,12,12,0
2022,1,Eastern Province,Undifferentiated Goods-Producing Activities of Private Households for Own Use,micro,2,0,0,0,2,2,0
2022,1,Riyadh Region,Undifferentiated Goods-Producing Activities of Private Households for Own Use,small,1,1,0,1,6,6,0
2022,1,Riyadh Region,Undifferentiated Goods-Producing Activities of Private Households for Own Use,micro,2,0,0,0,2,2,0
2022,1,Qassim Region,Undifferentiated Goods-Producing Activities of Private Households for Own Use,micro,2,0,0,0,3,3,0
2022,1,Makkah Region,Undifferentiated Goods-Producing Activities of Private Households for Own Use,micro,1,0,0,0,1,0,1
2022,1,Eastern Province,"Other Professional, Scientific, and Technical Activities",small,30,136,64,72,191,177,14
2022,1,Eastern Province,"Other Professional, Scientific, and Technical Activities",large,1,279,237,42,375,373,2
2022,1,Eastern Province,"Other Professional, Scientific, and Technical Activities",micro,175,144,65,79,225,192,33
2022,1,Al Bahah Region,"Other Professional, Scientific, and Technical Activities",small,1,4,3,1,24,23,1
2022,1,Al Bahah Region,"Other Professional, Scientific, and Technical Activities",micro,6,1,0,1,7,6,1
2022,1,Al Jawf Region,"Other Professional, Scientific, and Technical Activities",small,1,2,2,0,21,21,0
2022,1,Al Jawf Region,"Other Professional, Scientific, and Technical Activities",micro,18,4,3,1,34,32,2
2022,1,Northern Borders Region,"Other Professional, Scientific, and Technical Activities",micro,10,1,0,1,20,16,4
2022,1,Riyadh Region,"Other Professional, Scientific, and Technical Activities",small,109,598,286,312,781,688,93
2022,1,Riyadh Region,"Other Professional, Scientific, and Technical Activities",large,4,763,540,223,851,839,12
2022,1,Riyadh Region,"Other Professional, Scientific, and Technical Activities",micro,467,294,104,190,739,647,92
2022,1,Riyadh Region,"Other Professional, Scientific, and Technical Activities",medium,10,599,355,244,596,576,20
2022,1,Qassim Region,"Other Professional, Scientific, and Technical Activities",small,6,51,36,15,95,95,0
2022,1,Qassim Region,"Other Professional, Scientific, and Technical Activities",micro,38,21,12,9,56,49,7
2022,1,Al Madinah Region,"Other Professional, Scientific, and Technical Activities",small,9,25,11,14,71,55,16
2022,1,Al Madinah Region,"Other Professional, Scientific, and Technical Activities",micro,78,35,20,15,123,107,16
2022,1,Tabuk Region,"Other Professional, Scientific, and Technical Activities",small,1,6,1,5,4,4,0
2022,1,Tabuk Region,"Other Professional, Scientific, and Technical Activities",micro,30,8,4,4,58,57,1
2022,1,Jazan Region,"Other Professional, Scientific, and Technical Activities",small,2,10,3,7,7,6,1
2022,1,Jazan Region,"Other Professional, Scientific, and Technical Activities",micro,33,9,4,5,53,49,4
2022,1,Hail Region,"Other Professional, Scientific, and Technical Activities",small,1,2,0,2,7,7,0
2022,1,Hail Region,"Other Professional, Scientific, and Technical Activities",micro,20,5,1,4,30,25,5
2022,1,Aseer Region,"Other Professional, Scientific, and Technical Activities",small,4,14,5,9,35,24,11
2022,1,Aseer Region,"Other Professional, Scientific, and Technical Activities",micro,46,16,9,7,84,78,6
2022,1,Aseer Region,"Other Professional, Scientific, and Technical Activities",medium,1,21,18,3,68,68,0
2022,1,Makkah Region,"Other Professional, Scientific, and Technical Activities",small,68,282,145,137,585,538,47
2022,1,Makkah Region,"Other Professional, Scientific, and Technical Activities",micro,370,207,66,141,635,529,106
2022,1,Makkah Region,"Other Professional, Scientific, and Technical Activities",medium,6,177,145,32,209,208,1
2022,1,Najran Region,"Other Professional, Scientific, and Technical Activities",small,1,0,0,0,8,8,0
2022,1,Najran Region,"Other Professional, Scientific, and Technical Activities",micro,25,2,2,0,53,50,3
2022,1,Eastern Province,Activities Auxiliary to Financial Services and Insurance Activities,small,23,276,180,96,138,135,3
2022,1,Eastern Province,Activities Auxiliary to Financial Services and Insurance Activities,micro,39,40,30,10,49,43,6
2022,1,Eastern Province,Activities Auxiliary to Financial Services and Insurance Activities,medium,4,377,180,197,110,101,9
2022,1,Al Jawf Region,Activities Auxiliary to Financial Services and Insurance Activities,micro,2,0,0,0,2,2,0
2022,1,Riyadh Region,Activities Auxiliary to Financial Services and Insurance Activities,small,133,1769,1112,657,818,785,33
2022,1,Riyadh Region,Activities Auxiliary to Financial Services and Insurance Activities,large,13,29233,23355,5878,1868,1830,38
2022,1,Riyadh Region,Activities Auxiliary to Financial Services and Insurance Activities,micro,159,217,127,90,148,145,3
2022,1,Riyadh Region,Activities Auxiliary to Financial Services and Insurance Activities,medium,37,3987,2857,1130,816,767,49
2022,1,Qassim Region,Activities Auxiliary to Financial Services and Insurance Activities,small,1,0,0,0,12,12,0
2022,1,Qassim Region,Activities Auxiliary to Financial Services and Insurance Activities,micro,4,2,1,1,3,3,0
2022,1,Al Madinah Region,Activities Auxiliary to Financial Services and Insurance Activities,small,1,4,2,2,4,4,0
2022,1,Al Madinah Region,Activities Auxiliary to Financial Services and Insurance Activities,micro,15,28,27,1,21,21,0
2022,1,Al Madinah Region,Activities Auxiliary to Financial Services and Insurance Activities,medium,1,26,14,12,103,103,0
2022,1,Tabuk Region,Activities Auxiliary to Financial Services and Insurance Activities,micro,3,1,1,0,6,6,0
2022,1,Jazan Region,Activities Auxiliary to Financial Services and Insurance Activities,micro,2,2,2,0,2,2,0
2022,1,Aseer Region,Activities Auxiliary to Financial Services and Insurance Activities,micro,3,1,1,0,3,3,0
2022,1,Makkah Region,Activities Auxiliary to Financial Services and Insurance Activities,small,53,530,295,235,329,311,18
2022,1,Makkah Region,Activities Auxiliary to Financial Services and Insurance Activities,micro,54,72,53,19,77,75,2
2022,1,Makkah Region,Activities Auxiliary to Financial Services and Insurance Activities,medium,12,831,560,271,237,228,9
2022,1,Najran Region,Activities Auxiliary to Financial Services and Insurance Activities,small,1,23,21,2,12,12,0
2022,1,Najran Region,Activities Auxiliary to Financial Services and Insurance Activities,micro,2,1,1,0,3,3,0
2022,1,Eastern Province,Legal and Accounting Activities,small,84,566,336,230,431,421,10
2022,1,Eastern Province,Legal and Accounting Activities,micro,233,344,217,127,242,235,7
2022,1,Eastern Province,Legal and Accounting Activities,medium,8,395,213,182,463,450,13
2022,1,Al Bahah Region,Legal and Accounting Activities,micro,8,15,10,5,14,14,0
2022,1,Al Jawf Region,Legal and Accounting Activities,small,5,25,14,11,8,8,0
2022,1,Al Jawf Region,Legal and Accounting Activities,micro,25,27,21,6,21,21,0
2022,1,Northern Borders Region,Legal and Accounting Activities,micro,7,10,4,6,5,5,0
2022,1,Riyadh Region,Legal and Accounting Activities,small,415,3098,1886,1212,2553,2457,96
2022,1,Riyadh Region,Legal and Accounting Activities,large,1,416,241,175,287,275,12
2022,1,Riyadh Region,Legal and Accounting Activities,micro,1266,1220,801,419,1659,1633,26
2022,1,Riyadh Region,Legal and Accounting Activities,medium,26,1059,600,459,1411,1354,57
2022,1,Qassim Region,Legal and Accounting Activities,small,10,58,33,25,25,25,0
2022,1,Qassim Region,Legal and Accounting Activities,micro,72,84,46,38,62,61,1
2022,1,Al Madinah Region,Legal and Accounting Activities,small,19,138,79,59,89,88,1
2022,1,Al Madinah Region,Legal and Accounting Activities,micro,84,94,67,27,84,81,3
2022,1,Tabuk Region,Legal and Accounting Activities,small,1,4,2,2,4,4,0
2022,1,Tabuk Region,Legal and Accounting Activities,micro,17,27,10,17,11,11,0
2022,1,Jazan Region,Legal and Accounting Activities,small,5,30,22,8,14,14,0
2022,1,Jazan Region,Legal and Accounting Activities,micro,23,22,18,4,25,25,0
2022,1,Hail Region,Legal and Accounting Activities,small,3,22,16,6,14,14,0
2022,1,Hail Region,Legal and Accounting Activities,micro,21,24,16,8,23,23,0
2022,1,Aseer Region,Legal and Accounting Activities,small,6,39,34,5,64,64,0
2022,1,Aseer Region,Legal and Accounting Activities,micro,48,57,43,14,58,57,1
2022,1,Aseer Region,Legal and Accounting Activities,medium,2,63,31,32,80,80,0
2022,1,Makkah Region,Legal and Accounting Activities,small,228,1748,1063,685,1197,1134,63
2022,1,Makkah Region,Legal and Accounting Activities,micro,616,782,516,266,657,632,25
2022,1,Makkah Region,Legal and Accounting Activities,medium,10,505,356,149,642,626,16
2022,1,Najran Region,Legal and Accounting Activities,small,1,10,9,1,18,18,0
2022,1,Najran Region,Legal and Accounting Activities,micro,29,4,2,2,51,51,0
2022,1,Eastern Province,Real Estate Activities,small,216,1164,745,419,1984,1960,24
2022,1,Eastern Province,Real Estate Activities,large,5,511,221,290,1235,1213,22
2022,1,Eastern Province,Real Estate Activities,micro,561,418,240,178,746,733,13
2022,1,Eastern Province,Real Estate Activities,medium,17,608,433,175,916,911,5
2022,1,Al Bahah Region,Real Estate Activities,small,3,18,14,4,22,22,0
2022,1,Al Bahah Region,Real Estate Activities,micro,16,9,8,1,29,29,0
2022,1,Al Bahah Region,Real Estate Activities,medium,1,36,32,4,74,74,0
2022,1,Al Jawf Region,Real Estate Activities,small,4,10,5,5,26,26,0
2022,1,Al Jawf Region,Real Estate Activities,micro,47,31,23,8,61,61,0
2022,1,Al Jawf Region,Real Estate Activities,medium,2,43,31,12,85,84,1
2022,1,Northern Borders Region,Real Estate Activities,small,8,25,20,5,89,89,0
2022,1,Northern Borders Region,Real Estate Activities,micro,38,9,5,4,65,65,0
2022,1,Riyadh Region,Real Estate Activities,small,693,4317,2594,1723,6266,6141,125
2022,1,Riyadh Region,Real Estate Activities,large,15,2845,1974,871,5899,4790,1109
2022,1,Riyadh Region,Real Estate Activities,micro,1926,1672,1006,666,2515,2476,39
2022,1,Riyadh Region,Real Estate Activities,medium,79,2970,1919,1051,4199,4078,121
2022,1,Qassim Region,Real Estate Activities,small,32,130,86,44,242,241,1
2022,1,Qassim Region,Real Estate Activities,large,1,146,83,63,308,308,0
2022,1,Qassim Region,Real Estate Activities,micro,156,82,53,29,244,241,3
2022,1,Qassim Region,Real Estate Activities,medium,7,180,101,79,549,549,0
2022,1,Al Madinah Region,Real Estate Activities,small,46,170,126,44,494,490,4
2022,1,Al Madinah Region,Real Estate Activities,large,1,139,129,10,198,198,0
2022,1,Al Madinah Region,Real Estate Activities,micro,237,114,57,57,367,365,2
2022,1,Al Madinah Region,Real Estate Activities,medium,3,104,61,43,262,254,8
2022,1,Tabuk Region,Real Estate Activities,small,13,41,28,13,96,96,0
2022,1,Tabuk Region,Real Estate Activities,micro,93,43,30,13,149,149,0
2022,1,Tabuk Region,Real Estate Activities,medium,1,15,14,1,41,41,0
2022,1,Jazan Region,Real Estate Activities,small,17,43,16,27,158,158,0
2022,1,Jazan Region,Real Estate Activities,micro,129,58,31,27,213,211,2
2022,1,Jazan Region,Real Estate Activities,medium,3,64,38,26,197,197,0
2022,1,Hail Region,Real Estate Activities,small,9,26,15,11,71,71,0
2022,1,Hail Region,Real Estate Activities,micro,88,42,23,19,141,140,1
2022,1,Hail Region,Real Estate Activities,medium,1,0,0,0,117,117,0
2022,1,Aseer Region,Real Estate Activities,small,35,138,87,51,276,276,0
2022,1,Aseer Region,Real Estate Activities,micro,221,116,74,42,340,340,0
2022,1,Aseer Region,Real Estate Activities,medium,6,209,73,136,349,348,1
2022,1,Makkah Region,Real Estate Activities,small,441,2130,1298,832,4173,4076,97
2022,1,Makkah Region,Real Estate Activities,large,6,1515,1071,444,2738,2703,35
2022,1,Makkah Region,Real Estate Activities,micro,1484,961,580,381,2295,2240,55
2022,1,Makkah Region,Real Estate Activities,medium,43,1667,1188,479,2782,2714,68
2022,1,Najran Region,Real Estate Activities,small,3,7,3,4,16,16,0
2022,1,Najran Region,Real Estate Activities,micro,51,20,9,11,79,79,0
2022,1,Najran Region,Real Estate Activities,medium,1,10,8,2,47,47,0
2022,1,Eastern Province,"Sports, Entertainment, and Recreation Activities",small,97,398,196,202,763,678,85
2022,1,Eastern Province,"Sports, Entertainment, and Recreation Activities",large,1,97,65,32,278,261,17
2022,1,Eastern Province,"Sports, Entertainment, and Recreation Activities",micro,268,253,101,152,383,346,37
2022,1,Eastern Province,"Sports, Entertainment, and Recreation Activities",medium,8,217,98,119,502,501,1
2022,1,Al Bahah Region,"Sports, Entertainment, and Recreation Activities",small,3,14,10,4,21,21,0
2022,1,Al Bahah Region,"Sports, Entertainment, and Recreation Activities",micro,24,14,10,4,50,45,5
2022,1,Al Jawf Region,"Sports, Entertainment, and Recreation Activities",small,8,36,31,5,62,58,4
2022,1,Al Jawf Region,"Sports, Entertainment, and Recreation Activities",micro,38,20,10,10,59,50,9
2022,1,Northern Borders Region,"Sports, Entertainment, and Recreation Activities",small,7,25,6,19,49,39,10
2022,1,Northern Borders Region,"Sports, Entertainment, and Recreation Activities",micro,37,17,7,10,87,80,7
2022,1,Riyadh Region,"Sports, Entertainment, and Recreation Activities",small,235,1295,519,776,2351,2014,337
2022,1,Riyadh Region,"Sports, Entertainment, and Recreation Activities",large,6,1631,934,697,2152,1890,262
2022,1,Riyadh Region,"Sports, Entertainment, and Recreation Activities",micro,591,457,168,289,896,814,82
2022,1,Riyadh Region,"Sports, Entertainment, and Recreation Activities",medium,24,1047,487,560,1580,1399,181
2022,1,Qassim Region,"Sports, Entertainment, and Recreation Activities",small,39,216,103,113,331,298,33
2022,1,Qassim Region,"Sports, Entertainment, and Recreation Activities",micro,65,43,19,24,104,95,9
2022,1,Qassim Region,"Sports, Entertainment, and Recreation Activities",medium,3,30,26,4,206,206,0
2022,1,Al Madinah Region,"Sports, Entertainment, and Recreation Activities",small,26,203,77,126,201,186,15
2022,1,Al Madinah Region,"Sports, Entertainment, and Recreation Activities",micro,90,55,23,32,152,134,18
2022,1,Al Madinah Region,"Sports, Entertainment, and Recreation Activities",medium,2,80,48,32,83,74,9
2022,1,Tabuk Region,"Sports, Entertainment, and Recreation Activities",small,12,41,12,29,76,69,7
2022,1,Tabuk Region,"Sports, Entertainment, and Recreation Activities",micro,62,35,20,15,104,95,9
2022,1,Tabuk Region,"Sports, Entertainment, and Recreation Activities",medium,1,44,38,6,23,23,0
2022,1,Jazan Region,"Sports, Entertainment, and Recreation Activities",small,7,17,14,3,44,44,0
2022,1,Jazan Region,"Sports, Entertainment, and Recreation Activities",micro,57,36,15,21,81,70,11
2022,1,Jazan Region,"Sports, Entertainment, and Recreation Activities",medium,1,38,7,31,70,70,0
2022,1,Hail Region,"Sports, Entertainment, and Recreation Activities",small,21,79,55,24,194,194,0
2022,1,Hail Region,"Sports, Entertainment, and Recreation Activities",micro,52,37,15,22,75,63,12
2022,1,Hail Region,"Sports, Entertainment, and Recreation Activities",medium,1,14,2,12,48,48,0
2022,1,Aseer Region,"Sports, Entertainment, and Recreation Activities",small,41,217,89,128,369,330,39
2022,1,Aseer Region,"Sports, Entertainment, and Recreation Activities",micro,115,81,46,35,205,190,15
2022,1,Aseer Region,"Sports, Entertainment, and Recreation Activities",medium,1,12,7,5,87,87,0
2022,1,Makkah Region,"Sports, Entertainment, and Recreation Activities",small,163,934,347,587,1421,1224,197
2022,1,Makkah Region,"Sports, Entertainment, and Recreation Activities",micro,469,334,146,188,709,651,58
2022,1,Makkah Region,"Sports, Entertainment, and Recreation Activities",medium,20,748,379,369,933,837,96
2022,1,Najran Region,"Sports, Entertainment, and Recreation Activities",small,11,43,25,18,126,118,8
2022,1,Najran Region,"Sports, Entertainment, and Recreation Activities",micro,28,19,11,8,55,52,3
2022,1,Eastern Province,Veterinary Activities,small,7,11,4,7,52,52,0
2022,1,Eastern Province,Veterinary Activities,micro,34,24,15,9,62,59,3
2022,1,Eastern Province,Veterinary Activities,medium,2,46,22,24,73,69,4
2022,1,Al Bahah Region,Veterinary Activities,micro,2,0,0,0,3,3,0
2022,1,Al Jawf Region,Veterinary Activities,micro,1,0,0,0,1,1,0
2022,1,Northern Borders Region,Veterinary Activities,small,1,0,0,0,10,8,2
2022,1,Northern Borders Region,Veterinary Activities,micro,5,3,2,1,9,9,0
2022,1,Riyadh Region,Veterinary Activities,small,23,91,52,39,228,205,23
2022,1,Riyadh Region,Veterinary Activities,micro,58,29,11,18,95,93,2
2022,1,Riyadh Region,Veterinary Activities,medium,5,146,69,77,328,302,26
2022,1,Qassim Region,Veterinary Activities,small,3,5,4,1,18,18,0
2022,1,Qassim Region,Veterinary Activities,micro,13,0,0,0,27,27,0
2022,1,Qassim Region,Veterinary Activities,medium,1,24,24,0,40,40,0
2022,1,Al Madinah Region,Veterinary Activities,small,4,7,5,2,19,19,0
2022,1,Al Madinah Region,Veterinary Activities,micro,17,5,2,3,36,32,4
2022,1,Tabuk Region,Veterinary Activities,micro,7,3,3,0,11,11,0
2022,1,Jazan Region,Veterinary Activities,micro,6,3,3,0,20,20,0
2022,1,Hail Region,Veterinary Activities,micro,5,0,0,0,13,13,0
2022,1,Aseer Region,Veterinary Activities,small,2,6,5,1,17,16,1
2022,1,Aseer Region,Veterinary Activities,micro,21,4,2,2,40,40,0
2022,1,Makkah Region,Veterinary Activities,small,13,52,13,39,131,119,12
2022,1,Makkah Region,Veterinary Activities,micro,49,23,8,15,88,84,4
2022,1,Makkah Region,Veterinary Activities,medium,2,35,17,18,72,59,13
2022,1,Najran Region,Veterinary Activities,small,1,0,0,0,7,7,0
2022,1,Najran Region,Veterinary Activities,micro,7,0,0,0,14,14,0
2022,1,Eastern Province,Rental and Leasing Activities,small,286,848,515,333,3226,3218,8
2022,1,Eastern Province,Rental and Leasing Activities,large,8,900,704,196,2582,2581,1
2022,1,Eastern Province,Rental and Leasing Activities,micro,2022,413,220,193,4149,4141,8
2022,1,Eastern Province,Rental and Leasing Activities,medium,38,941,738,203,2868,2866,2
2022,1,Al Bahah Region,Rental and Leasing Activities,small,6,7,2,5,60,60,0
2022,1,Al Bahah Region,Rental and Leasing Activities,micro,139,22,16,6,285,283,2
2022,1,Al Jawf Region,Rental and Leasing Activities,small,28,25,18,7,192,191,1
2022,1,Al Jawf Region,Rental and Leasing Activities,micro,610,42,29,13,1228,1220,8
2022,1,Northern Borders Region,Rental and Leasing Activities,small,8,29,18,11,45,45,0
2022,1,Northern Borders Region,Rental and Leasing Activities,micro,235,26,17,9,479,475,4
2022,1,Riyadh Region,Rental and Leasing Activities,small,1145,1264,700,564,9762,9691,71
2022,1,Riyadh Region,Rental and Leasing Activities,large,13,2453,2054,399,4911,4907,4
2022,1,Riyadh Region,Rental and Leasing Activities,micro,55130,3184,1566,1618,136702,136097,605
2022,1,Riyadh Region,Rental and Leasing Activities,medium,51,1036,752,284,4042,4031,11
2022,1,Qassim Region,Rental and Leasing Activities,small,70,92,55,37,599,598,1
2022,1,Qassim Region,Rental and Leasing Activities,large,2,119,106,13,511,511,0
2022,1,Qassim Region,Rental and Leasing Activities,micro,1205,175,107,68,2734,2726,8
2022,1,Qassim Region,Rental and Leasing Activities,medium,6,88,79,9,492,492,0
2022,1,Al Madinah Region,Rental and Leasing Activities,small,83,181,94,87,865,859,6
2022,1,Al Madinah Region,Rental and Leasing Activities,large,1,97,70,27,283,283,0
2022,1,Al Madinah Region,Rental and Leasing Activities,micro,988,121,72,49,2081,2067,14
2022,1,Al Madinah Region,Rental and Leasing Activities,medium,4,128,100,28,339,339,0
2022,1,Tabuk Region,Rental and Leasing Activities,small,8,25,8,17,88,88,0
2022,1,Tabuk Region,Rental and Leasing Activities,micro,461,55,35,20,850,848,2
2022,1,Tabuk Region,Rental and Leasing Activities,medium,1,67,66,1,132,132,0
2022,1,Jazan Region,Rental and Leasing Activities,small,29,40,26,14,264,262,2
2022,1,Jazan Region,Rental and Leasing Activities,micro,1228,85,42,43,2869,2856,13
2022,1,Jazan Region,Rental and Leasing Activities,medium,2,20,12,8,116,100,16
2022,1,Hail Region,Rental and Leasing Activities,small,41,13,8,5,313,310,3
2022,1,Hail Region,Rental and Leasing Activities,micro,903,74,35,39,2164,2154,10
2022,1,Hail Region,Rental and Leasing Activities,medium,1,11,11,0,53,53,0
2022,1,Aseer Region,Rental and Leasing Activities,small,69,122,83,39,553,551,2
2022,1,Aseer Region,Rental and Leasing Activities,micro,1381,161,101,60,2586,2577,9
2022,1,Aseer Region,Rental and Leasing Activities,medium,2,44,29,15,71,71,0
2022,1,Makkah Region,Rental and Leasing Activities,small,252,689,415,274,2515,2487,28
2022,1,Makkah Region,Rental and Leasing Activities,large,4,939,836,103,1577,1575,2
2022,1,Makkah Region,Rental and Leasing Activities,micro,3343,425,245,180,7142,7048,94
2022,1,Makkah Region,Rental and Leasing Activities,medium,20,523,372,151,1431,1429,2
2022,1,Najran Region,Rental and Leasing Activities,small,58,45,20,25,511,509,2
2022,1,Najran Region,Rental and Leasing Activities,micro,1317,97,50,47,3096,3073,23
2022,1,Eastern Province,"Office Administrative, Office Support, and Other Business Support Activities",small,132,669,345,324,1168,1148,20
2022,1,Eastern Province,"Office Administrative, Office Support, and Other Business Support Activities",large,3,709,468,241,1343,1337,6
2022,1,Eastern Province,"Office Administrative, Office Support, and Other Business Support Activities",micro,572,371,162,209,901,878,23
2022,1,Eastern Province,"Office Administrative, Office Support, and Other Business Support Activities",medium,18,844,595,249,955,944,11
2022,1,Al Bahah Region,"Office Administrative, Office Support, and Other Business Support Activities",small,6,34,26,8,41,41,0
2022,1,Al Bahah Region,"Office Administrative, Office Support, and Other Business Support Activities",micro,34,8,4,4,58,58,0
2022,1,Al Bahah Region,"Office Administrative, Office Support, and Other Business Support Activities",medium,1,59,27,32,180,180,0
2022,1,Al Jawf Region,"Office Administrative, Office Support, and Other Business Support Activities",small,5,12,8,4,52,52,0
2022,1,Al Jawf Region,"Office Administrative, Office Support, and Other Business Support Activities",micro,59,26,17,9,94,93,1
2022,1,Northern Borders Region,"Office Administrative, Office Support, and Other Business Support Activities",small,5,32,3,29,44,44,0
2022,1,Northern Borders Region,"Office Administrative, Office Support, and Other Business Support Activities",micro,35,9,5,4,69,69,0
2022,1,Riyadh Region,"Office Administrative, Office Support, and Other Business Support Activities",small,511,2878,1255,1623,4507,4295,212
2022,1,Riyadh Region,"Office Administrative, Office Support, and Other Business Support Activities",large,11,3915,2697,1218,3897,3697,200
2022,1,Riyadh Region,"Office Administrative, Office Support, and Other Business Support Activities",micro,1864,1235,606,629,2980,2853,127
2022,1,Riyadh Region,"Office Administrative, Office Support, and Other Business Support Activities",medium,40,1640,828,812,2213,2083,130
2022,1,Qassim Region,"Office Administrative, Office Support, and Other Business Support Activities",small,24,91,45,46,248,237,11
2022,1,Qassim Region,"Office Administrative, Office Support, and Other Business Support Activities",micro,177,73,44,29,296,294,2
2022,1,Qassim Region,"Office Administrative, Office Support, and Other Business Support Activities",medium,1,0,0,0,107,107,0
2022,1,Al Madinah Region,"Office Administrative, Office Support, and Other Business Support Activities",small,32,115,46,69,264,253,11
2022,1,Al Madinah Region,"Office Administrative, Office Support, and Other Business Support Activities",micro,220,110,64,46,380,365,15
2022,1,Al Madinah Region,"Office Administrative, Office Support, and Other Business Support Activities",medium,5,161,115,46,372,370,2
2022,1,Tabuk Region,"Office Administrative, Office Support, and Other Business Support Activities",small,11,37,16,21,73,68,5
2022,1,Tabuk Region,"Office Administrative, Office Support, and Other Business Support Activities",micro,83,23,7,16,134,133,1
2022,1,Jazan Region,"Office Administrative, Office Support, and Other Business Support Activities",small,4,22,15,7,40,40,0
2022,1,Jazan Region,"Office Administrative, Office Support, and Other Business Support Activities",micro,78,19,12,7,161,160,1
2022,1,Hail Region,"Office Administrative, Office Support, and Other Business Support Activities",small,9,13,10,3,62,62,0
2022,1,Hail Region,"Office Administrative, Office Support, and Other Business Support Activities",micro,130,38,19,19,236,229,7
2022,1,Hail Region,"Office Administrative, Office Support, and Other Business Support Activities",medium,1,12,2,10,55,55,0
2022,1,Aseer Region,"Office Administrative, Office Support, and Other Business Support Activities",small,23,63,31,32,196,195,1
2022,1,Aseer Region,"Office Administrative, Office Support, and Other Business Support Activities",micro,211,80,41,39,334,329,5
2022,1,Aseer Region,"Office Administrative, Office Support, and Other Business Support Activities",medium,1,22,18,4,32,32,0
2022,1,Makkah Region,"Office Administrative, Office Support, and Other Business Support Activities",small,264,1242,607,635,2221,2080,141
2022,1,Makkah Region,"Office Administrative, Office Support, and Other Business Support Activities",large,5,3020,2022,998,1183,1134,49
2022,1,Makkah Region,"Office Administrative, Office Support, and Other Business Support Activities",micro,1208,609,302,307,2161,2070,91
2022,1,Makkah Region,"Office Administrative, Office Support, and Other Business Support Activities",medium,27,965,505,460,1706,1644,62
2022,1,Najran Region,"Office Administrative, Office Support, and Other Business Support Activities",small,3,3,3,0,17,14,3
2022,1,Najran Region,"Office Administrative, Office Support, and Other Business Support Activities",micro,70,24,10,14,126,125,1
2022,1,Eastern Province,Other Mining and Quarrying Activities,small,41,158,83,75,525,521,4
2022,1,Eastern Province,Other Mining and Quarrying Activities,large,3,1325,1060,265,3672,3670,2
2022,1,Eastern Province,Other Mining and Quarrying Activities,micro,73,56,36,20,122,121,1
2022,1,Eastern Province,Other Mining and Quarrying Activities,medium,12,365,283,82,921,920,1
2022,1,Al Bahah Region,Other Mining and Quarrying Activities,small,3,15,6,9,65,65,0
2022,1,Al Bahah Region,Other Mining and Quarrying Activities,micro,1,1,0,1,3,3,0
2022,1,Al Bahah Region,Other Mining and Quarrying Activities,medium,1,15,9,6,35,35,0
2022,1,Al Jawf Region,Other Mining and Quarrying Activities,small,1,6,3,3,38,38,0
2022,1,Al Jawf Region,Other Mining and Quarrying Activities,micro,10,3,3,0,13,13,0
2022,1,Al Jawf Region,Other Mining and Quarrying Activities,medium,1,10,10,0,45,45,0
2022,1,Northern Borders Region,Other Mining and Quarrying Activities,small,4,11,8,3,73,73,0
2022,1,Northern Borders Region,Other Mining and Quarrying Activities,micro,6,3,3,0,8,8,0
2022,1,Northern Borders Region,Other Mining and Quarrying Activities,medium,1,13,4,9,40,40,0
2022,1,Riyadh Region,Other Mining and Quarrying Activities,small,130,508,257,251,1717,1711,6
2022,1,Riyadh Region,Other Mining and Quarrying Activities,large,7,762,456,306,2572,2572,0
2022,1,Riyadh Region,Other Mining and Quarrying Activities,micro,201,134,81,53,309,305,4
2022,1,Riyadh Region,Other Mining and Quarrying Activities,medium,25,674,404,270,1861,1861,0
2022,1,Qassim Region,Other Mining and Quarrying Activities,small,8,46,26,20,132,131,1
2022,1,Qassim Region,Other Mining and Quarrying Activities,micro,21,10,4,6,32,32,0
2022,1,Qassim Region,Other Mining and Quarrying Activities,medium,2,61,34,27,161,161,0
2022,1,Al Madinah Region,Other Mining and Quarrying Activities,small,20,114,87,27,325,325,0
2022,1,Al Madinah Region,Other Mining and Quarrying Activities,large,2,344,333,11,607,607,0
2022,1,Al Madinah Region,Other Mining and Quarrying Activities,micro,39,27,17,10,68,68,0
2022,1,Al Madinah Region,Other Mining and Quarrying Activities,medium,2,36,32,4,86,86,0
2022,1,Tabuk Region,Other Mining and Quarrying Activities,small,5,21,13,8,47,47,0
2022,1,Tabuk Region,Other Mining and Quarrying Activities,micro,4,4,3,1,4,4,0
2022,1,Tabuk Region,Other Mining and Quarrying Activities,medium,1,29,16,13,128,127,1
2022,1,Jazan Region,Other Mining and Quarrying Activities,small,10,38,20,18,150,150,0
2022,1,Jazan Region,Other Mining and Quarrying Activities,micro,19,9,6,3,33,33,0
2022,1,Jazan Region,Other Mining and Quarrying Activities,medium,2,37,15,22,148,148,0
2022,1,Hail Region,Other Mining and Quarrying Activities,small,2,3,3,0,11,11,0
2022,1,Hail Region,Other Mining and Quarrying Activities,micro,15,3,1,2,22,22,0
2022,1,Aseer Region,Other Mining and Quarrying Activities,small,21,84,71,13,221,220,1
2022,1,Aseer Region,Other Mining and Quarrying Activities,micro,43,22,13,9,72,72,0
2022,1,Makkah Region,Other Mining and Quarrying Activities,small,52,195,107,88,599,597,2
2022,1,Makkah Region,Other Mining and Quarrying Activities,large,6,1901,1757,144,1722,1721,1
2022,1,Makkah Region,Other Mining and Quarrying Activities,micro,104,70,45,25,159,158,1
2022,1,Makkah Region,Other Mining and Quarrying Activities,medium,8,126,68,58,554,552,2
2022,1,Najran Region,Other Mining and Quarrying Activities,small,8,13,8,5,115,115,0
2022,1,Najran Region,Other Mining and Quarrying Activities,micro,12,8,5,3,17,17,0
2022,1,Najran Region,Other Mining and Quarrying Activities,medium,1,18,15,3,47,47,0
2022,1,Eastern Province,"Creative, Arts, and Entertainment Activities",small,5,14,7,7,40,39,1
2022,1,Eastern Province,"Creative, Arts, and Entertainment Activities",micro,27,16,8,8,41,36,5
2022,1,Al Bahah Region,"Creative, Arts, and Entertainment Activities",micro,2,1,1,0,4,4,0
2022,1,Al Jawf Region,"Creative, Arts, and Entertainment Activities",micro,3,1,0,1,4,4,0
2022,1,Riyadh Region,"Creative, Arts, and Entertainment Activities",small,21,82,25,57,173,159,14
2022,1,Riyadh Region,"Creative, Arts, and Entertainment Activities",large,2,189,147,42,769,765,4
2022,1,Riyadh Region,"Creative, Arts, and Entertainment Activities",micro,90,60,30,30,121,112,9
2022,1,Riyadh Region,"Creative, Arts, and Entertainment Activities",medium,2,154,116,38,143,140,3
2022,1,Qassim Region,"Creative, Arts, and Entertainment Activities",micro,4,1,1,0,9,9,0
2022,1,Al Madinah Region,"Creative, Arts, and Entertainment Activities",small,1,0,0,0,9,9,0
2022,1,Al Madinah Region,"Creative, Arts, and Entertainment Activities",micro,16,3,1,2,22,21,1
2022,1,Tabuk Region,"Creative, Arts, and Entertainment Activities",micro,1,1,0,1,0,0,0
2022,1,Jazan Region,"Creative, Arts, and Entertainment Activities",micro,1,1,1,0,2,2,0
2022,1,Hail Region,"Creative, Arts, and Entertainment Activities",micro,1,0,0,0,1,1,0
2022,1,Aseer Region,"Creative, Arts, and Entertainment Activities",small,2,22,4,18,8,8,0
2022,1,Aseer Region,"Creative, Arts, and Entertainment Activities",micro,10,5,4,1,20,20,0
2022,1,Makkah Region,"Creative, Arts, and Entertainment Activities",small,9,28,17,11,66,66,0
2022,1,Makkah Region,"Creative, Arts, and Entertainment Activities",micro,87,65,25,40,138,125,13
2022,1,Makkah Region,"Creative, Arts, and Entertainment Activities",medium,2,48,27,21,175,174,1
2022,1,Najran Region,"Creative, Arts, and Entertainment Activities",micro,2,0,0,0,5,5,0
2022,1,Eastern Province,Accommodation,small,210,1089,635,454,2013,1996,17
2022,1,Eastern Province,Accommodation,large,2,180,136,44,484,446,38
2022,1,Eastern Province,Accommodation,micro,262,239,140,99,420,414,6
2022,1,Eastern Province,Accommodation,medium,32,1215,671,544,2164,2105,59
2022,1,Al Bahah Region,Accommodation,small,20,68,44,24,202,202,0
2022,1,Al Bahah Region,Accommodation,micro,55,41,29,12,97,97,0
2022,1,Al Bahah Region,Accommodation,medium,1,26,13,13,45,45,0
2022,1,Al Jawf Region,Accommodation,small,11,19,10,9,70,70,0
2022,1,Al Jawf Region,Accommodation,micro,47,19,14,5,86,86,0
2022,1,Al Jawf Region,Accommodation,medium,1,16,8,8,49,49,0
2022,1,Northern Borders Region,Accommodation,small,10,37,19,18,87,87,0
2022,1,Northern Borders Region,Accommodation,micro,30,14,12,2,45,45,0
2022,1,Northern Borders Region,Accommodation,medium,1,18,13,5,43,43,0
2022,1,Riyadh Region,Accommodation,small,312,1617,850,767,3499,3462,37
2022,1,Riyadh Region,Accommodation,large,10,2249,1287,962,3507,3423,84
2022,1,Riyadh Region,Accommodation,micro,590,452,249,203,1051,1038,13
2022,1,Riyadh Region,Accommodation,medium,69,2427,1500,927,4653,4579,74
2022,1,Qassim Region,Accommodation,small,50,241,160,81,471,471,0
2022,1,Qassim Region,Accommodation,large,1,0,0,0,317,315,2
2022,1,Qassim Region,Accommodation,micro,94,74,56,18,175,175,0
2022,1,Qassim Region,Accommodation,medium,4,101,55,46,180,180,0
2022,1,Al Madinah Region,Accommodation,small,128,667,473,194,1294,1279,15
2022,1,Al Madinah Region,Accommodation,large,4,513,357,156,775,765,10
2022,1,Al Madinah Region,Accommodation,micro,285,214,156,58,444,436,8
2022,1,Al Madinah Region,Accommodation,medium,31,1101,813,288,2052,2040,12
2022,1,Tabuk Region,Accommodation,small,33,193,105,88,284,284,0
2022,1,Tabuk Region,Accommodation,large,1,114,59,55,140,133,7
2022,1,Tabuk Region,Accommodation,micro,84,81,47,34,140,140,0
2022,1,Tabuk Region,Accommodation,medium,3,96,54,42,179,179,0
2022,1,Jazan Region,Accommodation,small,38,160,84,76,395,382,13
2022,1,Jazan Region,Accommodation,micro,215,138,75,63,327,325,2
2022,1,Jazan Region,Accommodation,medium,5,194,80,114,266,226,40
2022,1,Hail Region,Accommodation,small,20,84,64,20,197,197,0
2022,1,Hail Region,Accommodation,micro,58,38,23,15,113,112,1
2022,1,Hail Region,Accommodation,medium,1,24,16,8,92,92,0
2022,1,Aseer Region,Accommodation,small,85,306,179,127,693,686,7
2022,1,Aseer Region,Accommodation,large,1,1,1,0,251,251,0
2022,1,Aseer Region,Accommodation,micro,297,198,132,66,482,481,1
2022,1,Aseer Region,Accommodation,medium,6,157,111,46,340,337,3
2022,1,Makkah Region,Accommodation,small,453,2011,1199,812,4463,4351,112
2022,1,Makkah Region,Accommodation,large,14,2032,1510,522,3043,2996,47
2022,1,Makkah Region,Accommodation,micro,944,751,486,265,1560,1532,28
2022,1,Makkah Region,Accommodation,medium,74,2783,1985,798,5186,5076,110
2022,1,Najran Region,Accommodation,small,21,111,58,53,195,193,2
2022,1,Najran Region,Accommodation,micro,89,49,31,18,196,196,0
2022,1,Najran Region,Accommodation,medium,3,93,18,75,275,272,3
2022,1,Eastern Province,Public Administration and Defense; Compulsory Social Security,small,51,720,550,170,344,328,16
2022,1,Eastern Province,Public Administration and Defense; Compulsory Social Security,large,21,13451,10839,2612,6042,4398,1644
2022,1,Eastern Province,Public Administration and Defense; Compulsory Social Security,micro,136,111,76,35,204,201,3
2022,1,Eastern Province,Public Administration and Defense; Compulsory Social Security,medium,33,2425,2039,386,1502,1448,54
2022,1,Al Bahah Region,Public Administration and Defense; Compulsory Social Security,small,4,71,51,20,24,23,1
2022,1,Al Bahah Region,Public Administration and Defense; Compulsory Social Security,large,3,581,423,158,560,559,1
2022,1,Al Bahah Region,Public Administration and Defense; Compulsory Social Security,micro,11,7,7,0,24,24,0
2022,1,Al Bahah Region,Public Administration and Defense; Compulsory Social Security,medium,13,470,397,73,1142,1123,19
2022,1,Al Jawf Region,Public Administration and Defense; Compulsory Social Security,small,7,77,68,9,15,15,0
2022,1,Al Jawf Region,Public Administration and Defense; Compulsory Social Security,large,3,490,405,85,800,618,182
2022,1,Al Jawf Region,Public Administration and Defense; Compulsory Social Security,micro,18,12,5,7,23,22,1
2022,1,Al Jawf Region,Public Administration and Defense; Compulsory Social Security,medium,13,940,772,168,857,826,31
2022,1,Northern Borders Region,Public Administration and Defense; Compulsory Social Security,small,7,52,44,8,56,56,0
2022,1,Northern Borders Region,Public Administration and Defense; Compulsory Social Security,large,3,807,364,443,291,291,0
2022,1,Northern Borders Region,Public Administration and Defense; Compulsory Social Security,micro,8,9,8,1,4,4,0
2022,1,Northern Borders Region,Public Administration and Defense; Compulsory Social Security,medium,10,340,301,39,922,921,1
2022,1,Riyadh Region,Public Administration and Defense; Compulsory Social Security,small,187,3110,2330,780,837,781,56
2022,1,Riyadh Region,Public Administration and Defense; Compulsory Social Security,large,72,111882,92829,19053,9423,6740,2683
2022,1,Riyadh Region,Public Administration and Defense; Compulsory Social Security,micro,326,255,164,91,508,491,17
2022,1,Riyadh Region,Public Administration and Defense; Compulsory Social Security,medium,120,12340,9843,2497,1962,1890,72
2022,1,Qassim Region,Public Administration and Defense; Compulsory Social Security,small,10,115,74,41,70,59,11
2022,1,Qassim Region,Public Administration and Defense; Compulsory Social Security,large,12,2194,1577,617,3963,3956,7
2022,1,Qassim Region,Public Administration and Defense; Compulsory Social Security,micro,29,12,7,5,65,62,3
2022,1,Qassim Region,Public Administration and Defense; Compulsory Social Security,medium,20,556,428,128,1905,1896,9
2022,1,Al Madinah Region,Public Administration and Defense; Compulsory Social Security,small,19,225,199,26,91,90,1
2022,1,Al Madinah Region,Public Administration and Defense; Compulsory Social Security,large,3,514,449,65,1070,1070,0
2022,1,Al Madinah Region,Public Administration and Defense; Compulsory Social Security,micro,46,20,15,5,105,103,2
2022,1,Al Madinah Region,Public Administration and Defense; Compulsory Social Security,medium,13,446,407,39,1057,1057,0
2022,1,Tabuk Region,Public Administration and Defense; Compulsory Social Security,small,8,122,101,21,36,35,1
2022,1,Tabuk Region,Public Administration and Defense; Compulsory Social Security,large,1,318,182,136,0,0,0
2022,1,Tabuk Region,Public Administration and Defense; Compulsory Social Security,micro,20,5,3,2,53,53,0
2022,1,Tabuk Region,Public Administration and Defense; Compulsory Social Security,medium,11,746,566,180,481,481,0
2022,1,Jazan Region,Public Administration and Defense; Compulsory Social Security,small,14,212,201,11,107,103,4
2022,1,Jazan Region,Public Administration and Defense; Compulsory Social Security,large,3,1538,980,558,0,0,0
2022,1,Jazan Region,Public Administration and Defense; Compulsory Social Security,micro,41,13,10,3,107,107,0
2022,1,Jazan Region,Public Administration and Defense; Compulsory Social Security,medium,15,1133,1088,45,590,590,0
2022,1,Hail Region,Public Administration and Defense; Compulsory Social Security,small,4,52,34,18,11,11,0
2022,1,Hail Region,Public Administration and Defense; Compulsory Social Security,large,3,3212,2707,505,428,428,0
2022,1,Hail Region,Public Administration and Defense; Compulsory Social Security,micro,20,12,12,0,34,34,0
2022,1,Hail Region,Public Administration and Defense; Compulsory Social Security,medium,17,857,824,33,1876,1875,1
2022,1,Aseer Region,Public Administration and Defense; Compulsory Social Security,small,13,235,213,22,52,52,0
2022,1,Aseer Region,Public Administration and Defense; Compulsory Social Security,large,19,5925,4335,1590,6748,6171,577
2022,1,Aseer Region,Public Administration and Defense; Compulsory Social Security,micro,25,6,4,2,72,72,0
2022,1,Aseer Region,Public Administration and Defense; Compulsory Social Security,medium,30,1707,1276,431,3136,3135,1
2022,1,Makkah Region,Public Administration and Defense; Compulsory Social Security,small,90,841,653,188,549,539,10
2022,1,Makkah Region,Public Administration and Defense; Compulsory Social Security,large,27,20952,12582,8370,9483,5125,4358
2022,1,Makkah Region,Public Administration and Defense; Compulsory Social Security,micro,292,157,107,50,499,483,16
2022,1,Makkah Region,Public Administration and Defense; Compulsory Social Security,medium,41,2849,2321,528,2230,2161,69
2022,1,Najran Region,Public Administration and Defense; Compulsory Social Security,small,5,91,69,22,17,17,0
2022,1,Najran Region,Public Administration and Defense; Compulsory Social Security,large,5,1336,1118,218,1741,1146,595
2022,1,Najran Region,Public Administration and Defense; Compulsory Social Security,micro,34,16,16,0,54,54,0
2022,1,Najran Region,Public Administration and Defense; Compulsory Social Security,medium,16,1345,1179,166,754,754,0
2022,1,Eastern Province,Telecommunications,small,31,156,89,67,264,258,6
2022,1,Eastern Province,Telecommunications,micro,83,54,31,23,129,129,0
2022,1,Eastern Province,Telecommunications,medium,3,91,75,16,157,157,0
2022,1,Al Bahah Region,Telecommunications,small,1,4,1,3,9,9,0
2022,1,Al Bahah Region,Telecommunications,micro,4,1,1,0,6,6,0
2022,1,Al Jawf Region,Telecommunications,small,1,1,1,0,6,6,0
2022,1,Al Jawf Region,Telecommunications,micro,18,3,2,1,34,34,0
2022,1,Northern Borders Region,Telecommunications,small,2,5,0,5,16,16,0
2022,1,Northern Borders Region,Telecommunications,micro,13,5,3,2,27,26,1
2022,1,Riyadh Region,Telecommunications,small,137,904,480,424,1604,1538,66
2022,1,Riyadh Region,Telecommunications,large,14,20807,16585,4222,3120,3054,66
2022,1,Riyadh Region,Telecommunications,micro,326,183,110,73,586,569,17
2022,1,Riyadh Region,Telecommunications,medium,33,2310,1648,662,1512,1480,32
2022,1,Qassim Region,Telecommunications,small,13,14,10,4,156,156,0
2022,1,Qassim Region,Telecommunications,micro,52,19,10,9,100,100,0
2022,1,Qassim Region,Telecommunications,medium,1,0,0,0,50,50,0
2022,1,Al Madinah Region,Telecommunications,small,1,15,0,15,1,0,1
2022,1,Al Madinah Region,Telecommunications,micro,42,15,10,5,69,67,2
2022,1,Tabuk Region,Telecommunications,micro,19,2,2,0,38,38,0
2022,1,Jazan Region,Telecommunications,small,1,3,3,0,7,7,0
2022,1,Jazan Region,Telecommunications,micro,21,4,3,1,37,37,0
2022,1,Hail Region,Telecommunications,small,1,3,2,1,3,3,0
2022,1,Hail Region,Telecommunications,micro,23,7,1,6,51,50,1
2022,1,Aseer Region,Telecommunications,small,4,7,2,5,42,42,0
2022,1,Aseer Region,Telecommunications,micro,42,8,6,2,78,77,1
2022,1,Makkah Region,Telecommunications,small,42,183,83,100,408,405,3
2022,1,Makkah Region,Telecommunications,micro,230,89,55,34,388,380,8
2022,1,Makkah Region,Telecommunications,medium,2,61,26,35,141,129,12
2022,1,Najran Region,Telecommunications,small,3,0,0,0,48,46,2
2022,1,Najran Region,Telecommunications,micro,18,3,0,3,34,34,0
2022,1,Eastern Province,Repair and Installation of Machinery and Equipment,small,230,840,590,250,2747,2742,5
2022,1,Eastern Province,Repair and Installation of Machinery and Equipment,large,20,2947,2382,565,9583,9565,18
2022,1,Eastern Province,Repair and Installation of Machinery and Equipment,micro,690,284,152,132,1396,1393,3
2022,1,Eastern Province,Repair and Installation of Machinery and Equipment,medium,54,1712,1386,326,3706,3702,4
2022,1,Al Bahah Region,Repair and Installation of Machinery and Equipment,small,1,2,1,1,11,11,0
2022,1,Al Bahah Region,Repair and Installation of Machinery and Equipment,micro,33,7,6,1,56,56,0
2022,1,Al Jawf Region,Repair and Installation of Machinery and Equipment,small,5,3,1,2,33,33,0
2022,1,Al Jawf Region,Repair and Installation of Machinery and Equipment,micro,39,8,5,3,77,77,0
2022,1,Northern Borders Region,Repair and Installation of Machinery and Equipment,small,3,15,12,3,5,5,0
2022,1,Northern Borders Region,Repair and Installation of Machinery and Equipment,micro,44,2,2,0,121,121,0
2022,1,Riyadh Region,Repair and Installation of Machinery and Equipment,small,219,885,517,368,2726,2712,14
2022,1,Riyadh Region,Repair and Installation of Machinery and Equipment,large,13,4305,3898,407,3955,3934,21
2022,1,Riyadh Region,Repair and Installation of Machinery and Equipment,micro,873,265,142,123,1878,1868,10
2022,1,Riyadh Region,Repair and Installation of Machinery and Equipment,medium,52,1855,1537,318,3993,3939,54
2022,1,Qassim Region,Repair and Installation of Machinery and Equipment,small,24,45,21,24,228,228,0
2022,1,Qassim Region,Repair and Installation of Machinery and Equipment,micro,195,40,30,10,436,436,0
2022,1,Qassim Region,Repair and Installation of Machinery and Equipment,medium,5,122,88,34,439,439,0
2022,1,Al Madinah Region,Repair and Installation of Machinery and Equipment,small,22,63,37,26,177,176,1
2022,1,Al Madinah Region,Repair and Installation of Machinery and Equipment,large,1,59,26,33,224,224,0
2022,1,Al Madinah Region,Repair and Installation of Machinery and Equipment,micro,208,33,27,6,402,399,3
2022,1,Al Madinah Region,Repair and Installation of Machinery and Equipment,medium,2,25,15,10,112,112,0
2022,1,Tabuk Region,Repair and Installation of Machinery and Equipment,small,2,25,24,1,30,30,0
2022,1,Tabuk Region,Repair and Installation of Machinery and Equipment,micro,88,16,11,5,184,182,2
2022,1,Jazan Region,Repair and Installation of Machinery and Equipment,small,12,9,5,4,96,95,1
2022,1,Jazan Region,Repair and Installation of Machinery and Equipment,micro,276,25,17,8,670,670,0
2022,1,Hail Region,Repair and Installation of Machinery and Equipment,small,5,8,3,5,31,31,0
2022,1,Hail Region,Repair and Installation of Machinery and Equipment,micro,62,8,6,2,139,138,1
2022,1,Aseer Region,Repair and Installation of Machinery and Equipment,small,14,27,24,3,119,119,0
2022,1,Aseer Region,Repair and Installation of Machinery and Equipment,large,1,55,41,14,235,235,0
2022,1,Aseer Region,Repair and Installation of Machinery and Equipment,micro,153,31,20,11,356,354,2
2022,1,Aseer Region,Repair and Installation of Machinery and Equipment,medium,1,15,15,0,134,134,0
2022,1,Makkah Region,Repair and Installation of Machinery and Equipment,small,119,368,226,142,1334,1325,9
2022,1,Makkah Region,Repair and Installation of Machinery and Equipment,large,2,387,361,26,303,303,0
2022,1,Makkah Region,Repair and Installation of Machinery and Equipment,micro,785,161,78,83,1735,1731,4
2022,1,Makkah Region,Repair and Installation of Machinery and Equipment,medium,25,1099,893,206,1743,1736,7
2022,1,Najran Region,Repair and Installation of Machinery and Equipment,small,6,6,0,6,42,42,0
2022,1,Najran Region,Repair and Installation of Machinery and Equipment,micro,35,3,3,0,84,84,0
2022,1,Eastern Province,Repair of Computers and Personal and Household Goods,small,136,213,139,74,1622,1614,8
2022,1,Eastern Province,Repair of Computers and Personal and Household Goods,micro,784,212,127,85,1628,1626,2
2022,1,Eastern Province,Repair of Computers and Personal and Household Goods,medium,13,342,266,76,1087,1087,0
2022,1,Al Bahah Region,Repair of Computers and Personal and Household Goods,small,2,8,8,0,7,7,0
2022,1,Al Bahah Region,Repair of Computers and Personal and Household Goods,micro,54,20,14,6,107,107,0
2022,1,Al Jawf Region,Repair of Computers and Personal and Household Goods,small,14,11,9,2,157,157,0
2022,1,Al Jawf Region,Repair of Computers and Personal and Household Goods,micro,116,20,12,8,255,255,0
2022,1,Al Jawf Region,Repair of Computers and Personal and Household Goods,medium,2,0,0,0,183,183,0
2022,1,Northern Borders Region,Repair of Computers and Personal and Household Goods,small,2,2,1,1,11,11,0
2022,1,Northern Borders Region,Repair of Computers and Personal and Household Goods,micro,71,14,10,4,157,157,0
2022,1,Riyadh Region,Repair of Computers and Personal and Household Goods,small,481,487,253,234,6497,6469,28
2022,1,Riyadh Region,Repair of Computers and Personal and Household Goods,large,47,580,476,104,28017,28011,6
2022,1,Riyadh Region,Repair of Computers and Personal and Household Goods,micro,1711,289,141,148,4083,4063,20
2022,1,Riyadh Region,Repair of Computers and Personal and Household Goods,medium,158,149,71,78,20275,20178,97
2022,1,Qassim Region,Repair of Computers and Personal and Household Goods,small,214,94,55,39,3355,3346,9
2022,1,Qassim Region,Repair of Computers and Personal and Household Goods,large,7,11,2,9,5606,5606,0
2022,1,Qassim Region,Repair of Computers and Personal and Household Goods,micro,513,76,48,28,1266,1263,3
2022,1,Qassim Region,Repair of Computers and Personal and Household Goods,medium,49,15,5,10,5040,5033,7
2022,1,Al Madinah Region,Repair of Computers and Personal and Household Goods,small,38,57,41,16,335,331,4
2022,1,Al Madinah Region,Repair of Computers and Personal and Household Goods,micro,290,66,42,24,608,603,5
2022,1,Tabuk Region,Repair of Computers and Personal and Household Goods,small,27,42,24,18,231,230,1
2022,1,Tabuk Region,Repair of Computers and Personal and Household Goods,micro,234,31,21,10,522,521,1
2022,1,Tabuk Region,Repair of Computers and Personal and Household Goods,medium,2,1,1,0,253,253,0
2022,1,Jazan Region,Repair of Computers and Personal and Household Goods,small,21,25,21,4,209,208,1
2022,1,Jazan Region,Repair of Computers and Personal and Household Goods,micro,235,41,28,13,556,554,2
2022,1,Hail Region,Repair of Computers and Personal and Household Goods,small,48,22,15,7,435,432,3
2022,1,Hail Region,Repair of Computers and Personal and Household Goods,micro,279,40,27,13,643,632,11
2022,1,Hail Region,Repair of Computers and Personal and Household Goods,medium,1,0,0,0,57,57,0
2022,1,Aseer Region,Repair of Computers and Personal and Household Goods,small,56,54,44,10,605,603,2
2022,1,Aseer Region,Repair of Computers and Personal and Household Goods,micro,397,68,42,26,891,890,1
2022,1,Makkah Region,Repair of Computers and Personal and Household Goods,small,142,199,120,79,1288,1275,13
2022,1,Makkah Region,Repair of Computers and Personal and Household Goods,micro,1215,262,151,111,2582,2555,27
2022,1,Makkah Region,Repair of Computers and Personal and Household Goods,medium,7,185,135,50,517,513,4
2022,1,Najran Region,Repair of Computers and Personal and Household Goods,small,76,24,11,13,1031,1027,4
2022,1,Najran Region,Repair of Computers and Personal and Household Goods,large,2,0,0,0,797,797,0
2022,1,Najran Region,Repair of Computers and Personal and Household Goods,micro,171,26,11,15,377,377,0
2022,1,Najran Region,Repair of Computers and Personal and Household Goods,medium,14,2,1,1,1466,1465,1
2022,1,Eastern Province,Extraction of Crude Petroleum and Natural Gas,small,20,115,91,24,205,204,1
2022,1,Eastern Province,Extraction of Crude Petroleum and Natural Gas,large,6,64559,61447,3112,7540,6914,626
2022,1,Eastern Province,Extraction of Crude Petroleum and Natural Gas,micro,22,16,8,8,40,39,1
2022,1,Eastern Province,Extraction of Crude Petroleum and Natural Gas,medium,11,586,549,37,481,476,5
2022,1,Al Jawf Region,Extraction of Crude Petroleum and Natural Gas,micro,4,0,0,0,11,11,0
2022,1,Riyadh Region,Extraction of Crude Petroleum and Natural Gas,small,5,2,2,0,77,77,0
2022,1,Riyadh Region,Extraction of Crude Petroleum and Natural Gas,micro,15,7,4,3,32,32,0
2022,1,Riyadh Region,Extraction of Crude Petroleum and Natural Gas,medium,1,49,38,11,54,54,0
2022,1,Qassim Region,Extraction of Crude Petroleum and Natural Gas,micro,1,1,0,1,4,4,0
2022,1,Al Madinah Region,Extraction of Crude Petroleum and Natural Gas,micro,2,0,0,0,4,4,0
2022,1,Jazan Region,Extraction of Crude Petroleum and Natural Gas,small,1,3,3,0,5,5,0
2022,1,Aseer Region,Extraction of Crude Petroleum and Natural Gas,micro,3,3,1,2,3,3,0
2022,1,Makkah Region,Extraction of Crude Petroleum and Natural Gas,small,2,2,1,1,13,13,0
2022,1,Makkah Region,Extraction of Crude Petroleum and Natural Gas,large,1,515,498,17,102,102,0
2022,1,Makkah Region,Extraction of Crude Petroleum and Natural Gas,micro,1,0,0,0,3,3,0
2022,1,Najran Region,Extraction of Crude Petroleum and Natural Gas,small,1,1,1,0,7,7,0
2022,1,Najran Region,Extraction of Crude Petroleum and Natural Gas,micro,4,1,0,1,11,10,1
2022,1,Eastern Province,Advertising and Market Research,small,161,815,401,414,1555,1537,18
2022,1,Eastern Province,Advertising and Market Research,large,2,2038,1558,480,4436,4433,3
2022,1,Eastern Province,Advertising and Market Research,micro,535,355,145,210,906,889,17
2022,1,Eastern Province,Advertising and Market Research,medium,7,331,71,260,350,346,4
2022,1,Al Bahah Region,Advertising and Market Research,small,5,14,8,6,27,27,0
2022,1,Al Bahah Region,Advertising and Market Research,micro,15,5,2,3,31,31,0
2022,1,Al Jawf Region,Advertising and Market Research,small,6,6,6,0,44,43,1
2022,1,Al Jawf Region,Advertising and Market Research,micro,67,14,12,2,146,146,0
2022,1,Northern Borders Region,Advertising and Market Research,small,4,14,8,6,39,39,0
2022,1,Northern Borders Region,Advertising and Market Research,micro,13,4,2,2,17,17,0
2022,1,Riyadh Region,Advertising and Market Research,small,539,3156,1440,1716,4660,4443,217
2022,1,Riyadh Region,Advertising and Market Research,large,8,6670,5291,1379,1573,1346,227
2022,1,Riyadh Region,Advertising and Market Research,micro,1545,1065,427,638,2386,2283,103
2022,1,Riyadh Region,Advertising and Market Research,medium,20,796,505,291,1171,1113,58
2022,1,Qassim Region,Advertising and Market Research,small,36,91,49,42,360,357,3
2022,1,Qassim Region,Advertising and Market Research,micro,109,40,18,22,197,192,5
2022,1,Qassim Region,Advertising and Market Research,medium,2,26,13,13,150,149,1
2022,1,Al Madinah Region,Advertising and Market Research,small,23,65,34,31,187,186,1
2022,1,Al Madinah Region,Advertising and Market Research,micro,173,87,47,40,291,285,6
2022,1,Tabuk Region,Advertising and Market Research,small,4,19,8,11,52,52,0
2022,1,Tabuk Region,Advertising and Market Research,micro,63,18,10,8,118,117,1
2022,1,Jazan Region,Advertising and Market Research,small,11,46,17,29,81,80,1
2022,1,Jazan Region,Advertising and Market Research,micro,82,36,16,20,154,154,0
2022,1,Hail Region,Advertising and Market Research,small,5,11,7,4,39,39,0
2022,1,Hail Region,Advertising and Market Research,micro,58,25,12,13,112,112,0
2022,1,Aseer Region,Advertising and Market Research,small,17,66,39,27,190,190,0
2022,1,Aseer Region,Advertising and Market Research,micro,133,63,33,30,238,238,0
2022,1,Aseer Region,Advertising and Market Research,medium,1,31,12,19,60,59,1
2022,1,Makkah Region,Advertising and Market Research,small,307,1443,648,795,2819,2689,130
2022,1,Makkah Region,Advertising and Market Research,large,4,457,375,82,889,878,11
2022,1,Makkah Region,Advertising and Market Research,micro,1147,596,238,358,2049,1938,111
2022,1,Makkah Region,Advertising and Market Research,medium,30,917,485,432,1736,1663,73
2022,1,Najran Region,Advertising and Market Research,small,11,48,20,28,148,148,0
2022,1,Najran Region,Advertising and Market Research,micro,32,8,7,1,73,73,0
2022,1,Eastern Province,Unknown,small,62,105,62,43,646,591,55
2022,1,Eastern Province,Unknown,large,1,0,0,0,330,274,56
2022,1,Eastern Province,Unknown,micro,2268,148,74,74,3702,3667,35
2022,1,Al Bahah Region,Unknown,small,1,0,0,0,6,6,0
2022,1,Al Bahah Region,Unknown,micro,242,11,9,2,341,336,5
2022,1,Al Jawf Region,Unknown,small,4,5,3,2,27,24,3
2022,1,Al Jawf Region,Unknown,micro,842,41,23,18,1220,1206,14
2022,1,Northern Borders Region,Unknown,small,1,3,1,2,5,5,0
2022,1,Northern Borders Region,Unknown,micro,238,9,5,4,378,376,2
2022,1,Riyadh Region,Unknown,small,320,586,317,269,2863,2801,62
2022,1,Riyadh Region,Unknown,large,5,2659,1697,962,410,388,22
2022,1,Riyadh Region,Unknown,micro,47836,2221,1100,1121,87497,86651,846
2022,1,Riyadh Region,Unknown,medium,8,110,81,29,482,448,34
2022,1,Qassim Region,Unknown,small,28,35,20,15,383,377,6
2022,1,Qassim Region,Unknown,micro,1567,107,59,48,2650,2634,16
2022,1,Qassim Region,Unknown,medium,2,0,0,0,120,116,4
2022,1,Al Madinah Region,Unknown,small,19,17,9,8,150,150,0
2022,1,Al Madinah Region,Unknown,micro,1637,81,38,43,2498,2432,66
2022,1,Al Madinah Region,Unknown,medium,1,0,0,0,54,54,0
2022,1,Tabuk Region,Unknown,small,3,3,0,3,30,30,0
2022,1,Tabuk Region,Unknown,micro,633,24,9,15,932,920,12
2022,1,Tabuk Region,Unknown,medium,1,0,0,0,181,181,0
2022,1,Jazan Region,Unknown,small,11,24,19,5,97,97,0
2022,1,Jazan Region,Unknown,micro,1360,40,21,19,2094,2067,27
2022,1,Jazan Region,Unknown,medium,1,69,66,3,131,131,0
2022,1,Hail Region,Unknown,small,11,10,6,4,82,82,0
2022,1,Hail Region,Unknown,micro,1863,89,48,41,3144,3128,16
2022,1,Hail Region,Unknown,medium,2,0,0,0,182,135,47
2022,1,Aseer Region,Unknown,small,18,40,33,7,152,151,1
2022,1,Aseer Region,Unknown,micro,1850,65,38,27,2578,2557,21
2022,1,Aseer Region,Unknown,medium,1,0,0,0,73,73,0
2022,1,Makkah Region,Unknown,small,105,220,108,112,971,921,50
2022,1,Makkah Region,Unknown,micro,5663,311,175,136,8807,8432,375
2022,1,Makkah Region,Unknown,medium,6,149,92,57,410,359,51
2022,1,Najran Region,Unknown,small,20,9,1,8,220,220,0
2022,1,Najran Region,Unknown,micro,1880,99,51,48,3261,3246,15
2022,2,Eastern Province,"Travel Agencies, Tour Operators, Reservation Services, and Related Activities",small,49,282,132,150,445,434,11
2022,2,Eastern Province,"Travel Agencies, Tour Operators, Reservation Services, and Related Activities",large,1,266,252,14,328,327,1
2022,2,Eastern Province,"Travel Agencies, Tour Operators, Reservation Services, and Related Activities",micro,149,106,55,51,219,216,3
2022,2,Eastern Province,"Travel Agencies, Tour Operators, Reservation Services, and Related Activities",medium,8,220,122,98,443,441,2
2022,2,Al Bahah Region,"Travel Agencies, Tour Operators, Reservation Services, and Related Activities",micro,2,0,0,0,6,6,0
2022,2,Al Jawf Region,"Travel Agencies, Tour Operators, Reservation Services, and Related Activities",small,3,15,13,2,35,34,1
2022,2,Al Jawf Region,"Travel Agencies, Tour Operators, Reservation Services, and Related Activities",micro,7,3,0,3,12,12,0
2022,2,Northern Borders Region,"Travel Agencies, Tour Operators, Reservation Services, and Related Activities",small,1,2,2,0,7,7,0
2022,2,Northern Borders Region,"Travel Agencies, Tour Operators, Reservation Services, and Related Activities",large,1,109,106,3,492,492,0
2022,2,Northern Borders Region,"Travel Agencies, Tour Operators, Reservation Services, and Related Activities",micro,8,2,1,1,11,11,0
2022,2,Riyadh Region,"Travel Agencies, Tour Operators, Reservation Services, and Related Activities",small,111,567,259,308,1057,1042,15
2022,2,Riyadh Region,"Travel Agencies, Tour Operators, Reservation Services, and Related Activities",large,4,608,440,168,900,873,27
2022,2,Riyadh Region,"Travel Agencies, Tour Operators, Reservation Services, and Related Activities",micro,323,194,94,100,548,536,12
2022,2,Riyadh Region,"Travel Agencies, Tour Operators, Reservation Services, and Related Activities",medium,17,626,355,271,1120,1114,6
2022,2,Qassim Region,"Travel Agencies, Tour Operators, Reservation Services, and Related Activities",small,15,42,16,26,133,131,2
2022,2,Qassim Region,"Travel Agencies, Tour Operators, Reservation Services, and Related Activities",micro,73,16,8,8,164,163,1
2022,2,Al Madinah Region,"Travel Agencies, Tour Operators, Reservation Services, and Related Activities",small,24,101,48,53,295,283,12
2022,2,Al Madinah Region,"Travel Agencies, Tour Operators, Reservation Services, and Related Activities",micro,112,71,47,24,181,180,1
2022,2,Tabuk Region,"Travel Agencies, Tour Operators, Reservation Services, and Related Activities",small,6,27,16,11,52,52,0
2022,2,Tabuk Region,"Travel Agencies, Tour Operators, Reservation Services, and Related Activities",micro,30,16,7,9,47,46,1
2022,2,Jazan Region,"Travel Agencies, Tour Operators, Reservation Services, and Related Activities",small,3,12,4,8,14,14,0
2022,2,Jazan Region,"Travel Agencies, Tour Operators, Reservation Services, and Related Activities",micro,21,13,6,7,30,30,0
2022,2,Hail Region,"Travel Agencies, Tour Operators, Reservation Services, and Related Activities",small,6,27,5,22,57,57,0
2022,2,Hail Region,"Travel Agencies, Tour Operators, Reservation Services, and Related Activities",micro,17,10,6,4,27,27,0
2022,2,Hail Region,"Travel Agencies, Tour Operators, Reservation Services, and Related Activities",medium,1,11,11,0,42,42,0
2022,2,Aseer Region,"Travel Agencies, Tour Operators, Reservation Services, and Related Activities",small,6,18,9,9,34,34,0
2022,2,Aseer Region,"Travel Agencies, Tour Operators, Reservation Services, and Related Activities",micro,41,29,20,9,61,61,0
2022,2,Makkah Region,"Travel Agencies, Tour Operators, Reservation Services, and Related Activities",small,198,755,448,307,1560,1531,29
2022,2,Makkah Region,"Travel Agencies, Tour Operators, Reservation Services, and Related Activities",large,2,3848,3161,687,1343,1343,0
2022,2,Makkah Region,"Travel Agencies, Tour Operators, Reservation Services, and Related Activities",micro,539,401,250,151,872,852,20
2022,2,Makkah Region,"Travel Agencies, Tour Operators, Reservation Services, and Related Activities",medium,16,779,495,284,778,772,6
2022,2,Najran Region,"Travel Agencies, Tour Operators, Reservation Services, and Related Activities",small,3,4,2,2,34,34,0
2022,2,Najran Region,"Travel Agencies, Tour Operators, Reservation Services, and Related Activities",micro,10,5,4,1,20,20,0
2022,2,Eastern Province,Fishing and Aquaculture,small,122,130,52,78,1339,1338,1
2022,2,Eastern Province,Fishing and Aquaculture,micro,554,96,55,41,1349,1345,4
2022,2,Eastern Province,Fishing and Aquaculture,medium,1,7,3,4,57,57,0
2022,2,Al Bahah Region,Fishing and Aquaculture,small,1,1,1,0,5,5,0
2022,2,Al Bahah Region,Fishing and Aquaculture,micro,26,5,4,1,51,51,0
2022,2,Al Jawf Region,Fishing and Aquaculture,micro,177,9,8,1,270,270,0
2022,2,Northern Borders Region,Fishing and Aquaculture,micro,38,4,2,2,84,84,0
2022,2,Riyadh Region,Fishing and Aquaculture,small,103,123,71,52,750,750,0
2022,2,Riyadh Region,Fishing and Aquaculture,micro,18369,2550,1258,1292,41601,41375,226
2022,2,Qassim Region,Fishing and Aquaculture,small,3,1,0,1,28,28,0
2022,2,Qassim Region,Fishing and Aquaculture,micro,559,95,54,41,1252,1251,1
2022,2,Al Madinah Region,Fishing and Aquaculture,small,10,3,1,2,80,80,0
2022,2,Al Madinah Region,Fishing and Aquaculture,micro,272,35,16,19,499,475,24
2022,2,Tabuk Region,Fishing and Aquaculture,small,5,8,2,6,43,43,0
2022,2,Tabuk Region,Fishing and Aquaculture,micro,112,11,5,6,181,180,1
2022,2,Jazan Region,Fishing and Aquaculture,small,48,120,94,26,567,566,1
2022,2,Jazan Region,Fishing and Aquaculture,large,1,76,70,6,229,229,0
2022,2,Jazan Region,Fishing and Aquaculture,micro,287,39,19,20,574,569,5
2022,2,Jazan Region,Fishing and Aquaculture,medium,1,28,11,17,203,203,0
2022,2,Hail Region,Fishing and Aquaculture,small,3,2,1,1,16,16,0
2022,2,Hail Region,Fishing and Aquaculture,micro,964,96,50,46,2143,2135,8
2022,2,Aseer Region,Fishing and Aquaculture,small,7,3,2,1,65,65,0
2022,2,Aseer Region,Fishing and Aquaculture,micro,294,39,20,19,534,533,1
2022,2,Makkah Region,Fishing and Aquaculture,small,48,42,24,18,477,475,2
2022,2,Makkah Region,Fishing and Aquaculture,large,1,262,238,24,1777,1774,3
2022,2,Makkah Region,Fishing and Aquaculture,micro,1888,183,96,87,3438,3288,150
2022,2,Makkah Region,Fishing and Aquaculture,medium,1,1,1,0,67,67,0
2022,2,Najran Region,Fishing and Aquaculture,small,5,4,1,3,33,33,0
2022,2,Najran Region,Fishing and Aquaculture,micro,697,83,47,36,1469,1465,4
2022,2,Eastern Province,Manufacture of Shaped Metal Products (Except Machinery and Equipment),small,612,1842,1151,691,7280,7268,12
2022,2,Eastern Province,Manufacture of Shaped Metal Products (Except Machinery and Equipment),large,23,6879,6547,332,7980,7971,9
2022,2,Eastern Province,Manufacture of Shaped Metal Products (Except Machinery and Equipment),micro,1355,478,266,212,2933,2929,4
2022,2,Eastern Province,Manufacture of Shaped Metal Products (Except Machinery and Equipment),medium,99,2485,1895,590,7623,7615,8
2022,2,Al Bahah Region,Manufacture of Shaped Metal Products (Except Machinery and Equipment),small,22,24,15,9,171,171,0
2022,2,Al Bahah Region,Manufacture of Shaped Metal Products (Except Machinery and Equipment),micro,244,53,37,16,503,503,0
2022,2,Al Bahah Region,Manufacture of Shaped Metal Products (Except Machinery and Equipment),medium,1,14,13,1,55,55,0
2022,2,Al Jawf Region,Manufacture of Shaped Metal Products (Except Machinery and Equipment),small,33,41,33,8,343,343,0
2022,2,Al Jawf Region,Manufacture of Shaped Metal Products (Except Machinery and Equipment),micro,247,43,36,7,542,541,1
2022,2,Northern Borders Region,Manufacture of Shaped Metal Products (Except Machinery and Equipment),small,19,34,21,13,209,209,0
2022,2,Northern Borders Region,Manufacture of Shaped Metal Products (Except Machinery and Equipment),micro,97,24,13,11,225,221,4
2022,2,Riyadh Region,Manufacture of Shaped Metal Products (Except Machinery and Equipment),small,912,2712,1173,1539,11612,11551,61
2022,2,Riyadh Region,Manufacture of Shaped Metal Products (Except Machinery and Equipment),large,14,2499,1536,963,4966,4956,10
2022,2,Riyadh Region,Manufacture of Shaped Metal Products (Except Machinery and Equipment),micro,2299,656,301,355,5164,5147,17
2022,2,Riyadh Region,Manufacture of Shaped Metal Products (Except Machinery and Equipment),medium,139,3050,1697,1353,10663,10631,32
2022,2,Qassim Region,Manufacture of Shaped Metal Products (Except Machinery and Equipment),small,181,297,166,131,1822,1821,1
2022,2,Qassim Region,Manufacture of Shaped Metal Products (Except Machinery and Equipment),large,1,125,103,22,380,380,0
2022,2,Qassim Region,Manufacture of Shaped Metal Products (Except Machinery and Equipment),micro,1118,219,124,95,2634,2627,7
2022,2,Qassim Region,Manufacture of Shaped Metal Products (Except Machinery and Equipment),medium,7,121,74,47,379,379,0
2022,2,Al Madinah Region,Manufacture of Shaped Metal Products (Except Machinery and Equipment),small,88,187,103,84,857,856,1
2022,2,Al Madinah Region,Manufacture of Shaped Metal Products (Except Machinery and Equipment),micro,557,123,80,43,1241,1239,2
2022,2,Al Madinah Region,Manufacture of Shaped Metal Products (Except Machinery and Equipment),medium,8,185,131,54,693,692,1
2022,2,Tabuk Region,Manufacture of Shaped Metal Products (Except Machinery and Equipment),small,36,51,30,21,334,333,1
2022,2,Tabuk Region,Manufacture of Shaped Metal Products (Except Machinery and Equipment),micro,209,54,27,27,452,452,0
2022,2,Tabuk Region,Manufacture of Shaped Metal Products (Except Machinery and Equipment),medium,2,25,17,8,114,113,1
2022,2,Jazan Region,Manufacture of Shaped Metal Products (Except Machinery and Equipment),small,46,76,44,32,377,376,1
2022,2,Jazan Region,Manufacture of Shaped Metal Products (Except Machinery and Equipment),micro,735,100,68,32,1761,1757,4
2022,2,Hail Region,Manufacture of Shaped Metal Products (Except Machinery and Equipment),small,48,128,71,57,480,480,0
2022,2,Hail Region,Manufacture of Shaped Metal Products (Except Machinery and Equipment),micro,221,44,26,18,490,486,4
2022,2,Hail Region,Manufacture of Shaped Metal Products (Except Machinery and Equipment),medium,2,24,7,17,117,117,0
2022,2,Aseer Region,Manufacture of Shaped Metal Products (Except Machinery and Equipment),small,91,198,124,74,873,872,1
2022,2,Aseer Region,Manufacture of Shaped Metal Products (Except Machinery and Equipment),micro,915,183,113,70,2050,2049,1
2022,2,Aseer Region,Manufacture of Shaped Metal Products (Except Machinery and Equipment),medium,7,75,54,21,482,482,0
2022,2,Makkah Region,Manufacture of Shaped Metal Products (Except Machinery and Equipment),small,369,888,453,435,4245,4221,24
2022,2,Makkah Region,Manufacture of Shaped Metal Products (Except Machinery and Equipment),large,10,1095,733,362,2997,2991,6
2022,2,Makkah Region,Manufacture of Shaped Metal Products (Except Machinery and Equipment),micro,1897,361,192,169,4322,4308,14
2022,2,Makkah Region,Manufacture of Shaped Metal Products (Except Machinery and Equipment),medium,74,1876,1396,480,5983,5963,20
2022,2,Najran Region,Manufacture of Shaped Metal Products (Except Machinery and Equipment),small,24,37,17,20,242,241,1
2022,2,Najran Region,Manufacture of Shaped Metal Products (Except Machinery and Equipment),micro,289,42,25,17,731,731,0
2022,2,Eastern Province,Manufacture of Other Non-Metallic Mineral Products,small,274,1008,627,381,4357,4331,26
2022,2,Eastern Province,Manufacture of Other Non-Metallic Mineral Products,large,18,2494,2059,435,6168,6165,3
2022,2,Eastern Province,Manufacture of Other Non-Metallic Mineral Products,micro,355,144,79,65,782,781,1
2022,2,Eastern Province,Manufacture of Other Non-Metallic Mineral Products,medium,101,1930,1341,589,8330,8327,3
2022,2,Al Bahah Region,Manufacture of Other Non-Metallic Mineral Products,small,25,91,67,24,343,342,1
2022,2,Al Bahah Region,Manufacture of Other Non-Metallic Mineral Products,micro,43,11,10,1,89,89,0
2022,2,Al Bahah Region,Manufacture of Other Non-Metallic Mineral Products,medium,5,64,42,22,347,346,1
2022,2,Al Jawf Region,Manufacture of Other Non-Metallic Mineral Products,small,36,122,81,41,490,488,2
2022,2,Al Jawf Region,Manufacture of Other Non-Metallic Mineral Products,micro,48,12,9,3,91,90,1
2022,2,Al Jawf Region,Manufacture of Other Non-Metallic Mineral Products,medium,7,129,105,24,571,571,0
2022,2,Northern Borders Region,Manufacture of Other Non-Metallic Mineral Products,small,23,68,33,35,314,314,0
2022,2,Northern Borders Region,Manufacture of Other Non-Metallic Mineral Products,large,1,246,244,2,240,240,0
2022,2,Northern Borders Region,Manufacture of Other Non-Metallic Mineral Products,micro,38,14,9,5,76,76,0
2022,2,Northern Borders Region,Manufacture of Other Non-Metallic Mineral Products,medium,1,34,16,18,94,94,0
2022,2,Riyadh Region,Manufacture of Other Non-Metallic Mineral Products,small,1192,2039,943,1096,19756,19687,69
2022,2,Riyadh Region,Manufacture of Other Non-Metallic Mineral Products,large,31,4908,3726,1182,12149,12136,13
2022,2,Riyadh Region,Manufacture of Other Non-Metallic Mineral Products,micro,1586,396,186,210,3706,3687,19
2022,2,Riyadh Region,Manufacture of Other Non-Metallic Mineral Products,medium,315,3537,1848,1689,23398,23351,47
2022,2,Qassim Region,Manufacture of Other Non-Metallic Mineral Products,small,136,303,180,123,2153,2141,12
2022,2,Qassim Region,Manufacture of Other Non-Metallic Mineral Products,large,5,824,668,156,2736,2736,0
2022,2,Qassim Region,Manufacture of Other Non-Metallic Mineral Products,micro,242,57,29,28,619,619,0
2022,2,Qassim Region,Manufacture of Other Non-Metallic Mineral Products,medium,36,598,382,216,2932,2930,2
2022,2,Al Madinah Region,Manufacture of Other Non-Metallic Mineral Products,small,90,197,125,72,1205,1203,2
2022,2,Al Madinah Region,Manufacture of Other Non-Metallic Mineral Products,large,4,595,427,168,1555,1553,2
2022,2,Al Madinah Region,Manufacture of Other Non-Metallic Mineral Products,micro,173,43,27,16,388,386,2
2022,2,Al Madinah Region,Manufacture of Other Non-Metallic Mineral Products,medium,34,1031,813,218,2717,2716,1
2022,2,Tabuk Region,Manufacture of Other Non-Metallic Mineral Products,small,28,114,69,45,359,359,0
2022,2,Tabuk Region,Manufacture of Other Non-Metallic Mineral Products,large,2,347,327,20,594,592,2
2022,2,Tabuk Region,Manufacture of Other Non-Metallic Mineral Products,micro,49,15,8,7,100,100,0
2022,2,Tabuk Region,Manufacture of Other Non-Metallic Mineral Products,medium,3,47,32,15,199,199,0
2022,2,Jazan Region,Manufacture of Other Non-Metallic Mineral Products,small,67,258,147,111,879,876,3
2022,2,Jazan Region,Manufacture of Other Non-Metallic Mineral Products,large,1,352,352,0,164,164,0
2022,2,Jazan Region,Manufacture of Other Non-Metallic Mineral Products,micro,128,41,28,13,313,313,0
2022,2,Jazan Region,Manufacture of Other Non-Metallic Mineral Products,medium,22,510,344,166,1571,1571,0
2022,2,Hail Region,Manufacture of Other Non-Metallic Mineral Products,small,44,47,34,13,564,562,2
2022,2,Hail Region,Manufacture of Other Non-Metallic Mineral Products,large,1,254,254,0,166,166,0
2022,2,Hail Region,Manufacture of Other Non-Metallic Mineral Products,micro,146,32,19,13,351,350,1
2022,2,Hail Region,Manufacture of Other Non-Metallic Mineral Products,medium,8,139,93,46,531,531,0
2022,2,Aseer Region,Manufacture of Other Non-Metallic Mineral Products,small,159,413,246,167,2146,2140,6
2022,2,Aseer Region,Manufacture of Other Non-Metallic Mineral Products,large,6,963,900,63,2130,2129,1
2022,2,Aseer Region,Manufacture of Other Non-Metallic Mineral Products,micro,246,79,46,33,599,598,1
2022,2,Aseer Region,Manufacture of Other Non-Metallic Mineral Products,medium,34,666,448,218,2649,2649,0
2022,2,Makkah Region,Manufacture of Other Non-Metallic Mineral Products,small,248,738,393,345,3651,3640,11
2022,2,Makkah Region,Manufacture of Other Non-Metallic Mineral Products,large,16,2870,2007,863,6419,6414,5
2022,2,Makkah Region,Manufacture of Other Non-Metallic Mineral Products,micro,429,140,86,54,918,913,5
2022,2,Makkah Region,Manufacture of Other Non-Metallic Mineral Products,medium,64,1351,843,508,4930,4924,6
2022,2,Najran Region,Manufacture of Other Non-Metallic Mineral Products,small,38,127,77,50,573,563,10
2022,2,Najran Region,Manufacture of Other Non-Metallic Mineral Products,large,1,344,327,17,392,392,0
2022,2,Najran Region,Manufacture of Other Non-Metallic Mineral Products,micro,74,17,11,6,178,177,1
2022,2,Najran Region,Manufacture of Other Non-Metallic Mineral Products,medium,17,294,193,101,1445,1438,7
2022,2,Eastern Province,Manufacture of Rubber and Plastic Products,small,42,167,107,60,719,719,0
2022,2,Eastern Province,Manufacture of Rubber and Plastic Products,large,3,403,349,54,869,869,0
2022,2,Eastern Province,Manufacture of Rubber and Plastic Products,micro,48,25,14,11,104,104,0
2022,2,Eastern Province,Manufacture of Rubber and Plastic Products,medium,36,1071,824,247,2696,2693,3
2022,2,Al Bahah Region,Manufacture of Rubber and Plastic Products,small,1,3,2,1,21,21,0
2022,2,Al Bahah Region,Manufacture of Rubber and Plastic Products,micro,2,1,0,1,1,1,0
2022,2,Al Jawf Region,Manufacture of Rubber and Plastic Products,small,2,7,5,2,30,30,0
2022,2,Al Jawf Region,Manufacture of Rubber and Plastic Products,large,1,133,92,41,355,354,1
2022,2,Al Jawf Region,Manufacture of Rubber and Plastic Products,micro,9,2,2,0,24,24,0
2022,2,Northern Borders Region,Manufacture of Rubber and Plastic Products,small,1,3,1,2,5,5,0
2022,2,Northern Borders Region,Manufacture of Rubber and Plastic Products,medium,1,0,0,0,101,101,0
2022,2,Riyadh Region,Manufacture of Rubber and Plastic Products,small,112,505,222,283,2035,2025,10
2022,2,Riyadh Region,Manufacture of Rubber and Plastic Products,large,10,964,529,435,2813,2808,5
2022,2,Riyadh Region,Manufacture of Rubber and Plastic Products,micro,177,70,38,32,379,378,1
2022,2,Riyadh Region,Manufacture of Rubber and Plastic Products,medium,71,1778,939,839,5817,5806,11
2022,2,Qassim Region,Manufacture of Rubber and Plastic Products,small,6,35,16,19,64,64,0
2022,2,Qassim Region,Manufacture of Rubber and Plastic Products,micro,7,1,0,1,13,13,0
2022,2,Qassim Region,Manufacture of Rubber and Plastic Products,medium,6,163,104,59,479,478,1
2022,2,Al Madinah Region,Manufacture of Rubber and Plastic Products,small,18,95,47,48,354,353,1
2022,2,Al Madinah Region,Manufacture of Rubber and Plastic Products,large,1,137,72,65,340,340,0
2022,2,Al Madinah Region,Manufacture of Rubber and Plastic Products,micro,22,16,9,7,33,33,0
2022,2,Al Madinah Region,Manufacture of Rubber and Plastic Products,medium,7,219,154,65,643,637,6
2022,2,Tabuk Region,Manufacture of Rubber and Plastic Products,small,6,17,10,7,73,73,0
2022,2,Tabuk Region,Manufacture of Rubber and Plastic Products,micro,6,3,0,3,15,15,0
2022,2,Jazan Region,Manufacture of Rubber and Plastic Products,small,3,7,6,1,42,42,0
2022,2,Jazan Region,Manufacture of Rubber and Plastic Products,micro,2,0,0,0,7,7,0
2022,2,Hail Region,Manufacture of Rubber and Plastic Products,small,4,27,9,18,90,90,0
2022,2,Hail Region,Manufacture of Rubber and Plastic Products,micro,5,0,0,0,9,9,0
2022,2,Hail Region,Manufacture of Rubber and Plastic Products,medium,2,110,85,25,170,170,0
2022,2,Aseer Region,Manufacture of Rubber and Plastic Products,small,5,11,7,4,53,53,0
2022,2,Aseer Region,Manufacture of Rubber and Plastic Products,micro,24,6,5,1,48,48,0
2022,2,Aseer Region,Manufacture of Rubber and Plastic Products,medium,3,64,35,29,200,200,0
2022,2,Makkah Region,Manufacture of Rubber and Plastic Products,small,76,389,214,175,1356,1340,16
2022,2,Makkah Region,Manufacture of Rubber and Plastic Products,large,10,1145,842,303,2895,2876,19
2022,2,Makkah Region,Manufacture of Rubber and Plastic Products,micro,74,33,22,11,141,140,1
2022,2,Makkah Region,Manufacture of Rubber and Plastic Products,medium,33,913,543,370,2957,2953,4
2022,2,Najran Region,Manufacture of Rubber and Plastic Products,small,5,29,16,13,96,96,0
2022,2,Najran Region,Manufacture of Rubber and Plastic Products,micro,8,2,0,2,25,25,0
2022,2,Najran Region,Manufacture of Rubber and Plastic Products,medium,1,52,19,33,113,113,0
2022,2,Eastern Province,Manufacture of Coke and Refined Petroleum Products,small,20,102,71,31,324,323,1
2022,2,Eastern Province,Manufacture of Coke and Refined Petroleum Products,large,7,3383,3339,44,1645,1644,1
2022,2,Eastern Province,Manufacture of Coke and Refined Petroleum Products,micro,16,20,11,9,24,24,0
2022,2,Eastern Province,Manufacture of Coke and Refined Petroleum Products,medium,10,588,558,30,613,613,0
2022,2,Al Jawf Region,Manufacture of Coke and Refined Petroleum Products,micro,2,0,0,0,4,4,0
2022,2,Riyadh Region,Manufacture of Coke and Refined Petroleum Products,small,31,132,86,46,340,337,3
2022,2,Riyadh Region,Manufacture of Coke and Refined Petroleum Products,micro,41,32,18,14,67,66,1
2022,2,Riyadh Region,Manufacture of Coke and Refined Petroleum Products,medium,5,171,127,44,342,341,1
2022,2,Qassim Region,Manufacture of Coke and Refined Petroleum Products,small,3,19,18,1,53,53,0
2022,2,Qassim Region,Manufacture of Coke and Refined Petroleum Products,micro,4,4,3,1,6,6,0
2022,2,Al Madinah Region,Manufacture of Coke and Refined Petroleum Products,small,1,8,8,0,22,22,0
2022,2,Al Madinah Region,Manufacture of Coke and Refined Petroleum Products,large,4,1958,1900,58,784,784,0
2022,2,Al Madinah Region,Manufacture of Coke and Refined Petroleum Products,micro,5,4,3,1,12,12,0
2022,2,Al Madinah Region,Manufacture of Coke and Refined Petroleum Products,medium,3,289,289,0,170,170,0
2022,2,Jazan Region,Manufacture of Coke and Refined Petroleum Products,medium,1,114,109,5,43,38,5
2022,2,Aseer Region,Manufacture of Coke and Refined Petroleum Products,small,2,9,5,4,20,20,0
2022,2,Makkah Region,Manufacture of Coke and Refined Petroleum Products,small,20,110,77,33,266,264,2
2022,2,Makkah Region,Manufacture of Coke and Refined Petroleum Products,large,2,2821,2731,90,1610,1597,13
2022,2,Makkah Region,Manufacture of Coke and Refined Petroleum Products,micro,14,7,6,1,23,23,0
2022,2,Makkah Region,Manufacture of Coke and Refined Petroleum Products,medium,2,13,13,0,120,120,0
2022,2,Eastern Province,Manufacture of Paper and Paper Products,small,51,257,150,107,877,876,1
2022,2,Eastern Province,Manufacture of Paper and Paper Products,large,5,573,458,115,1420,1418,2
2022,2,Eastern Province,Manufacture of Paper and Paper Products,micro,44,25,14,11,106,105,1
2022,2,Eastern Province,Manufacture of Paper and Paper Products,medium,15,563,402,161,1406,1405,1
2022,2,Al Bahah Region,Manufacture of Paper and Paper Products,micro,1,0,0,0,1,1,0
2022,2,Al Jawf Region,Manufacture of Paper and Paper Products,small,1,3,2,1,12,12,0
2022,2,Al Jawf Region,Manufacture of Paper and Paper Products,micro,2,1,1,0,7,7,0
2022,2,Northern Borders Region,Manufacture of Paper and Paper Products,small,2,2,1,1,15,15,0
2022,2,Northern Borders Region,Manufacture of Paper and Paper Products,micro,2,0,0,0,3,3,0
2022,2,Riyadh Region,Manufacture of Paper and Paper Products,small,93,450,207,243,1347,1344,3
2022,2,Riyadh Region,Manufacture of Paper and Paper Products,large,2,136,43,93,378,378,0
2022,2,Riyadh Region,Manufacture of Paper and Paper Products,micro,108,62,26,36,245,244,1
2022,2,Riyadh Region,Manufacture of Paper and Paper Products,medium,31,828,507,321,2528,2524,4
2022,2,Qassim Region,Manufacture of Paper and Paper Products,small,9,35,15,20,135,134,1
2022,2,Qassim Region,Manufacture of Paper and Paper Products,micro,15,7,2,5,34,34,0
2022,2,Qassim Region,Manufacture of Paper and Paper Products,medium,4,98,74,24,364,363,1
2022,2,Al Madinah Region,Manufacture of Paper and Paper Products,small,10,40,20,20,157,156,1
2022,2,Al Madinah Region,Manufacture of Paper and Paper Products,micro,15,6,3,3,37,37,0
2022,2,Al Madinah Region,Manufacture of Paper and Paper Products,medium,1,26,10,16,76,76,0
2022,2,Tabuk Region,Manufacture of Paper and Paper Products,small,3,17,7,10,57,57,0
2022,2,Tabuk Region,Manufacture of Paper and Paper Products,micro,5,6,4,2,10,10,0
2022,2,Jazan Region,Manufacture of Paper and Paper Products,small,1,1,0,1,6,6,0
2022,2,Jazan Region,Manufacture of Paper and Paper Products,micro,6,4,2,2,14,14,0
2022,2,Jazan Region,Manufacture of Paper and Paper Products,medium,1,17,8,9,51,51,0
2022,2,Hail Region,Manufacture of Paper and Paper Products,small,3,8,4,4,41,41,0
2022,2,Hail Region,Manufacture of Paper and Paper Products,micro,5,5,3,2,13,13,0
2022,2,Aseer Region,Manufacture of Paper and Paper Products,small,10,24,14,10,107,107,0
2022,2,Aseer Region,Manufacture of Paper and Paper Products,micro,8,2,2,0,18,17,1
2022,2,Makkah Region,Manufacture of Paper and Paper Products,small,68,265,158,107,969,965,4
2022,2,Makkah Region,Manufacture of Paper and Paper Products,large,5,667,505,162,1645,1638,7
2022,2,Makkah Region,Manufacture of Paper and Paper Products,micro,53,31,19,12,104,100,4
2022,2,Makkah Region,Manufacture of Paper and Paper Products,medium,21,675,349,326,1616,1606,10
2022,2,Najran Region,Manufacture of Paper and Paper Products,small,2,1,1,0,15,15,0
2022,2,Najran Region,Manufacture of Paper and Paper Products,micro,23,3,2,1,59,59,0
2022,2,Eastern Province,Manufacture of Chemicals and Chemical Products,small,167,1010,707,303,2415,2405,10
2022,2,Eastern Province,Manufacture of Chemicals and Chemical Products,large,16,11079,10962,117,2597,2596,1
2022,2,Eastern Province,Manufacture of Chemicals and Chemical Products,micro,158,121,63,58,274,274,0
2022,2,Eastern Province,Manufacture of Chemicals and Chemical Products,medium,74,3236,2853,383,4737,4731,6
2022,2,Al Bahah Region,Manufacture of Chemicals and Chemical Products,small,4,5,4,1,64,64,0
2022,2,Al Bahah Region,Manufacture of Chemicals and Chemical Products,micro,5,0,0,0,10,10,0
2022,2,Al Jawf Region,Manufacture of Chemicals and Chemical Products,small,1,2,1,1,5,5,0
2022,2,Al Jawf Region,Manufacture of Chemicals and Chemical Products,micro,8,1,1,0,16,16,0
2022,2,Northern Borders Region,Manufacture of Chemicals and Chemical Products,large,1,581,574,7,229,229,0
2022,2,Northern Borders Region,Manufacture of Chemicals and Chemical Products,micro,10,2,2,0,23,23,0
2022,2,Riyadh Region,Manufacture of Chemicals and Chemical Products,small,375,1577,740,837,5735,5720,15
2022,2,Riyadh Region,Manufacture of Chemicals and Chemical Products,large,14,2401,1609,792,4116,4101,15
2022,2,Riyadh Region,Manufacture of Chemicals and Chemical Products,micro,450,212,93,119,950,939,11
2022,2,Riyadh Region,Manufacture of Chemicals and Chemical Products,medium,81,2024,1069,955,6331,6321,10
2022,2,Qassim Region,Manufacture of Chemicals and Chemical Products,small,19,41,18,23,222,222,0
2022,2,Qassim Region,Manufacture of Chemicals and Chemical Products,large,2,480,456,24,1185,1184,1
2022,2,Qassim Region,Manufacture of Chemicals and Chemical Products,micro,26,7,3,4,49,49,0
2022,2,Qassim Region,Manufacture of Chemicals and Chemical Products,medium,8,182,111,71,554,554,0
2022,2,Al Madinah Region,Manufacture of Chemicals and Chemical Products,small,29,155,120,35,421,419,2
2022,2,Al Madinah Region,Manufacture of Chemicals and Chemical Products,large,4,2579,2569,10,497,497,0
2022,2,Al Madinah Region,Manufacture of Chemicals and Chemical Products,micro,35,13,7,6,78,77,1
2022,2,Al Madinah Region,Manufacture of Chemicals and Chemical Products,medium,11,255,216,39,625,621,4
2022,2,Tabuk Region,Manufacture of Chemicals and Chemical Products,small,10,50,35,15,156,156,0
2022,2,Tabuk Region,Manufacture of Chemicals and Chemical Products,large,1,521,321,200,721,716,5
2022,2,Tabuk Region,Manufacture of Chemicals and Chemical Products,micro,16,4,2,2,32,32,0
2022,2,Jazan Region,Manufacture of Chemicals and Chemical Products,small,10,23,14,9,100,100,0
2022,2,Jazan Region,Manufacture of Chemicals and Chemical Products,micro,16,6,4,2,41,40,1
2022,2,Jazan Region,Manufacture of Chemicals and Chemical Products,medium,1,9,9,0,73,73,0
2022,2,Hail Region,Manufacture of Chemicals and Chemical Products,small,8,15,6,9,63,63,0
2022,2,Hail Region,Manufacture of Chemicals and Chemical Products,micro,56,12,8,4,157,157,0
2022,2,Aseer Region,Manufacture of Chemicals and Chemical Products,small,26,110,67,43,348,347,1
2022,2,Aseer Region,Manufacture of Chemicals and Chemical Products,large,1,644,529,115,1383,1380,3
2022,2,Aseer Region,Manufacture of Chemicals and Chemical Products,micro,37,9,8,1,78,78,0
2022,2,Aseer Region,Manufacture of Chemicals and Chemical Products,medium,3,76,52,24,211,211,0
2022,2,Makkah Region,Manufacture of Chemicals and Chemical Products,small,180,751,417,334,2634,2612,22
2022,2,Makkah Region,Manufacture of Chemicals and Chemical Products,large,4,861,651,210,2221,2217,4
2022,2,Makkah Region,Manufacture of Chemicals and Chemical Products,micro,232,112,57,55,447,435,12
2022,2,Makkah Region,Manufacture of Chemicals and Chemical Products,medium,72,1999,1299,700,5256,5214,42
2022,2,Najran Region,Manufacture of Chemicals and Chemical Products,small,5,21,16,5,77,77,0
2022,2,Najran Region,Manufacture of Chemicals and Chemical Products,micro,13,2,1,1,25,25,0
2022,2,Najran Region,Manufacture of Chemicals and Chemical Products,medium,1,13,0,13,45,45,0
2022,2,Eastern Province,Manufacture of Textiles,small,74,165,83,82,856,842,14
2022,2,Eastern Province,Manufacture of Textiles,micro,299,58,22,36,634,612,22
2022,2,Eastern Province,Manufacture of Textiles,medium,6,248,203,45,512,512,0
2022,2,Al Bahah Region,Manufacture of Textiles,small,4,7,4,3,46,45,1
2022,2,Al Bahah Region,Manufacture of Textiles,micro,19,5,2,3,41,41,0
2022,2,Al Jawf Region,Manufacture of Textiles,small,5,3,3,0,55,55,0
2022,2,Al Jawf Region,Manufacture of Textiles,micro,45,8,6,2,109,108,1
2022,2,Northern Borders Region,Manufacture of Textiles,small,3,5,3,2,29,29,0
2022,2,Northern Borders Region,Manufacture of Textiles,micro,25,4,3,1,52,52,0
2022,2,Riyadh Region,Manufacture of Textiles,small,95,215,82,133,1000,995,5
2022,2,Riyadh Region,Manufacture of Textiles,large,6,1485,982,503,3688,3663,25
2022,2,Riyadh Region,Manufacture of Textiles,micro,411,87,39,48,904,899,5
2022,2,Riyadh Region,Manufacture of Textiles,medium,10,322,213,109,889,887,2
2022,2,Qassim Region,Manufacture of Textiles,small,17,30,28,2,130,130,0
2022,2,Qassim Region,Manufacture of Textiles,micro,85,13,4,9,220,220,0
2022,2,Qassim Region,Manufacture of Textiles,medium,1,18,8,10,51,51,0
2022,2,Al Madinah Region,Manufacture of Textiles,small,29,66,48,18,345,343,2
2022,2,Al Madinah Region,Manufacture of Textiles,micro,121,26,11,15,266,257,9
2022,2,Al Madinah Region,Manufacture of Textiles,medium,4,97,56,41,307,307,0
2022,2,Tabuk Region,Manufacture of Textiles,small,8,11,3,8,91,91,0
2022,2,Tabuk Region,Manufacture of Textiles,micro,61,11,8,3,158,155,3
2022,2,Jazan Region,Manufacture of Textiles,small,1,3,3,0,12,12,0
2022,2,Jazan Region,Manufacture of Textiles,micro,25,2,1,1,53,53,0
2022,2,Hail Region,Manufacture of Textiles,small,12,20,15,5,115,115,0
2022,2,Hail Region,Manufacture of Textiles,micro,51,6,3,3,135,133,2
2022,2,Aseer Region,Manufacture of Textiles,small,8,17,10,7,69,69,0
2022,2,Aseer Region,Manufacture of Textiles,micro,62,14,11,3,139,134,5
2022,2,Makkah Region,Manufacture of Textiles,small,58,160,80,80,669,660,9
2022,2,Makkah Region,Manufacture of Textiles,large,3,311,300,11,1009,1008,1
2022,2,Makkah Region,Manufacture of Textiles,micro,270,56,32,24,606,592,14
2022,2,Makkah Region,Manufacture of Textiles,medium,8,322,245,77,542,540,2
2022,2,Najran Region,Manufacture of Textiles,small,5,6,3,3,68,63,5
2022,2,Najran Region,Manufacture of Textiles,micro,48,6,5,1,115,112,3
2022,2,Eastern Province,Manufacture of Food Products,small,280,1035,548,487,3524,3518,6
2022,2,Eastern Province,Manufacture of Food Products,large,12,1251,613,638,4534,4525,9
2022,2,Eastern Province,Manufacture of Food Products,micro,742,266,135,131,1503,1499,4
2022,2,Eastern Province,Manufacture of Food Products,medium,63,1269,736,533,4576,4553,23
2022,2,Al Bahah Region,Manufacture of Food Products,small,19,44,29,15,207,207,0
2022,2,Al Bahah Region,Manufacture of Food Products,micro,91,24,18,6,189,186,3
2022,2,Al Bahah Region,Manufacture of Food Products,medium,1,11,5,6,50,50,0
2022,2,Al Jawf Region,Manufacture of Food Products,small,35,100,87,13,299,298,1
2022,2,Al Jawf Region,Manufacture of Food Products,micro,159,35,29,6,332,332,0
2022,2,Al Jawf Region,Manufacture of Food Products,medium,1,5,2,3,53,53,0
2022,2,Northern Borders Region,Manufacture of Food Products,small,22,39,23,16,246,246,0
2022,2,Northern Borders Region,Manufacture of Food Products,micro,96,11,7,4,209,209,0
2022,2,Northern Borders Region,Manufacture of Food Products,medium,1,16,12,4,60,60,0
2022,2,Riyadh Region,Manufacture of Food Products,small,559,1925,884,1041,7402,7357,45
2022,2,Riyadh Region,Manufacture of Food Products,large,35,5317,3497,1820,14784,14728,56
2022,2,Riyadh Region,Manufacture of Food Products,micro,1661,506,242,264,3458,3426,32
2022,2,Riyadh Region,Manufacture of Food Products,medium,125,3307,1883,1424,9050,8995,55
2022,2,Qassim Region,Manufacture of Food Products,small,122,476,283,193,1624,1617,7
2022,2,Qassim Region,Manufacture of Food Products,large,8,859,615,244,2868,2733,135
2022,2,Qassim Region,Manufacture of Food Products,micro,346,89,52,37,727,726,1
2022,2,Qassim Region,Manufacture of Food Products,medium,46,1043,609,434,3584,3580,4
2022,2,Al Madinah Region,Manufacture of Food Products,small,119,306,177,129,1388,1377,11
2022,2,Al Madinah Region,Manufacture of Food Products,micro,493,142,73,69,1031,1018,13
2022,2,Al Madinah Region,Manufacture of Food Products,medium,14,379,253,126,1081,1079,2
2022,2,Tabuk Region,Manufacture of Food Products,small,38,84,37,47,439,436,3
2022,2,Tabuk Region,Manufacture of Food Products,large,1,81,16,65,200,200,0
2022,2,Tabuk Region,Manufacture of Food Products,micro,192,41,17,24,375,375,0
2022,2,Tabuk Region,Manufacture of Food Products,medium,5,96,32,64,324,324,0
2022,2,Jazan Region,Manufacture of Food Products,small,55,125,71,54,704,698,6
2022,2,Jazan Region,Manufacture of Food Products,micro,265,57,38,19,556,554,2
2022,2,Jazan Region,Manufacture of Food Products,medium,6,116,38,78,476,476,0
2022,2,Hail Region,Manufacture of Food Products,small,22,65,35,30,218,217,1
2022,2,Hail Region,Manufacture of Food Products,large,1,74,35,39,197,196,1
2022,2,Hail Region,Manufacture of Food Products,micro,197,34,11,23,411,408,3
2022,2,Hail Region,Manufacture of Food Products,medium,10,177,36,141,821,818,3
2022,2,Aseer Region,Manufacture of Food Products,small,79,224,118,106,854,854,0
2022,2,Aseer Region,Manufacture of Food Products,large,3,204,118,86,1135,1135,0
2022,2,Aseer Region,Manufacture of Food Products,micro,477,101,58,43,861,861,0
2022,2,Aseer Region,Manufacture of Food Products,medium,14,416,250,166,1165,1164,1
2022,2,Makkah Region,Manufacture of Food Products,small,402,1243,594,649,4984,4941,43
2022,2,Makkah Region,Manufacture of Food Products,large,35,6395,3501,2894,18001,17656,345
2022,2,Makkah Region,Manufacture of Food Products,micro,1384,406,201,205,2850,2828,22
2022,2,Makkah Region,Manufacture of Food Products,medium,75,2047,1072,975,5487,5404,83
2022,2,Najran Region,Manufacture of Food Products,small,21,32,12,20,231,231,0
2022,2,Najran Region,Manufacture of Food Products,micro,155,42,26,16,340,338,2
2022,2,Eastern Province,Manufacture of Basic Pharmaceuticals and Pharmaceutical Preparations,small,10,48,29,19,164,152,12
2022,2,Eastern Province,Manufacture of Basic Pharmaceuticals and Pharmaceutical Preparations,micro,8,5,2,3,16,13,3
2022,2,Eastern Province,Manufacture of Basic Pharmaceuticals and Pharmaceutical Preparations,medium,4,184,137,47,191,189,2
2022,2,Al Jawf Region,Manufacture of Basic Pharmaceuticals and Pharmaceutical Preparations,micro,4,0,0,0,10,10,0
2022,2,Northern Borders Region,Manufacture of Basic Pharmaceuticals and Pharmaceutical Preparations,micro,1,1,0,1,0,0,0
2022,2,Riyadh Region,Manufacture of Basic Pharmaceuticals and Pharmaceutical Preparations,small,25,202,92,110,329,318,11
2022,2,Riyadh Region,Manufacture of Basic Pharmaceuticals and Pharmaceutical Preparations,large,5,552,269,283,1479,1451,28
2022,2,Riyadh Region,Manufacture of Basic Pharmaceuticals and Pharmaceutical Preparations,micro,127,31,18,13,310,309,1
2022,2,Riyadh Region,Manufacture of Basic Pharmaceuticals and Pharmaceutical Preparations,medium,5,141,61,80,297,292,5
2022,2,Qassim Region,Manufacture of Basic Pharmaceuticals and Pharmaceutical Preparations,small,2,11,3,8,11,11,0
2022,2,Qassim Region,Manufacture of Basic Pharmaceuticals and Pharmaceutical Preparations,large,1,290,275,15,314,309,5
2022,2,Qassim Region,Manufacture of Basic Pharmaceuticals and Pharmaceutical Preparations,micro,9,0,0,0,16,16,0
2022,2,Qassim Region,Manufacture of Basic Pharmaceuticals and Pharmaceutical Preparations,medium,1,34,29,5,94,85,9
2022,2,Al Madinah Region,Manufacture of Basic Pharmaceuticals and Pharmaceutical Preparations,small,2,10,7,3,38,38,0
2022,2,Al Madinah Region,Manufacture of Basic Pharmaceuticals and Pharmaceutical Preparations,micro,4,1,0,1,6,6,0
2022,2,Tabuk Region,Manufacture of Basic Pharmaceuticals and Pharmaceutical Preparations,micro,1,0,0,0,4,4,0
2022,2,Jazan Region,Manufacture of Basic Pharmaceuticals and Pharmaceutical Preparations,small,1,1,1,0,5,5,0
2022,2,Jazan Region,Manufacture of Basic Pharmaceuticals and Pharmaceutical Preparations,micro,5,0,0,0,11,9,2
2022,2,Hail Region,Manufacture of Basic Pharmaceuticals and Pharmaceutical Preparations,micro,5,0,0,0,13,13,0
2022,2,Aseer Region,Manufacture of Basic Pharmaceuticals and Pharmaceutical Preparations,micro,5,2,1,1,18,18,0
2022,2,Aseer Region,Manufacture of Basic Pharmaceuticals and Pharmaceutical Preparations,medium,1,16,4,12,37,33,4
2022,2,Makkah Region,Manufacture of Basic Pharmaceuticals and Pharmaceutical Preparations,small,9,32,23,9,91,86,5
2022,2,Makkah Region,Manufacture of Basic Pharmaceuticals and Pharmaceutical Preparations,large,2,593,316,277,674,655,19
2022,2,Makkah Region,Manufacture of Basic Pharmaceuticals and Pharmaceutical Preparations,micro,14,18,13,5,17,17,0
2022,2,Makkah Region,Manufacture of Basic Pharmaceuticals and Pharmaceutical Preparations,medium,8,424,224,200,539,523,16
2022,2,Najran Region,Manufacture of Basic Pharmaceuticals and Pharmaceutical Preparations,small,1,0,0,0,8,8,0
2022,2,Eastern Province,Manufacture of Leather and Leather Products,small,8,14,7,7,104,104,0
2022,2,Eastern Province,Manufacture of Leather and Leather Products,micro,13,0,0,0,25,25,0
2022,2,Eastern Province,Manufacture of Leather and Leather Products,medium,2,57,55,2,140,140,0
2022,2,Al Bahah Region,Manufacture of Leather and Leather Products,micro,2,0,0,0,5,5,0
2022,2,Al Jawf Region,Manufacture of Leather and Leather Products,small,1,1,1,0,5,5,0
2022,2,Al Jawf Region,Manufacture of Leather and Leather Products,micro,1,0,0,0,3,3,0
2022,2,Northern Borders Region,Manufacture of Leather and Leather Products,small,3,1,1,0,23,23,0
2022,2,Northern Borders Region,Manufacture of Leather and Leather Products,micro,3,0,0,0,10,10,0
2022,2,Riyadh Region,Manufacture of Leather and Leather Products,small,37,36,17,19,384,382,2
2022,2,Riyadh Region,Manufacture of Leather and Leather Products,large,2,180,46,134,634,634,0
2022,2,Riyadh Region,Manufacture of Leather and Leather Products,micro,67,9,6,3,168,168,0
2022,2,Riyadh Region,Manufacture of Leather and Leather Products,medium,4,92,33,59,261,260,1
2022,2,Qassim Region,Manufacture of Leather and Leather Products,micro,6,2,0,2,16,16,0
2022,2,Al Madinah Region,Manufacture of Leather and Leather Products,small,2,3,0,3,20,20,0
2022,2,Al Madinah Region,Manufacture of Leather and Leather Products,micro,8,3,3,0,23,23,0
2022,2,Al Madinah Region,Manufacture of Leather and Leather Products,medium,1,24,10,14,113,113,0
2022,2,Jazan Region,Manufacture of Leather and Leather Products,small,1,0,0,0,6,6,0
2022,2,Jazan Region,Manufacture of Leather and Leather Products,micro,59,4,3,1,204,204,0
2022,2,Hail Region,Manufacture of Leather and Leather Products,small,1,0,0,0,6,6,0
2022,2,Hail Region,Manufacture of Leather and Leather Products,micro,9,2,0,2,22,22,0
2022,2,Aseer Region,Manufacture of Leather and Leather Products,small,1,0,0,0,10,10,0
2022,2,Aseer Region,Manufacture of Leather and Leather Products,micro,13,3,1,2,38,38,0
2022,2,Makkah Region,Manufacture of Leather and Leather Products,small,5,22,11,11,93,92,1
2022,2,Makkah Region,Manufacture of Leather and Leather Products,micro,30,3,0,3,79,78,1
2022,2,Makkah Region,Manufacture of Leather and Leather Products,medium,2,28,15,13,98,98,0
2022,2,Najran Region,Manufacture of Leather and Leather Products,micro,4,3,0,3,5,5,0
2022,2,Eastern Province,Manufacture of Wearing Apparel,small,242,532,206,326,2450,2233,217
2022,2,Eastern Province,Manufacture of Wearing Apparel,micro,2080,384,164,220,4382,4062,320
2022,2,Eastern Province,Manufacture of Wearing Apparel,medium,12,289,76,213,710,707,3
2022,2,Al Bahah Region,Manufacture of Wearing Apparel,small,14,29,15,14,124,105,19
2022,2,Al Bahah Region,Manufacture of Wearing Apparel,micro,154,34,24,10,303,247,56
2022,2,Al Jawf Region,Manufacture of Wearing Apparel,small,18,20,13,7,117,107,10
2022,2,Al Jawf Region,Manufacture of Wearing Apparel,micro,277,42,25,17,588,545,43
2022,2,Northern Borders Region,Manufacture of Wearing Apparel,small,7,11,2,9,76,52,24
2022,2,Northern Borders Region,Manufacture of Wearing Apparel,micro,280,37,19,18,681,646,35
2022,2,Riyadh Region,Manufacture of Wearing Apparel,small,420,954,329,625,4264,3791,473
2022,2,Riyadh Region,Manufacture of Wearing Apparel,large,7,966,165,801,2095,2034,61
2022,2,Riyadh Region,Manufacture of Wearing Apparel,micro,3588,668,219,449,7663,7083,580
2022,2,Riyadh Region,Manufacture of Wearing Apparel,medium,24,593,189,404,1856,1658,198
2022,2,Qassim Region,Manufacture of Wearing Apparel,small,52,71,34,37,440,387,53
2022,2,Qassim Region,Manufacture of Wearing Apparel,micro,732,114,54,60,1564,1442,122
2022,2,Qassim Region,Manufacture of Wearing Apparel,medium,5,65,54,11,462,457,5
2022,2,Al Madinah Region,Manufacture of Wearing Apparel,small,71,100,44,56,596,516,80
2022,2,Al Madinah Region,Manufacture of Wearing Apparel,micro,968,158,69,89,2076,1806,270
2022,2,Al Madinah Region,Manufacture of Wearing Apparel,medium,3,64,37,27,215,211,4
2022,2,Tabuk Region,Manufacture of Wearing Apparel,small,32,40,14,26,280,264,16
2022,2,Tabuk Region,Manufacture of Wearing Apparel,micro,783,96,54,42,2024,1980,44
2022,2,Tabuk Region,Manufacture of Wearing Apparel,medium,1,0,0,0,87,87,0
2022,2,Jazan Region,Manufacture of Wearing Apparel,small,25,25,13,12,182,158,24
2022,2,Jazan Region,Manufacture of Wearing Apparel,micro,594,65,41,24,1386,1268,118
2022,2,Hail Region,Manufacture of Wearing Apparel,small,26,43,11,32,205,156,49
2022,2,Hail Region,Manufacture of Wearing Apparel,micro,395,41,21,20,841,774,67
2022,2,Aseer Region,Manufacture of Wearing Apparel,small,57,81,36,45,521,479,42
2022,2,Aseer Region,Manufacture of Wearing Apparel,micro,938,154,83,71,2028,1812,216
2022,2,Aseer Region,Manufacture of Wearing Apparel,medium,3,43,27,16,191,191,0
2022,2,Makkah Region,Manufacture of Wearing Apparel,small,219,486,177,309,2019,1834,185
2022,2,Makkah Region,Manufacture of Wearing Apparel,large,1,142,38,104,413,413,0
2022,2,Makkah Region,Manufacture of Wearing Apparel,micro,2738,488,206,282,5852,5266,586
2022,2,Makkah Region,Manufacture of Wearing Apparel,medium,16,404,93,311,1059,965,94
2022,2,Najran Region,Manufacture of Wearing Apparel,small,21,19,6,13,181,161,20
2022,2,Najran Region,Manufacture of Wearing Apparel,micro,413,66,30,36,941,882,59
2022,2,Najran Region,Manufacture of Wearing Apparel,medium,1,16,2,14,43,43,0
2022,2,Eastern Province,Manufacture of Electrical Equipment,small,59,291,199,92,816,813,3
2022,2,Eastern Province,Manufacture of Electrical Equipment,large,6,1781,1731,50,1303,1299,4
2022,2,Eastern Province,Manufacture of Electrical Equipment,micro,155,57,33,24,320,319,1
2022,2,Eastern Province,Manufacture of Electrical Equipment,medium,24,748,558,190,1655,1653,2
2022,2,Al Bahah Region,Manufacture of Electrical Equipment,micro,10,0,0,0,17,17,0
2022,2,Al Jawf Region,Manufacture of Electrical Equipment,small,2,0,0,0,14,14,0
2022,2,Al Jawf Region,Manufacture of Electrical Equipment,micro,13,1,1,0,29,29,0
2022,2,Northern Borders Region,Manufacture of Electrical Equipment,small,1,0,0,0,6,6,0
2022,2,Northern Borders Region,Manufacture of Electrical Equipment,micro,19,0,0,0,46,46,0
2022,2,Riyadh Region,Manufacture of Electrical Equipment,small,91,371,205,166,1466,1463,3
2022,2,Riyadh Region,Manufacture of Electrical Equipment,large,8,765,687,78,1999,1996,3
2022,2,Riyadh Region,Manufacture of Electrical Equipment,micro,170,57,35,22,369,367,2
2022,2,Riyadh Region,Manufacture of Electrical Equipment,medium,51,1433,855,578,4288,4280,8
2022,2,Qassim Region,Manufacture of Electrical Equipment,small,11,34,22,12,167,167,0
2022,2,Qassim Region,Manufacture of Electrical Equipment,micro,26,2,0,2,52,52,0
2022,2,Qassim Region,Manufacture of Electrical Equipment,medium,1,19,19,0,72,72,0
2022,2,Al Madinah Region,Manufacture of Electrical Equipment,small,11,42,25,17,152,152,0
2022,2,Al Madinah Region,Manufacture of Electrical Equipment,large,1,97,90,7,295,295,0
2022,2,Al Madinah Region,Manufacture of Electrical Equipment,micro,39,10,9,1,80,80,0
2022,2,Al Madinah Region,Manufacture of Electrical Equipment,medium,2,68,37,31,254,254,0
2022,2,Tabuk Region,Manufacture of Electrical Equipment,small,1,0,0,0,6,6,0
2022,2,Tabuk Region,Manufacture of Electrical Equipment,micro,16,0,0,0,36,36,0
2022,2,Jazan Region,Manufacture of Electrical Equipment,small,1,0,0,0,6,6,0
2022,2,Jazan Region,Manufacture of Electrical Equipment,micro,32,2,1,1,84,84,0
2022,2,Hail Region,Manufacture of Electrical Equipment,small,1,0,0,0,6,6,0
2022,2,Hail Region,Manufacture of Electrical Equipment,micro,13,6,1,5,35,35,0
2022,2,Aseer Region,Manufacture of Electrical Equipment,small,6,18,10,8,74,74,0
2022,2,Aseer Region,Manufacture of Electrical Equipment,micro,32,4,3,1,69,69,0
2022,2,Makkah Region,Manufacture of Electrical Equipment,small,53,178,108,70,739,735,4
2022,2,Makkah Region,Manufacture of Electrical Equipment,large,3,378,357,21,1266,1265,1
2022,2,Makkah Region,Manufacture of Electrical Equipment,micro,147,30,19,11,326,322,4
2022,2,Makkah Region,Manufacture of Electrical Equipment,medium,7,155,90,65,510,509,1
2022,2,Najran Region,Manufacture of Electrical Equipment,small,2,7,5,2,34,34,0
2022,2,Najran Region,Manufacture of Electrical Equipment,micro,8,2,0,2,16,16,0
2022,2,Eastern Province,Manufacture of Beverages,small,20,100,54,46,321,320,1
2022,2,Eastern Province,Manufacture of Beverages,large,4,593,386,207,1486,1485,1
2022,2,Eastern Province,Manufacture of Beverages,micro,39,13,6,7,85,85,0
2022,2,Eastern Province,Manufacture of Beverages,medium,4,109,44,65,314,312,2
2022,2,Al Bahah Region,Manufacture of Beverages,small,1,18,1,17,4,4,0
2022,2,Al Bahah Region,Manufacture of Beverages,micro,4,1,1,0,6,6,0
2022,2,Al Bahah Region,Manufacture of Beverages,medium,3,55,25,30,175,171,4
2022,2,Al Jawf Region,Manufacture of Beverages,small,2,4,0,4,12,12,0
2022,2,Al Jawf Region,Manufacture of Beverages,micro,7,1,0,1,11,11,0
2022,2,Al Jawf Region,Manufacture of Beverages,medium,1,15,9,6,50,50,0
2022,2,Northern Borders Region,Manufacture of Beverages,small,1,3,2,1,10,10,0
2022,2,Riyadh Region,Manufacture of Beverages,small,50,238,97,141,725,721,4
2022,2,Riyadh Region,Manufacture of Beverages,large,15,2102,1443,659,5289,5280,9
2022,2,Riyadh Region,Manufacture of Beverages,micro,67,21,7,14,151,149,2
2022,2,Riyadh Region,Manufacture of Beverages,medium,27,743,375,368,2028,2024,4
2022,2,Qassim Region,Manufacture of Beverages,small,7,13,8,5,95,95,0
2022,2,Qassim Region,Manufacture of Beverages,large,2,369,159,210,743,743,0
2022,2,Qassim Region,Manufacture of Beverages,micro,16,5,2,3,27,27,0
2022,2,Qassim Region,Manufacture of Beverages,medium,4,126,50,76,357,357,0
2022,2,Al Madinah Region,Manufacture of Beverages,small,11,45,29,16,187,186,1
2022,2,Al Madinah Region,Manufacture of Beverages,micro,22,10,7,3,42,42,0
2022,2,Al Madinah Region,Manufacture of Beverages,medium,4,115,59,56,360,360,0
2022,2,Tabuk Region,Manufacture of Beverages,small,3,10,6,4,56,56,0
2022,2,Tabuk Region,Manufacture of Beverages,micro,21,1,0,1,43,43,0
2022,2,Tabuk Region,Manufacture of Beverages,medium,3,110,59,51,205,204,1
2022,2,Jazan Region,Manufacture of Beverages,small,2,1,1,0,19,19,0
2022,2,Jazan Region,Manufacture of Beverages,large,2,120,66,54,437,437,0
2022,2,Jazan Region,Manufacture of Beverages,micro,21,3,1,2,48,48,0
2022,2,Jazan Region,Manufacture of Beverages,medium,5,154,95,59,403,403,0
2022,2,Hail Region,Manufacture of Beverages,small,4,18,12,6,65,65,0
2022,2,Hail Region,Manufacture of Beverages,large,1,70,38,32,183,183,0
2022,2,Hail Region,Manufacture of Beverages,micro,6,2,2,0,16,16,0
2022,2,Hail Region,Manufacture of Beverages,medium,1,13,4,9,42,41,1
2022,2,Aseer Region,Manufacture of Beverages,small,10,37,28,9,178,178,0
2022,2,Aseer Region,Manufacture of Beverages,large,1,136,126,10,309,309,0
2022,2,Aseer Region,Manufacture of Beverages,micro,25,5,1,4,58,58,0
2022,2,Aseer Region,Manufacture of Beverages,medium,1,32,24,8,67,67,0
2022,2,Makkah Region,Manufacture of Beverages,small,47,210,99,111,680,680,0
2022,2,Makkah Region,Manufacture of Beverages,large,4,951,779,172,1776,1770,6
2022,2,Makkah Region,Manufacture of Beverages,micro,104,29,19,10,203,200,3
2022,2,Makkah Region,Manufacture of Beverages,medium,17,628,386,242,1811,1808,3
2022,2,Najran Region,Manufacture of Beverages,small,3,22,8,14,56,55,1
2022,2,Najran Region,Manufacture of Beverages,micro,6,3,1,2,12,12,0
2022,2,Najran Region,Manufacture of Beverages,medium,1,86,67,19,126,126,0
2022,2,Eastern Province,Manufacture of Basic Metals,small,102,526,375,151,1569,1566,3
2022,2,Eastern Province,Manufacture of Basic Metals,large,13,2355,2252,103,3757,3757,0
2022,2,Eastern Province,Manufacture of Basic Metals,micro,130,55,43,12,254,254,0
2022,2,Eastern Province,Manufacture of Basic Metals,medium,59,1914,1460,454,5081,5080,1
2022,2,Al Bahah Region,Manufacture of Basic Metals,micro,12,1,1,0,28,28,0
2022,2,Al Jawf Region,Manufacture of Basic Metals,small,2,1,1,0,12,12,0
2022,2,Al Jawf Region,Manufacture of Basic Metals,micro,16,0,0,0,39,39,0
2022,2,Northern Borders Region,Manufacture of Basic Metals,small,2,2,1,1,13,13,0
2022,2,Northern Borders Region,Manufacture of Basic Metals,micro,12,1,1,0,34,34,0
2022,2,Riyadh Region,Manufacture of Basic Metals,small,193,627,332,295,2829,2818,11
2022,2,Riyadh Region,Manufacture of Basic Metals,large,8,721,506,215,2769,2765,4
2022,2,Riyadh Region,Manufacture of Basic Metals,micro,388,96,44,52,840,835,5
2022,2,Riyadh Region,Manufacture of Basic Metals,medium,53,1295,787,508,4126,4103,23
2022,2,Qassim Region,Manufacture of Basic Metals,small,17,44,28,16,287,286,1
2022,2,Qassim Region,Manufacture of Basic Metals,micro,85,12,7,5,199,198,1
2022,2,Qassim Region,Manufacture of Basic Metals,medium,3,32,23,9,195,195,0
2022,2,Al Madinah Region,Manufacture of Basic Metals,small,11,32,26,6,131,130,1
2022,2,Al Madinah Region,Manufacture of Basic Metals,micro,69,7,4,3,142,142,0
2022,2,Al Madinah Region,Manufacture of Basic Metals,medium,2,189,176,13,183,183,0
2022,2,Tabuk Region,Manufacture of Basic Metals,small,3,13,2,11,25,25,0
2022,2,Tabuk Region,Manufacture of Basic Metals,micro,19,3,3,0,37,37,0
2022,2,Tabuk Region,Manufacture of Basic Metals,medium,1,31,17,14,97,97,0
2022,2,Jazan Region,Manufacture of Basic Metals,small,2,8,3,5,23,23,0
2022,2,Jazan Region,Manufacture of Basic Metals,large,1,152,152,0,114,114,0
2022,2,Jazan Region,Manufacture of Basic Metals,micro,44,4,2,2,101,101,0
2022,2,Jazan Region,Manufacture of Basic Metals,medium,2,104,92,12,237,237,0
2022,2,Hail Region,Manufacture of Basic Metals,small,5,4,3,1,36,36,0
2022,2,Hail Region,Manufacture of Basic Metals,micro,52,6,5,1,111,111,0
2022,2,Hail Region,Manufacture of Basic Metals,medium,2,24,12,12,103,103,0
2022,2,Aseer Region,Manufacture of Basic Metals,small,19,65,54,11,247,247,0
2022,2,Aseer Region,Manufacture of Basic Metals,micro,78,12,7,5,166,166,0
2022,2,Aseer Region,Manufacture of Basic Metals,medium,1,31,30,1,108,108,0
2022,2,Makkah Region,Manufacture of Basic Metals,small,90,319,171,148,1302,1301,1
2022,2,Makkah Region,Manufacture of Basic Metals,large,10,1100,719,381,2506,2505,1
2022,2,Makkah Region,Manufacture of Basic Metals,micro,189,76,42,34,391,387,4
2022,2,Makkah Region,Manufacture of Basic Metals,medium,29,838,661,177,2338,2322,16
2022,2,Najran Region,Manufacture of Basic Metals,small,4,2,2,0,29,29,0
2022,2,Najran Region,Manufacture of Basic Metals,large,1,194,192,2,344,343,1
2022,2,Najran Region,Manufacture of Basic Metals,micro,55,4,2,2,138,138,0
2022,2,Najran Region,Manufacture of Basic Metals,medium,1,30,17,13,77,77,0
2022,2,Eastern Province,"Manufacture of Wood and Wood Products (Except Furniture), Manufacture of Straw and Plaiting Materials",small,155,372,194,178,1708,1702,6
2022,2,Eastern Province,"Manufacture of Wood and Wood Products (Except Furniture), Manufacture of Straw and Plaiting Materials",large,1,59,59,0,198,198,0
2022,2,Eastern Province,"Manufacture of Wood and Wood Products (Except Furniture), Manufacture of Straw and Plaiting Materials",micro,407,143,63,80,876,876,0
2022,2,Eastern Province,"Manufacture of Wood and Wood Products (Except Furniture), Manufacture of Straw and Plaiting Materials",medium,15,361,245,116,1235,1233,2
2022,2,Al Bahah Region,"Manufacture of Wood and Wood Products (Except Furniture), Manufacture of Straw and Plaiting Materials",small,11,14,12,2,77,77,0
2022,2,Al Bahah Region,"Manufacture of Wood and Wood Products (Except Furniture), Manufacture of Straw and Plaiting Materials",micro,71,20,11,9,153,152,1
2022,2,Al Jawf Region,"Manufacture of Wood and Wood Products (Except Furniture), Manufacture of Straw and Plaiting Materials",small,8,8,6,2,58,58,0
2022,2,Al Jawf Region,"Manufacture of Wood and Wood Products (Except Furniture), Manufacture of Straw and Plaiting Materials",micro,70,9,6,3,143,143,0
2022,2,Northern Borders Region,"Manufacture of Wood and Wood Products (Except Furniture), Manufacture of Straw and Plaiting Materials",small,3,4,3,1,15,15,0
2022,2,Northern Borders Region,"Manufacture of Wood and Wood Products (Except Furniture), Manufacture of Straw and Plaiting Materials",micro,46,7,3,4,98,98,0
2022,2,Riyadh Region,"Manufacture of Wood and Wood Products (Except Furniture), Manufacture of Straw and Plaiting Materials",small,269,643,256,387,3159,3143,16
2022,2,Riyadh Region,"Manufacture of Wood and Wood Products (Except Furniture), Manufacture of Straw and Plaiting Materials",micro,809,254,112,142,1833,1826,7
2022,2,Riyadh Region,"Manufacture of Wood and Wood Products (Except Furniture), Manufacture of Straw and Plaiting Materials",medium,24,589,229,360,1910,1838,72
2022,2,Qassim Region,"Manufacture of Wood and Wood Products (Except Furniture), Manufacture of Straw and Plaiting Materials",small,30,57,30,27,359,355,4
2022,2,Qassim Region,"Manufacture of Wood and Wood Products (Except Furniture), Manufacture of Straw and Plaiting Materials",large,1,63,44,19,199,199,0
2022,2,Qassim Region,"Manufacture of Wood and Wood Products (Except Furniture), Manufacture of Straw and Plaiting Materials",micro,234,55,25,30,578,574,4
2022,2,Al Madinah Region,"Manufacture of Wood and Wood Products (Except Furniture), Manufacture of Straw and Plaiting Materials",small,26,38,22,16,195,195,0
2022,2,Al Madinah Region,"Manufacture of Wood and Wood Products (Except Furniture), Manufacture of Straw and Plaiting Materials",micro,144,41,23,18,334,334,0
2022,2,Al Madinah Region,"Manufacture of Wood and Wood Products (Except Furniture), Manufacture of Straw and Plaiting Materials",medium,2,21,16,5,84,84,0
2022,2,Tabuk Region,"Manufacture of Wood and Wood Products (Except Furniture), Manufacture of Straw and Plaiting Materials",small,14,15,9,6,82,82,0
2022,2,Tabuk Region,"Manufacture of Wood and Wood Products (Except Furniture), Manufacture of Straw and Plaiting Materials",micro,76,8,2,6,177,177,0
2022,2,Jazan Region,"Manufacture of Wood and Wood Products (Except Furniture), Manufacture of Straw and Plaiting Materials",small,17,28,14,14,136,135,1
2022,2,Jazan Region,"Manufacture of Wood and Wood Products (Except Furniture), Manufacture of Straw and Plaiting Materials",micro,177,34,22,12,431,431,0
2022,2,Jazan Region,"Manufacture of Wood and Wood Products (Except Furniture), Manufacture of Straw and Plaiting Materials",medium,1,21,2,19,68,68,0
2022,2,Hail Region,"Manufacture of Wood and Wood Products (Except Furniture), Manufacture of Straw and Plaiting Materials",small,10,27,9,18,126,126,0
2022,2,Hail Region,"Manufacture of Wood and Wood Products (Except Furniture), Manufacture of Straw and Plaiting Materials",micro,53,15,8,7,117,117,0
2022,2,Aseer Region,"Manufacture of Wood and Wood Products (Except Furniture), Manufacture of Straw and Plaiting Materials",small,42,69,49,20,386,386,0
2022,2,Aseer Region,"Manufacture of Wood and Wood Products (Except Furniture), Manufacture of Straw and Plaiting Materials",micro,264,69,35,34,615,614,1
2022,2,Aseer Region,"Manufacture of Wood and Wood Products (Except Furniture), Manufacture of Straw and Plaiting Materials",medium,1,11,5,6,47,47,0
2022,2,Makkah Region,"Manufacture of Wood and Wood Products (Except Furniture), Manufacture of Straw and Plaiting Materials",small,109,247,102,145,1144,1142,2
2022,2,Makkah Region,"Manufacture of Wood and Wood Products (Except Furniture), Manufacture of Straw and Plaiting Materials",large,2,228,197,31,764,764,0
2022,2,Makkah Region,"Manufacture of Wood and Wood Products (Except Furniture), Manufacture of Straw and Plaiting Materials",micro,628,134,74,60,1428,1419,9
2022,2,Makkah Region,"Manufacture of Wood and Wood Products (Except Furniture), Manufacture of Straw and Plaiting Materials",medium,13,271,162,109,970,962,8
2022,2,Najran Region,"Manufacture of Wood and Wood Products (Except Furniture), Manufacture of Straw and Plaiting Materials",small,5,5,3,2,35,35,0
2022,2,Najran Region,"Manufacture of Wood and Wood Products (Except Furniture), Manufacture of Straw and Plaiting Materials",micro,80,8,3,5,178,178,0
2022,2,Eastern Province,"Manufacture of Computers, Electronic and Optical Products",small,23,120,87,33,239,239,0
2022,2,Eastern Province,"Manufacture of Computers, Electronic and Optical Products",micro,73,34,24,10,140,137,3
2022,2,Eastern Province,"Manufacture of Computers, Electronic and Optical Products",medium,4,120,92,28,277,276,1
2022,2,Al Bahah Region,"Manufacture of Computers, Electronic and Optical Products",small,1,3,3,0,4,4,0
2022,2,Al Bahah Region,"Manufacture of Computers, Electronic and Optical Products",micro,8,7,7,0,16,16,0
2022,2,Al Jawf Region,"Manufacture of Computers, Electronic and Optical Products",micro,4,1,0,1,13,13,0
2022,2,Northern Borders Region,"Manufacture of Computers, Electronic and Optical Products",micro,5,0,0,0,9,9,0
2022,2,Riyadh Region,"Manufacture of Computers, Electronic and Optical Products",small,24,89,55,34,333,333,0
2022,2,Riyadh Region,"Manufacture of Computers, Electronic and Optical Products",micro,78,25,15,10,144,144,0
2022,2,Riyadh Region,"Manufacture of Computers, Electronic and Optical Products",medium,2,11,3,8,90,86,4
2022,2,Qassim Region,"Manufacture of Computers, Electronic and Optical Products",micro,12,3,3,0,22,22,0
2022,2,Al Madinah Region,"Manufacture of Computers, Electronic and Optical Products",small,4,8,5,3,37,37,0
2022,2,Al Madinah Region,"Manufacture of Computers, Electronic and Optical Products",micro,22,5,3,2,50,50,0
2022,2,Tabuk Region,"Manufacture of Computers, Electronic and Optical Products",small,3,9,4,5,13,13,0
2022,2,Tabuk Region,"Manufacture of Computers, Electronic and Optical Products",micro,15,1,0,1,28,28,0
2022,2,Jazan Region,"Manufacture of Computers, Electronic and Optical Products",small,4,6,5,1,45,45,0
2022,2,Jazan Region,"Manufacture of Computers, Electronic and Optical Products",micro,29,2,2,0,75,75,0
2022,2,Hail Region,"Manufacture of Computers, Electronic and Optical Products",small,1,1,0,1,7,7,0
2022,2,Hail Region,"Manufacture of Computers, Electronic and Optical Products",micro,14,0,0,0,35,33,2
2022,2,Aseer Region,"Manufacture of Computers, Electronic and Optical Products",small,4,4,3,1,24,24,0
2022,2,Aseer Region,"Manufacture of Computers, Electronic and Optical Products",micro,53,3,3,0,105,105,0
2022,2,Makkah Region,"Manufacture of Computers, Electronic and Optical Products",small,26,63,44,19,220,205,15
2022,2,Makkah Region,"Manufacture of Computers, Electronic and Optical Products",micro,160,49,30,19,307,306,1
2022,2,Makkah Region,"Manufacture of Computers, Electronic and Optical Products",medium,2,58,43,15,75,72,3
2022,2,Najran Region,"Manufacture of Computers, Electronic and Optical Products",micro,9,2,0,2,21,21,0
2022,2,Eastern Province,Manufacture of Furniture,small,156,439,232,207,1924,1916,8
2022,2,Eastern Province,Manufacture of Furniture,large,3,236,147,89,798,796,2
2022,2,Eastern Province,Manufacture of Furniture,micro,533,143,68,75,1179,1178,1
2022,2,Eastern Province,Manufacture of Furniture,medium,26,548,361,187,2093,2091,2
2022,2,Al Bahah Region,Manufacture of Furniture,small,9,15,13,2,66,66,0
2022,2,Al Bahah Region,Manufacture of Furniture,micro,75,14,8,6,163,163,0
2022,2,Al Jawf Region,Manufacture of Furniture,small,10,17,11,6,81,80,1
2022,2,Al Jawf Region,Manufacture of Furniture,micro,112,19,10,9,244,243,1
2022,2,Northern Borders Region,Manufacture of Furniture,small,5,5,5,0,31,31,0
2022,2,Northern Borders Region,Manufacture of Furniture,micro,82,19,10,9,216,216,0
2022,2,Riyadh Region,Manufacture of Furniture,small,463,999,413,586,5831,5803,28
2022,2,Riyadh Region,Manufacture of Furniture,large,11,800,395,405,3257,3250,7
2022,2,Riyadh Region,Manufacture of Furniture,micro,1269,287,141,146,3018,3008,10
2022,2,Riyadh Region,Manufacture of Furniture,medium,67,1296,598,698,4970,4949,21
2022,2,Qassim Region,Manufacture of Furniture,small,49,103,60,43,701,698,3
2022,2,Qassim Region,Manufacture of Furniture,large,1,73,23,50,334,334,0
2022,2,Qassim Region,Manufacture of Furniture,micro,222,52,34,18,515,512,3
2022,2,Qassim Region,Manufacture of Furniture,medium,7,109,78,31,475,475,0
2022,2,Al Madinah Region,Manufacture of Furniture,small,35,48,28,20,341,340,1
2022,2,Al Madinah Region,Manufacture of Furniture,micro,238,54,34,20,527,524,3
2022,2,Al Madinah Region,Manufacture of Furniture,medium,1,14,10,4,67,67,0
2022,2,Tabuk Region,Manufacture of Furniture,small,18,21,6,15,168,168,0
2022,2,Tabuk Region,Manufacture of Furniture,micro,186,29,16,13,466,466,0
2022,2,Jazan Region,Manufacture of Furniture,small,16,17,10,7,145,145,0
2022,2,Jazan Region,Manufacture of Furniture,micro,313,43,20,23,822,820,2
2022,2,Hail Region,Manufacture of Furniture,small,22,26,17,9,205,204,1
2022,2,Hail Region,Manufacture of Furniture,micro,150,25,15,10,359,359,0
2022,2,Hail Region,Manufacture of Furniture,medium,1,19,14,5,69,69,0
2022,2,Aseer Region,Manufacture of Furniture,small,69,109,78,31,688,685,3
2022,2,Aseer Region,Manufacture of Furniture,micro,469,95,58,37,1080,1080,0
2022,2,Aseer Region,Manufacture of Furniture,medium,1,14,8,6,40,40,0
2022,2,Makkah Region,Manufacture of Furniture,small,136,268,139,129,1528,1509,19
2022,2,Makkah Region,Manufacture of Furniture,large,1,79,56,23,280,279,1
2022,2,Makkah Region,Manufacture of Furniture,micro,667,143,76,67,1518,1508,10
2022,2,Makkah Region,Manufacture of Furniture,medium,21,561,254,307,2029,2024,5
2022,2,Najran Region,Manufacture of Furniture,small,25,24,7,17,242,242,0
2022,2,Najran Region,Manufacture of Furniture,micro,106,22,7,15,258,258,0
2022,2,Najran Region,Manufacture of Furniture,medium,2,12,10,2,164,164,0
2022,2,Eastern Province,Manufacture of Other Transport Equipment,small,8,43,27,16,120,120,0
2022,2,Eastern Province,Manufacture of Other Transport Equipment,large,2,2164,2131,33,755,754,1
2022,2,Eastern Province,Manufacture of Other Transport Equipment,micro,13,7,6,1,22,22,0
2022,2,Eastern Province,Manufacture of Other Transport Equipment,medium,2,137,132,5,274,274,0
2022,2,Al Bahah Region,Manufacture of Other Transport Equipment,micro,1,0,0,0,1,1,0
2022,2,Al Jawf Region,Manufacture of Other Transport Equipment,small,1,0,0,0,40,40,0
2022,2,Al Jawf Region,Manufacture of Other Transport Equipment,micro,2,0,0,0,6,6,0
2022,2,Northern Borders Region,Manufacture of Other Transport Equipment,micro,2,0,0,0,6,6,0
2022,2,Riyadh Region,Manufacture of Other Transport Equipment,small,17,77,59,18,197,196,1
2022,2,Riyadh Region,Manufacture of Other Transport Equipment,large,1,1313,1286,27,639,639,0
2022,2,Riyadh Region,Manufacture of Other Transport Equipment,micro,75,29,16,13,178,178,0
2022,2,Riyadh Region,Manufacture of Other Transport Equipment,medium,6,451,372,79,486,486,0
2022,2,Qassim Region,Manufacture of Other Transport Equipment,micro,4,0,0,0,6,5,1
2022,2,Al Madinah Region,Manufacture of Other Transport Equipment,small,1,0,0,0,12,12,0
2022,2,Al Madinah Region,Manufacture of Other Transport Equipment,micro,6,1,0,1,9,9,0
2022,2,Tabuk Region,Manufacture of Other Transport Equipment,small,1,1,0,1,5,5,0
2022,2,Jazan Region,Manufacture of Other Transport Equipment,small,2,6,5,1,28,28,0
2022,2,Jazan Region,Manufacture of Other Transport Equipment,micro,6,0,0,0,16,16,0
2022,2,Hail Region,Manufacture of Other Transport Equipment,micro,1,0,0,0,3,3,0
2022,2,Aseer Region,Manufacture of Other Transport Equipment,small,1,0,0,0,10,10,0
2022,2,Aseer Region,Manufacture of Other Transport Equipment,micro,4,0,0,0,10,10,0
2022,2,Makkah Region,Manufacture of Other Transport Equipment,small,6,14,8,6,67,66,1
2022,2,Makkah Region,Manufacture of Other Transport Equipment,micro,33,10,6,4,62,61,1
2022,2,Makkah Region,Manufacture of Other Transport Equipment,medium,2,32,26,6,92,92,0
2022,2,Najran Region,Manufacture of Other Transport Equipment,small,2,1,0,1,17,17,0
2022,2,Najran Region,Manufacture of Other Transport Equipment,micro,5,0,0,0,11,9,2
2022,2,Eastern Province,"Manufacture of Motor Vehicles, Trailers, and Semi-Trailers",small,23,137,91,46,362,362,0
2022,2,Eastern Province,"Manufacture of Motor Vehicles, Trailers, and Semi-Trailers",large,2,334,331,3,462,462,0
2022,2,Eastern Province,"Manufacture of Motor Vehicles, Trailers, and Semi-Trailers",micro,38,6,2,4,87,87,0
2022,2,Eastern Province,"Manufacture of Motor Vehicles, Trailers, and Semi-Trailers",medium,12,417,349,68,940,939,1
2022,2,Al Jawf Region,"Manufacture of Motor Vehicles, Trailers, and Semi-Trailers",small,1,2,2,0,8,8,0
2022,2,Al Jawf Region,"Manufacture of Motor Vehicles, Trailers, and Semi-Trailers",micro,9,1,1,0,17,17,0
2022,2,Northern Borders Region,"Manufacture of Motor Vehicles, Trailers, and Semi-Trailers",micro,1,0,0,0,2,2,0
2022,2,Riyadh Region,"Manufacture of Motor Vehicles, Trailers, and Semi-Trailers",small,31,131,70,61,531,531,0
2022,2,Riyadh Region,"Manufacture of Motor Vehicles, Trailers, and Semi-Trailers",large,2,92,37,55,1629,1622,7
2022,2,Riyadh Region,"Manufacture of Motor Vehicles, Trailers, and Semi-Trailers",micro,61,19,10,9,126,125,1
2022,2,Riyadh Region,"Manufacture of Motor Vehicles, Trailers, and Semi-Trailers",medium,11,168,83,85,625,617,8
2022,2,Qassim Region,"Manufacture of Motor Vehicles, Trailers, and Semi-Trailers",small,4,10,6,4,48,48,0
2022,2,Qassim Region,"Manufacture of Motor Vehicles, Trailers, and Semi-Trailers",large,1,104,85,19,262,262,0
2022,2,Qassim Region,"Manufacture of Motor Vehicles, Trailers, and Semi-Trailers",micro,14,8,3,5,19,19,0
2022,2,Al Madinah Region,"Manufacture of Motor Vehicles, Trailers, and Semi-Trailers",small,1,3,3,0,16,16,0
2022,2,Al Madinah Region,"Manufacture of Motor Vehicles, Trailers, and Semi-Trailers",micro,13,1,1,0,27,27,0
2022,2,Tabuk Region,"Manufacture of Motor Vehicles, Trailers, and Semi-Trailers",micro,6,1,1,0,19,19,0
2022,2,Tabuk Region,"Manufacture of Motor Vehicles, Trailers, and Semi-Trailers",medium,1,41,21,20,179,179,0
2022,2,Jazan Region,"Manufacture of Motor Vehicles, Trailers, and Semi-Trailers",small,1,10,2,8,22,22,0
2022,2,Jazan Region,"Manufacture of Motor Vehicles, Trailers, and Semi-Trailers",micro,18,1,1,0,51,51,0
2022,2,Hail Region,"Manufacture of Motor Vehicles, Trailers, and Semi-Trailers",small,1,0,0,0,14,14,0
2022,2,Hail Region,"Manufacture of Motor Vehicles, Trailers, and Semi-Trailers",micro,9,2,2,0,23,23,0
2022,2,Aseer Region,"Manufacture of Motor Vehicles, Trailers, and Semi-Trailers",small,1,2,1,1,7,7,0
2022,2,Aseer Region,"Manufacture of Motor Vehicles, Trailers, and Semi-Trailers",micro,12,4,4,0,27,27,0
2022,2,Makkah Region,"Manufacture of Motor Vehicles, Trailers, and Semi-Trailers",small,11,46,37,9,140,140,0
2022,2,Makkah Region,"Manufacture of Motor Vehicles, Trailers, and Semi-Trailers",micro,39,7,4,3,100,100,0
2022,2,Makkah Region,"Manufacture of Motor Vehicles, Trailers, and Semi-Trailers",medium,10,379,253,126,886,886,0
2022,2,Najran Region,"Manufacture of Motor Vehicles, Trailers, and Semi-Trailers",small,1,0,0,0,7,7,0
2022,2,Najran Region,"Manufacture of Motor Vehicles, Trailers, and Semi-Trailers",micro,10,1,0,1,25,25,0
2022,2,Eastern Province,Manufacture of Other Machinery and Equipment Not Classified Elsewhere,small,67,481,396,85,908,906,2
2022,2,Eastern Province,Manufacture of Other Machinery and Equipment Not Classified Elsewhere,large,7,1484,1383,101,1993,1991,2
2022,2,Eastern Province,Manufacture of Other Machinery and Equipment Not Classified Elsewhere,micro,71,47,35,12,127,125,2
2022,2,Eastern Province,Manufacture of Other Machinery and Equipment Not Classified Elsewhere,medium,32,1422,1231,191,2269,2263,6
2022,2,Al Bahah Region,Manufacture of Other Machinery and Equipment Not Classified Elsewhere,micro,3,3,2,1,8,8,0
2022,2,Al Jawf Region,Manufacture of Other Machinery and Equipment Not Classified Elsewhere,micro,3,0,0,0,3,3,0
2022,2,Northern Borders Region,Manufacture of Other Machinery and Equipment Not Classified Elsewhere,micro,4,0,0,0,12,12,0
2022,2,Riyadh Region,Manufacture of Other Machinery and Equipment Not Classified Elsewhere,small,85,289,169,120,1325,1321,4
2022,2,Riyadh Region,Manufacture of Other Machinery and Equipment Not Classified Elsewhere,large,3,148,80,68,738,737,1
2022,2,Riyadh Region,Manufacture of Other Machinery and Equipment Not Classified Elsewhere,micro,268,63,29,34,598,596,2
2022,2,Riyadh Region,Manufacture of Other Machinery and Equipment Not Classified Elsewhere,medium,21,727,437,290,2100,2094,6
2022,2,Qassim Region,Manufacture of Other Machinery and Equipment Not Classified Elsewhere,small,4,3,2,1,21,21,0
2022,2,Qassim Region,Manufacture of Other Machinery and Equipment Not Classified Elsewhere,micro,34,4,2,2,61,61,0
2022,2,Qassim Region,Manufacture of Other Machinery and Equipment Not Classified Elsewhere,medium,3,68,34,34,217,217,0
2022,2,Al Madinah Region,Manufacture of Other Machinery and Equipment Not Classified Elsewhere,small,7,27,22,5,117,117,0
2022,2,Al Madinah Region,Manufacture of Other Machinery and Equipment Not Classified Elsewhere,micro,18,2,0,2,43,43,0
2022,2,Al Madinah Region,Manufacture of Other Machinery and Equipment Not Classified Elsewhere,medium,2,30,24,6,106,106,0
2022,2,Tabuk Region,Manufacture of Other Machinery and Equipment Not Classified Elsewhere,micro,5,0,0,0,16,16,0
2022,2,Jazan Region,Manufacture of Other Machinery and Equipment Not Classified Elsewhere,small,5,8,6,2,45,45,0
2022,2,Jazan Region,Manufacture of Other Machinery and Equipment Not Classified Elsewhere,micro,21,3,2,1,48,48,0
2022,2,Hail Region,Manufacture of Other Machinery and Equipment Not Classified Elsewhere,small,1,19,19,0,0,0,0
2022,2,Hail Region,Manufacture of Other Machinery and Equipment Not Classified Elsewhere,micro,12,3,1,2,29,29,0
2022,2,Aseer Region,Manufacture of Other Machinery and Equipment Not Classified Elsewhere,small,3,30,29,1,46,46,0
2022,2,Aseer Region,Manufacture of Other Machinery and Equipment Not Classified Elsewhere,micro,15,5,3,2,37,37,0
2022,2,Aseer Region,Manufacture of Other Machinery and Equipment Not Classified Elsewhere,medium,1,41,41,0,162,162,0
2022,2,Makkah Region,Manufacture of Other Machinery and Equipment Not Classified Elsewhere,small,39,136,69,67,580,579,1
2022,2,Makkah Region,Manufacture of Other Machinery and Equipment Not Classified Elsewhere,large,3,788,781,7,1644,1642,2
2022,2,Makkah Region,Manufacture of Other Machinery and Equipment Not Classified Elsewhere,micro,79,29,17,12,157,157,0
2022,2,Makkah Region,Manufacture of Other Machinery and Equipment Not Classified Elsewhere,medium,11,310,230,80,880,879,1
2022,2,Najran Region,Manufacture of Other Machinery and Equipment Not Classified Elsewhere,small,1,0,0,0,7,7,0
2022,2,Najran Region,Manufacture of Other Machinery and Equipment Not Classified Elsewhere,micro,9,1,1,0,20,20,0
2022,2,Najran Region,Manufacture of Other Machinery and Equipment Not Classified Elsewhere,medium,1,0,0,0,118,118,0
2022,2,Eastern Province,"Electricity, Gas, Steam, and Air Conditioning Supply",small,49,294,208,86,537,536,1
2022,2,Eastern Province,"Electricity, Gas, Steam, and Air Conditioning Supply",large,1,6347,6342,5,462,462,0
2022,2,Eastern Province,"Electricity, Gas, Steam, and Air Conditioning Supply",micro,56,23,13,10,85,85,0
2022,2,Eastern Province,"Electricity, Gas, Steam, and Air Conditioning Supply",medium,5,208,191,17,194,193,1
2022,2,Al Bahah Region,"Electricity, Gas, Steam, and Air Conditioning Supply",micro,2,2,2,0,4,4,0
2022,2,Al Jawf Region,"Electricity, Gas, Steam, and Air Conditioning Supply",small,1,0,0,0,6,6,0
2022,2,Al Jawf Region,"Electricity, Gas, Steam, and Air Conditioning Supply",micro,6,1,1,0,9,9,0
2022,2,Northern Borders Region,"Electricity, Gas, Steam, and Air Conditioning Supply",small,1,1,0,1,5,5,0
2022,2,Northern Borders Region,"Electricity, Gas, Steam, and Air Conditioning Supply",micro,2,0,0,0,3,3,0
2022,2,Riyadh Region,"Electricity, Gas, Steam, and Air Conditioning Supply",small,64,305,179,126,665,664,1
2022,2,Riyadh Region,"Electricity, Gas, Steam, and Air Conditioning Supply",large,2,11228,10980,248,1574,1572,2
2022,2,Riyadh Region,"Electricity, Gas, Steam, and Air Conditioning Supply",micro,102,62,40,22,175,175,0
2022,2,Riyadh Region,"Electricity, Gas, Steam, and Air Conditioning Supply",medium,7,533,475,58,216,215,1
2022,2,Qassim Region,"Electricity, Gas, Steam, and Air Conditioning Supply",small,3,23,20,3,76,76,0
2022,2,Qassim Region,"Electricity, Gas, Steam, and Air Conditioning Supply",micro,14,3,2,1,37,37,0
2022,2,Al Madinah Region,"Electricity, Gas, Steam, and Air Conditioning Supply",small,3,33,32,1,25,25,0
2022,2,Al Madinah Region,"Electricity, Gas, Steam, and Air Conditioning Supply",micro,16,7,6,1,41,41,0
2022,2,Tabuk Region,"Electricity, Gas, Steam, and Air Conditioning Supply",small,3,8,4,4,25,25,0
2022,2,Tabuk Region,"Electricity, Gas, Steam, and Air Conditioning Supply",micro,14,3,2,1,32,32,0
2022,2,Jazan Region,"Electricity, Gas, Steam, and Air Conditioning Supply",small,5,19,10,9,88,88,0
2022,2,Jazan Region,"Electricity, Gas, Steam, and Air Conditioning Supply",micro,15,5,4,1,29,29,0
2022,2,Hail Region,"Electricity, Gas, Steam, and Air Conditioning Supply",small,2,2,0,2,13,13,0
2022,2,Hail Region,"Electricity, Gas, Steam, and Air Conditioning Supply",micro,9,2,1,1,22,22,0
2022,2,Aseer Region,"Electricity, Gas, Steam, and Air Conditioning Supply",small,7,43,36,7,42,42,0
2022,2,Aseer Region,"Electricity, Gas, Steam, and Air Conditioning Supply",large,1,4657,4657,0,264,264,0
2022,2,Aseer Region,"Electricity, Gas, Steam, and Air Conditioning Supply",micro,19,3,3,0,36,36,0
2022,2,Aseer Region,"Electricity, Gas, Steam, and Air Conditioning Supply",medium,2,15,15,0,204,204,0
2022,2,Makkah Region,"Electricity, Gas, Steam, and Air Conditioning Supply",small,34,197,135,62,467,466,1
2022,2,Makkah Region,"Electricity, Gas, Steam, and Air Conditioning Supply",large,1,9445,9443,2,536,536,0
2022,2,Makkah Region,"Electricity, Gas, Steam, and Air Conditioning Supply",micro,59,24,14,10,104,104,0
2022,2,Makkah Region,"Electricity, Gas, Steam, and Air Conditioning Supply",medium,6,98,44,54,390,389,1
2022,2,Najran Region,"Electricity, Gas, Steam, and Air Conditioning Supply",small,2,11,6,5,27,19,8
2022,2,Najran Region,"Electricity, Gas, Steam, and Air Conditioning Supply",micro,6,1,1,0,13,13,0
2022,2,Eastern Province,"Activities of Financial Services, Except Mandatory Social Security",small,3,23,19,4,8,8,0
2022,2,Eastern Province,"Activities of Financial Services, Except Mandatory Social Security",large,2,582,419,163,160,151,9
2022,2,Eastern Province,"Activities of Financial Services, Except Mandatory Social Security",micro,1,3,1,2,1,1,0
2022,2,Eastern Province,"Activities of Financial Services, Except Mandatory Social Security",medium,2,132,89,43,47,44,3
2022,2,Al Jawf Region,"Activities of Financial Services, Except Mandatory Social Security",micro,1,2,1,1,0,0,0
2022,2,Riyadh Region,"Activities of Financial Services, Except Mandatory Social Security",small,4,78,60,18,18,17,1
2022,2,Riyadh Region,"Activities of Financial Services, Except Mandatory Social Security",large,5,2297,1369,928,660,628,32
2022,2,Riyadh Region,"Activities of Financial Services, Except Mandatory Social Security",micro,26,22,9,13,16,16,0
2022,2,Riyadh Region,"Activities of Financial Services, Except Mandatory Social Security",medium,6,633,492,141,234,232,2
2022,2,Al Madinah Region,"Activities of Financial Services, Except Mandatory Social Security",micro,2,0,0,0,3,3,0
2022,2,Jazan Region,"Activities of Financial Services, Except Mandatory Social Security",micro,1,0,0,0,4,4,0
2022,2,Aseer Region,"Activities of Financial Services, Except Mandatory Social Security",micro,2,0,0,0,3,3,0
2022,2,Aseer Region,"Activities of Financial Services, Except Mandatory Social Security",medium,1,98,96,2,21,21,0
2022,2,Makkah Region,"Activities of Financial Services, Except Mandatory Social Security",small,6,88,44,44,33,31,2
2022,2,Makkah Region,"Activities of Financial Services, Except Mandatory Social Security",large,1,1143,665,478,392,320,72
2022,2,Makkah Region,"Activities of Financial Services, Except Mandatory Social Security",micro,7,1,1,0,9,8,1
2022,2,Makkah Region,"Activities of Financial Services, Except Mandatory Social Security",medium,4,564,342,222,148,140,8
2022,2,Najran Region,"Activities of Financial Services, Except Mandatory Social Security",micro,2,1,1,0,7,7,0
2022,2,Eastern Province,Mining of Metal Ores,small,15,18,12,6,135,135,0
2022,2,Eastern Province,Mining of Metal Ores,micro,90,14,7,7,184,184,0
2022,2,Eastern Province,Mining of Metal Ores,medium,3,134,90,44,236,235,1
2022,2,Al Bahah Region,Mining of Metal Ores,micro,4,0,0,0,9,9,0
2022,2,Al Jawf Region,Mining of Metal Ores,micro,3,0,0,0,6,6,0
2022,2,Northern Borders Region,Mining of Metal Ores,micro,5,1,1,0,14,14,0
2022,2,Riyadh Region,Mining of Metal Ores,small,12,43,26,17,159,158,1
2022,2,Riyadh Region,Mining of Metal Ores,micro,31,15,8,7,58,58,0
2022,2,Riyadh Region,Mining of Metal Ores,medium,1,0,0,0,65,65,0
2022,2,Qassim Region,Mining of Metal Ores,small,1,2,2,0,5,5,0
2022,2,Qassim Region,Mining of Metal Ores,micro,16,3,3,0,44,44,0
2022,2,Qassim Region,Mining of Metal Ores,medium,1,89,89,0,0,0,0
2022,2,Al Madinah Region,Mining of Metal Ores,small,2,3,2,1,15,15,0
2022,2,Al Madinah Region,Mining of Metal Ores,micro,9,2,1,1,17,17,0
2022,2,Tabuk Region,Mining of Metal Ores,small,1,1,1,0,7,7,0
2022,2,Tabuk Region,Mining of Metal Ores,micro,1,0,0,0,1,1,0
2022,2,Jazan Region,Mining of Metal Ores,micro,11,0,0,0,36,36,0
2022,2,Hail Region,Mining of Metal Ores,micro,3,0,0,0,5,5,0
2022,2,Aseer Region,Mining of Metal Ores,small,11,23,14,9,93,93,0
2022,2,Aseer Region,Mining of Metal Ores,micro,45,4,2,2,97,96,1
2022,2,Makkah Region,Mining of Metal Ores,small,7,62,43,19,105,103,2
2022,2,Makkah Region,Mining of Metal Ores,micro,39,11,6,5,79,79,0
2022,2,Makkah Region,Mining of Metal Ores,medium,2,227,227,0,0,0,0
2022,2,Najran Region,Mining of Metal Ores,small,1,0,0,0,10,10,0
2022,2,Najran Region,Mining of Metal Ores,micro,8,0,0,0,19,19,0
2022,2,Eastern Province,Mining of Coal and Lignite,small,2,8,8,0,14,14,0
2022,2,Eastern Province,Mining of Coal and Lignite,micro,4,3,2,1,7,7,0
2022,2,Riyadh Region,Mining of Coal and Lignite,small,2,3,2,1,16,16,0
2022,2,Riyadh Region,Mining of Coal and Lignite,micro,11,5,4,1,32,32,0
2022,2,Qassim Region,Mining of Coal and Lignite,small,1,4,0,4,15,15,0
2022,2,Qassim Region,Mining of Coal and Lignite,micro,3,2,0,2,6,6,0
2022,2,Al Madinah Region,Mining of Coal and Lignite,micro,1,0,0,0,1,1,0
2022,2,Hail Region,Mining of Coal and Lignite,micro,1,0,0,0,4,4,0
2022,2,Makkah Region,Mining of Coal and Lignite,small,1,3,1,2,15,15,0
2022,2,Makkah Region,Mining of Coal and Lignite,micro,8,2,1,1,17,17,0
2022,2,Najran Region,Mining of Coal and Lignite,micro,1,0,0,0,4,4,0
2022,2,Eastern Province,Construction of Buildings,small,5144,11478,6354,5124,69658,69445,213
2022,2,Eastern Province,Construction of Buildings,large,138,22464,16712,5752,119535,118478,1057
2022,2,Eastern Province,Construction of Buildings,micro,11648,3315,1769,1546,26831,26744,87
2022,2,Eastern Province,Construction of Buildings,medium,725,10792,6894,3898,60310,60195,115
2022,2,Al Bahah Region,Construction of Buildings,small,302,517,374,143,2971,2964,7
2022,2,Al Bahah Region,Construction of Buildings,micro,1156,238,138,100,2790,2787,3
2022,2,Al Bahah Region,Construction of Buildings,medium,8,130,96,34,624,624,0
2022,2,Al Jawf Region,Construction of Buildings,small,299,458,296,162,3207,3202,5
2022,2,Al Jawf Region,Construction of Buildings,large,1,248,183,65,435,360,75
2022,2,Al Jawf Region,Construction of Buildings,micro,1454,256,188,68,3600,3594,6
2022,2,Al Jawf Region,Construction of Buildings,medium,16,234,158,76,1145,1132,13
2022,2,Northern Borders Region,Construction of Buildings,small,226,339,189,150,2378,2369,9
2022,2,Northern Borders Region,Construction of Buildings,large,3,295,137,158,1419,1388,31
2022,2,Northern Borders Region,Construction of Buildings,micro,1545,223,123,100,3988,3977,11
2022,2,Northern Borders Region,Construction of Buildings,medium,14,140,85,55,802,802,0
2022,2,Riyadh Region,Construction of Buildings,small,7659,14766,6728,8038,96873,96071,802
2022,2,Riyadh Region,Construction of Buildings,large,298,21125,12286,8839,190316,188922,1394
2022,2,Riyadh Region,Construction of Buildings,micro,22441,5621,2725,2896,50170,49789,381
2022,2,Riyadh Region,Construction of Buildings,medium,1084,14179,6874,7305,98715,98088,627
2022,2,Qassim Region,Construction of Buildings,small,1802,2366,1429,937,21343,21252,91
2022,2,Qassim Region,Construction of Buildings,large,24,308,151,157,9647,9631,16
2022,2,Qassim Region,Construction of Buildings,micro,9775,1367,755,612,23688,23616,72
2022,2,Qassim Region,Construction of Buildings,medium,175,1324,879,445,16078,16057,21
2022,2,Al Madinah Region,Construction of Buildings,small,1429,2472,1450,1022,16175,16092,83
2022,2,Al Madinah Region,Construction of Buildings,large,10,2452,1476,976,5462,5018,444
2022,2,Al Madinah Region,Construction of Buildings,micro,5539,1161,650,511,13508,13453,55
2022,2,Al Madinah Region,Construction of Buildings,medium,93,1314,823,491,6781,6761,20
2022,2,Tabuk Region,Construction of Buildings,small,396,673,412,261,3905,3892,13
2022,2,Tabuk Region,Construction of Buildings,large,1,14,9,5,262,258,4
2022,2,Tabuk Region,Construction of Buildings,micro,2713,491,257,234,6878,6870,8
2022,2,Tabuk Region,Construction of Buildings,medium,14,139,77,62,958,958,0
2022,2,Jazan Region,Construction of Buildings,small,481,853,419,434,4880,4867,13
2022,2,Jazan Region,Construction of Buildings,micro,3653,613,352,261,9291,9259,32
2022,2,Jazan Region,Construction of Buildings,medium,19,251,151,100,1428,1423,5
2022,2,Hail Region,Construction of Buildings,small,552,774,374,400,5981,5959,22
2022,2,Hail Region,Construction of Buildings,large,2,112,85,27,612,612,0
2022,2,Hail Region,Construction of Buildings,micro,3252,490,271,219,7845,7819,26
2022,2,Hail Region,Construction of Buildings,medium,37,453,300,153,3044,3040,4
2022,2,Aseer Region,Construction of Buildings,small,1451,2531,1604,927,14775,14731,44
2022,2,Aseer Region,Construction of Buildings,large,2,181,178,3,1723,1723,0
2022,2,Aseer Region,Construction of Buildings,micro,8003,1422,856,566,19341,19319,22
2022,2,Aseer Region,Construction of Buildings,medium,71,1240,839,401,5378,5297,81
2022,2,Makkah Region,Construction of Buildings,small,6058,10750,5444,5306,71693,71163,530
2022,2,Makkah Region,Construction of Buildings,large,82,11488,8636,2852,85243,84616,627
2022,2,Makkah Region,Construction of Buildings,micro,20165,4571,2309,2262,49378,48972,406
2022,2,Makkah Region,Construction of Buildings,medium,498,7787,4581,3206,40065,39732,333
2022,2,Najran Region,Construction of Buildings,small,529,729,383,346,5809,5784,25
2022,2,Najran Region,Construction of Buildings,large,12,969,701,268,3661,3643,18
2022,2,Najran Region,Construction of Buildings,micro,2911,392,215,177,7052,7013,39
2022,2,Najran Region,Construction of Buildings,medium,47,791,480,311,4338,4332,6
2022,2,Eastern Province,"Water Collection, Treatment, and Supply",small,37,181,134,47,418,418,0
2022,2,Eastern Province,"Water Collection, Treatment, and Supply",large,2,1643,1635,8,456,456,0
2022,2,Eastern Province,"Water Collection, Treatment, and Supply",micro,58,19,17,2,115,115,0
2022,2,Eastern Province,"Water Collection, Treatment, and Supply",medium,2,143,140,3,155,155,0
2022,2,Al Bahah Region,"Water Collection, Treatment, and Supply",small,2,3,3,0,12,12,0
2022,2,Al Bahah Region,"Water Collection, Treatment, and Supply",micro,19,3,0,3,39,39,0
2022,2,Al Jawf Region,"Water Collection, Treatment, and Supply",small,3,13,8,5,39,39,0
2022,2,Al Jawf Region,"Water Collection, Treatment, and Supply",micro,13,3,1,2,27,27,0
2022,2,Al Jawf Region,"Water Collection, Treatment, and Supply",medium,1,19,13,6,37,37,0
2022,2,Northern Borders Region,"Water Collection, Treatment, and Supply",small,5,7,6,1,31,31,0
2022,2,Northern Borders Region,"Water Collection, Treatment, and Supply",micro,17,2,1,1,42,42,0
2022,2,Riyadh Region,"Water Collection, Treatment, and Supply",small,57,213,127,86,649,649,0
2022,2,Riyadh Region,"Water Collection, Treatment, and Supply",large,2,85,46,39,535,535,0
2022,2,Riyadh Region,"Water Collection, Treatment, and Supply",micro,166,56,26,30,361,359,2
2022,2,Riyadh Region,"Water Collection, Treatment, and Supply",medium,10,522,366,156,629,626,3
2022,2,Qassim Region,"Water Collection, Treatment, and Supply",small,13,33,15,18,142,142,0
2022,2,Qassim Region,"Water Collection, Treatment, and Supply",micro,51,15,8,7,110,110,0
2022,2,Qassim Region,"Water Collection, Treatment, and Supply",medium,1,45,45,0,164,164,0
2022,2,Al Madinah Region,"Water Collection, Treatment, and Supply",small,7,33,27,6,83,83,0
2022,2,Al Madinah Region,"Water Collection, Treatment, and Supply",large,1,350,350,0,1,1,0
2022,2,Al Madinah Region,"Water Collection, Treatment, and Supply",micro,45,20,9,11,72,72,0
2022,2,Al Madinah Region,"Water Collection, Treatment, and Supply",medium,1,30,16,14,75,75,0
2022,2,Tabuk Region,"Water Collection, Treatment, and Supply",small,5,8,7,1,67,67,0
2022,2,Tabuk Region,"Water Collection, Treatment, and Supply",micro,42,11,6,5,86,86,0
2022,2,Tabuk Region,"Water Collection, Treatment, and Supply",medium,1,19,13,6,81,81,0
2022,2,Jazan Region,"Water Collection, Treatment, and Supply",small,8,64,58,6,51,51,0
2022,2,Jazan Region,"Water Collection, Treatment, and Supply",micro,70,13,6,7,137,137,0
2022,2,Jazan Region,"Water Collection, Treatment, and Supply",medium,1,55,53,2,26,26,0
2022,2,Hail Region,"Water Collection, Treatment, and Supply",micro,28,2,0,2,64,64,0
2022,2,Hail Region,"Water Collection, Treatment, and Supply",medium,3,63,46,17,284,284,0
2022,2,Aseer Region,"Water Collection, Treatment, and Supply",small,20,54,26,28,206,206,0
2022,2,Aseer Region,"Water Collection, Treatment, and Supply",micro,128,23,8,15,243,243,0
2022,2,Makkah Region,"Water Collection, Treatment, and Supply",small,67,261,200,61,496,495,1
2022,2,Makkah Region,"Water Collection, Treatment, and Supply",large,1,111,99,12,528,528,0
2022,2,Makkah Region,"Water Collection, Treatment, and Supply",micro,350,76,42,34,710,708,2
2022,2,Makkah Region,"Water Collection, Treatment, and Supply",medium,13,726,640,86,771,770,1
2022,2,Najran Region,"Water Collection, Treatment, and Supply",small,3,5,2,3,21,21,0
2022,2,Najran Region,"Water Collection, Treatment, and Supply",large,1,120,102,18,187,184,3
2022,2,Najran Region,"Water Collection, Treatment, and Supply",micro,26,7,3,4,49,49,0
2022,2,Najran Region,"Water Collection, Treatment, and Supply",medium,2,29,25,4,103,103,0
2022,2,Eastern Province,"Wholesale and Retail Trade, Repair of Motor Vehicles and Motorcycles",small,1704,4137,2664,1473,16356,16334,22
2022,2,Eastern Province,"Wholesale and Retail Trade, Repair of Motor Vehicles and Motorcycles",large,10,2183,1972,211,4064,4059,5
2022,2,Eastern Province,"Wholesale and Retail Trade, Repair of Motor Vehicles and Motorcycles",micro,6508,2227,1332,895,14141,14119,22
2022,2,Eastern Province,"Wholesale and Retail Trade, Repair of Motor Vehicles and Motorcycles",medium,60,1259,920,339,3627,3624,3
2022,2,Al Bahah Region,"Wholesale and Retail Trade, Repair of Motor Vehicles and Motorcycles",small,81,153,117,36,618,618,0
2022,2,Al Bahah Region,"Wholesale and Retail Trade, Repair of Motor Vehicles and Motorcycles",micro,543,125,102,23,1150,1147,3
2022,2,Al Bahah Region,"Wholesale and Retail Trade, Repair of Motor Vehicles and Motorcycles",medium,2,33,24,9,117,117,0
2022,2,Al Jawf Region,"Wholesale and Retail Trade, Repair of Motor Vehicles and Motorcycles",small,136,206,150,56,1198,1197,1
2022,2,Al Jawf Region,"Wholesale and Retail Trade, Repair of Motor Vehicles and Motorcycles",micro,897,212,173,39,1993,1992,1
2022,2,Northern Borders Region,"Wholesale and Retail Trade, Repair of Motor Vehicles and Motorcycles",small,81,119,79,40,663,660,3
2022,2,Northern Borders Region,"Wholesale and Retail Trade, Repair of Motor Vehicles and Motorcycles",micro,637,113,81,32,1455,1453,2
2022,2,Northern Borders Region,"Wholesale and Retail Trade, Repair of Motor Vehicles and Motorcycles",medium,1,16,10,6,48,48,0
2022,2,Riyadh Region,"Wholesale and Retail Trade, Repair of Motor Vehicles and Motorcycles",small,2772,7118,3597,3521,27469,27356,113
2022,2,Riyadh Region,"Wholesale and Retail Trade, Repair of Motor Vehicles and Motorcycles",large,10,1546,1296,250,4309,4304,5
2022,2,Riyadh Region,"Wholesale and Retail Trade, Repair of Motor Vehicles and Motorcycles",micro,13409,3379,1784,1595,31174,31047,127
2022,2,Riyadh Region,"Wholesale and Retail Trade, Repair of Motor Vehicles and Motorcycles",medium,129,2780,1674,1106,9445,9416,29
2022,2,Qassim Region,"Wholesale and Retail Trade, Repair of Motor Vehicles and Motorcycles",small,536,1042,722,320,5076,5053,23
2022,2,Qassim Region,"Wholesale and Retail Trade, Repair of Motor Vehicles and Motorcycles",micro,3216,671,435,236,7429,7421,8
2022,2,Qassim Region,"Wholesale and Retail Trade, Repair of Motor Vehicles and Motorcycles",medium,21,281,190,91,1371,1371,0
2022,2,Al Madinah Region,"Wholesale and Retail Trade, Repair of Motor Vehicles and Motorcycles",small,387,777,527,250,3110,3098,12
2022,2,Al Madinah Region,"Wholesale and Retail Trade, Repair of Motor Vehicles and Motorcycles",micro,3034,729,471,258,6867,6855,12
2022,2,Al Madinah Region,"Wholesale and Retail Trade, Repair of Motor Vehicles and Motorcycles",medium,10,110,89,21,542,542,0
2022,2,Tabuk Region,"Wholesale and Retail Trade, Repair of Motor Vehicles and Motorcycles",small,187,395,257,138,1584,1581,3
2022,2,Tabuk Region,"Wholesale and Retail Trade, Repair of Motor Vehicles and Motorcycles",micro,1492,325,213,112,3444,3439,5
2022,2,Tabuk Region,"Wholesale and Retail Trade, Repair of Motor Vehicles and Motorcycles",medium,2,77,69,8,206,206,0
2022,2,Jazan Region,"Wholesale and Retail Trade, Repair of Motor Vehicles and Motorcycles",small,192,412,287,125,1667,1663,4
2022,2,Jazan Region,"Wholesale and Retail Trade, Repair of Motor Vehicles and Motorcycles",large,1,0,0,0,299,299,0
2022,2,Jazan Region,"Wholesale and Retail Trade, Repair of Motor Vehicles and Motorcycles",micro,2394,401,282,119,5648,5643,5
2022,2,Jazan Region,"Wholesale and Retail Trade, Repair of Motor Vehicles and Motorcycles",medium,5,73,56,17,329,328,1
2022,2,Hail Region,"Wholesale and Retail Trade, Repair of Motor Vehicles and Motorcycles",small,217,434,255,179,1936,1934,2
2022,2,Hail Region,"Wholesale and Retail Trade, Repair of Motor Vehicles and Motorcycles",micro,1228,243,154,89,2829,2825,4
2022,2,Hail Region,"Wholesale and Retail Trade, Repair of Motor Vehicles and Motorcycles",medium,4,53,40,13,214,214,0
2022,2,Aseer Region,"Wholesale and Retail Trade, Repair of Motor Vehicles and Motorcycles",small,514,1135,753,382,4602,4598,4
2022,2,Aseer Region,"Wholesale and Retail Trade, Repair of Motor Vehicles and Motorcycles",micro,3534,811,549,262,7868,7849,19
2022,2,Aseer Region,"Wholesale and Retail Trade, Repair of Motor Vehicles and Motorcycles",medium,13,317,276,41,985,984,1
2022,2,Makkah Region,"Wholesale and Retail Trade, Repair of Motor Vehicles and Motorcycles",small,1669,3991,2485,1506,15631,15539,92
2022,2,Makkah Region,"Wholesale and Retail Trade, Repair of Motor Vehicles and Motorcycles",large,15,4864,4182,682,9509,9476,33
2022,2,Makkah Region,"Wholesale and Retail Trade, Repair of Motor Vehicles and Motorcycles",micro,10057,2521,1523,998,23019,22905,114
2022,2,Makkah Region,"Wholesale and Retail Trade, Repair of Motor Vehicles and Motorcycles",medium,66,1658,1246,412,4504,4492,12
2022,2,Najran Region,"Wholesale and Retail Trade, Repair of Motor Vehicles and Motorcycles",small,120,242,153,89,1254,1248,6
2022,2,Najran Region,"Wholesale and Retail Trade, Repair of Motor Vehicles and Motorcycles",micro,847,150,91,59,1970,1965,5
2022,2,Najran Region,"Wholesale and Retail Trade, Repair of Motor Vehicles and Motorcycles",medium,3,84,71,13,196,196,0
2022,2,Eastern Province,Wholesale Trade (Except of Motor Vehicles and Motorcycles),small,2223,8602,5008,3594,22589,22460,129
2022,2,Eastern Province,Wholesale Trade (Except of Motor Vehicles and Motorcycles),large,28,5928,4040,1888,10622,10531,91
2022,2,Eastern Province,Wholesale Trade (Except of Motor Vehicles and Motorcycles),micro,6029,3308,1862,1446,11419,11354,65
2022,2,Eastern Province,Wholesale Trade (Except of Motor Vehicles and Motorcycles),medium,190,6039,3853,2186,12552,12449,103
2022,2,Al Bahah Region,Wholesale Trade (Except of Motor Vehicles and Motorcycles),small,108,289,215,74,931,931,0
2022,2,Al Bahah Region,Wholesale Trade (Except of Motor Vehicles and Motorcycles),micro,421,200,147,53,799,796,3
2022,2,Al Bahah Region,Wholesale Trade (Except of Motor Vehicles and Motorcycles),medium,3,81,63,18,161,161,0
2022,2,Al Jawf Region,Wholesale Trade (Except of Motor Vehicles and Motorcycles),small,138,388,283,105,1309,1306,3
2022,2,Al Jawf Region,Wholesale Trade (Except of Motor Vehicles and Motorcycles),micro,575,187,133,54,1137,1130,7
2022,2,Al Jawf Region,Wholesale Trade (Except of Motor Vehicles and Motorcycles),medium,1,68,18,50,128,126,2
2022,2,Northern Borders Region,Wholesale Trade (Except of Motor Vehicles and Motorcycles),small,59,141,75,66,563,558,5
2022,2,Northern Borders Region,Wholesale Trade (Except of Motor Vehicles and Motorcycles),micro,361,118,71,47,817,817,0
2022,2,Northern Borders Region,Wholesale Trade (Except of Motor Vehicles and Motorcycles),medium,3,19,10,9,230,230,0
2022,2,Riyadh Region,Wholesale Trade (Except of Motor Vehicles and Motorcycles),small,5675,21322,9966,11356,59661,58950,711
2022,2,Riyadh Region,Wholesale Trade (Except of Motor Vehicles and Motorcycles),large,67,17668,12823,4845,23347,23142,205
2022,2,Riyadh Region,Wholesale Trade (Except of Motor Vehicles and Motorcycles),micro,15916,6833,3385,3448,31752,31288,464
2022,2,Riyadh Region,Wholesale Trade (Except of Motor Vehicles and Motorcycles),medium,497,15665,8175,7490,32206,31644,562
2022,2,Qassim Region,Wholesale Trade (Except of Motor Vehicles and Motorcycles),small,441,1415,901,514,4435,4401,34
2022,2,Qassim Region,Wholesale Trade (Except of Motor Vehicles and Motorcycles),large,3,832,292,540,762,762,0
2022,2,Qassim Region,Wholesale Trade (Except of Motor Vehicles and Motorcycles),micro,2105,757,496,261,4329,4311,18
2022,2,Qassim Region,Wholesale Trade (Except of Motor Vehicles and Motorcycles),medium,26,492,312,180,1804,1795,9
2022,2,Al Madinah Region,Wholesale Trade (Except of Motor Vehicles and Motorcycles),small,642,1951,1224,727,5938,5903,35
2022,2,Al Madinah Region,Wholesale Trade (Except of Motor Vehicles and Motorcycles),large,1,91,71,20,218,216,2
2022,2,Al Madinah Region,Wholesale Trade (Except of Motor Vehicles and Motorcycles),micro,2806,1059,664,395,5771,5727,44
2022,2,Al Madinah Region,Wholesale Trade (Except of Motor Vehicles and Motorcycles),medium,29,795,555,240,2192,2086,106
2022,2,Tabuk Region,Wholesale Trade (Except of Motor Vehicles and Motorcycles),small,156,515,298,217,1565,1558,7
2022,2,Tabuk Region,Wholesale Trade (Except of Motor Vehicles and Motorcycles),large,1,99,64,35,269,269,0
2022,2,Tabuk Region,Wholesale Trade (Except of Motor Vehicles and Motorcycles),micro,834,317,181,136,1640,1631,9
2022,2,Tabuk Region,Wholesale Trade (Except of Motor Vehicles and Motorcycles),medium,10,166,70,96,604,602,2
2022,2,Jazan Region,Wholesale Trade (Except of Motor Vehicles and Motorcycles),small,295,745,419,326,2774,2765,9
2022,2,Jazan Region,Wholesale Trade (Except of Motor Vehicles and Motorcycles),micro,1651,431,263,168,3664,3644,20
2022,2,Jazan Region,Wholesale Trade (Except of Motor Vehicles and Motorcycles),medium,10,231,131,100,832,799,33
2022,2,Hail Region,Wholesale Trade (Except of Motor Vehicles and Motorcycles),small,152,436,278,158,1466,1460,6
2022,2,Hail Region,Wholesale Trade (Except of Motor Vehicles and Motorcycles),micro,743,251,139,112,1623,1617,6
2022,2,Hail Region,Wholesale Trade (Except of Motor Vehicles and Motorcycles),medium,6,97,43,54,272,272,0
2022,2,Aseer Region,Wholesale Trade (Except of Motor Vehicles and Motorcycles),small,473,1552,1027,525,4455,4435,20
2022,2,Aseer Region,Wholesale Trade (Except of Motor Vehicles and Motorcycles),large,2,250,151,99,483,469,14
2022,2,Aseer Region,Wholesale Trade (Except of Motor Vehicles and Motorcycles),micro,2030,781,516,265,4114,4094,20
2022,2,Aseer Region,Wholesale Trade (Except of Motor Vehicles and Motorcycles),medium,28,685,433,252,1757,1751,6
2022,2,Makkah Region,Wholesale Trade (Except of Motor Vehicles and Motorcycles),small,5119,18032,8778,9254,52848,52190,658
2022,2,Makkah Region,Wholesale Trade (Except of Motor Vehicles and Motorcycles),large,60,11089,7510,3579,19371,19113,258
2022,2,Makkah Region,Wholesale Trade (Except of Motor Vehicles and Motorcycles),micro,14043,5518,2817,2701,29092,28574,518
2022,2,Makkah Region,Wholesale Trade (Except of Motor Vehicles and Motorcycles),medium,378,11896,6518,5378,24379,24114,265
2022,2,Najran Region,Wholesale Trade (Except of Motor Vehicles and Motorcycles),small,118,349,223,126,1132,1128,4
2022,2,Najran Region,Wholesale Trade (Except of Motor Vehicles and Motorcycles),micro,580,178,108,70,1339,1329,10
2022,2,Najran Region,Wholesale Trade (Except of Motor Vehicles and Motorcycles),medium,6,191,99,92,398,398,0
2022,2,Eastern Province,Retail Trade (Except of Motor Vehicles and Motorcycles),small,3145,10624,5548,5076,29333,29123,210
2022,2,Eastern Province,Retail Trade (Except of Motor Vehicles and Motorcycles),large,34,8339,4203,4136,14277,13505,772
2022,2,Eastern Province,Retail Trade (Except of Motor Vehicles and Motorcycles),micro,15183,6914,3626,3288,28774,28620,154
2022,2,Eastern Province,Retail Trade (Except of Motor Vehicles and Motorcycles),medium,238,7533,3833,3700,16042,15738,304
2022,2,Al Bahah Region,Retail Trade (Except of Motor Vehicles and Motorcycles),small,235,650,444,206,1945,1939,6
2022,2,Al Bahah Region,Retail Trade (Except of Motor Vehicles and Motorcycles),micro,1334,572,381,191,2393,2376,17
2022,2,Al Bahah Region,Retail Trade (Except of Motor Vehicles and Motorcycles),medium,6,99,83,16,262,262,0
2022,2,Al Jawf Region,Retail Trade (Except of Motor Vehicles and Motorcycles),small,299,708,481,227,2408,2395,13
2022,2,Al Jawf Region,Retail Trade (Except of Motor Vehicles and Motorcycles),micro,2209,706,463,243,4145,4125,20
2022,2,Al Jawf Region,Retail Trade (Except of Motor Vehicles and Motorcycles),medium,8,199,55,144,482,481,1
2022,2,Northern Borders Region,Retail Trade (Except of Motor Vehicles and Motorcycles),small,167,384,216,168,1345,1328,17
2022,2,Northern Borders Region,Retail Trade (Except of Motor Vehicles and Motorcycles),micro,1668,448,260,188,3347,3332,15
2022,2,Northern Borders Region,Retail Trade (Except of Motor Vehicles and Motorcycles),medium,8,130,94,36,485,465,20
2022,2,Riyadh Region,Retail Trade (Except of Motor Vehicles and Motorcycles),small,6741,24628,11321,13307,67933,67019,914
2022,2,Riyadh Region,Retail Trade (Except of Motor Vehicles and Motorcycles),large,132,46433,25668,20765,80605,79699,906
2022,2,Riyadh Region,Retail Trade (Except of Motor Vehicles and Motorcycles),micro,30762,11735,5866,5869,62006,61239,767
2022,2,Riyadh Region,Retail Trade (Except of Motor Vehicles and Motorcycles),medium,645,18022,8448,9574,44739,43993,746
2022,2,Qassim Region,Retail Trade (Except of Motor Vehicles and Motorcycles),small,1055,3241,2104,1137,10060,9987,73
2022,2,Qassim Region,Retail Trade (Except of Motor Vehicles and Motorcycles),large,2,290,41,249,408,408,0
2022,2,Qassim Region,Retail Trade (Except of Motor Vehicles and Motorcycles),micro,5709,2068,1366,702,11234,11169,65
2022,2,Qassim Region,Retail Trade (Except of Motor Vehicles and Motorcycles),medium,72,1430,973,457,5361,5357,4
2022,2,Al Madinah Region,Retail Trade (Except of Motor Vehicles and Motorcycles),small,1314,3685,2246,1439,11331,11261,70
2022,2,Al Madinah Region,Retail Trade (Except of Motor Vehicles and Motorcycles),large,4,382,156,226,1200,1174,26
2022,2,Al Madinah Region,Retail Trade (Except of Motor Vehicles and Motorcycles),micro,8876,2917,1859,1058,17927,17761,166
2022,2,Al Madinah Region,Retail Trade (Except of Motor Vehicles and Motorcycles),medium,59,1508,698,810,3329,3290,39
2022,2,Tabuk Region,Retail Trade (Except of Motor Vehicles and Motorcycles),small,391,1122,604,518,3076,3054,22
2022,2,Tabuk Region,Retail Trade (Except of Motor Vehicles and Motorcycles),large,1,116,94,22,136,136,0
2022,2,Tabuk Region,Retail Trade (Except of Motor Vehicles and Motorcycles),micro,3380,1121,677,444,6536,6514,22
2022,2,Tabuk Region,Retail Trade (Except of Motor Vehicles and Motorcycles),medium,8,336,101,235,679,649,30
2022,2,Jazan Region,Retail Trade (Except of Motor Vehicles and Motorcycles),small,727,2008,1062,946,6376,6313,63
2022,2,Jazan Region,Retail Trade (Except of Motor Vehicles and Motorcycles),large,1,130,118,12,250,250,0
2022,2,Jazan Region,Retail Trade (Except of Motor Vehicles and Motorcycles),micro,6228,1755,1057,698,12793,12714,79
2022,2,Jazan Region,Retail Trade (Except of Motor Vehicles and Motorcycles),medium,21,606,253,353,1485,1457,28
2022,2,Hail Region,Retail Trade (Except of Motor Vehicles and Motorcycles),small,405,1062,570,492,3672,3638,34
2022,2,Hail Region,Retail Trade (Except of Motor Vehicles and Motorcycles),large,2,360,149,211,473,473,0
2022,2,Hail Region,Retail Trade (Except of Motor Vehicles and Motorcycles),micro,2914,961,539,422,5812,5774,38
2022,2,Hail Region,Retail Trade (Except of Motor Vehicles and Motorcycles),medium,14,334,114,220,765,735,30
2022,2,Aseer Region,Retail Trade (Except of Motor Vehicles and Motorcycles),small,1123,3286,1874,1412,9879,9819,60
2022,2,Aseer Region,Retail Trade (Except of Motor Vehicles and Motorcycles),large,3,882,236,646,839,835,4
2022,2,Aseer Region,Retail Trade (Except of Motor Vehicles and Motorcycles),micro,7860,2870,1836,1034,15049,14974,75
2022,2,Aseer Region,Retail Trade (Except of Motor Vehicles and Motorcycles),medium,40,978,471,507,2284,2213,71
2022,2,Makkah Region,Retail Trade (Except of Motor Vehicles and Motorcycles),small,5838,19281,9319,9962,56807,55982,825
2022,2,Makkah Region,Retail Trade (Except of Motor Vehicles and Motorcycles),large,62,19313,9805,9508,24483,23844,639
2022,2,Makkah Region,Retail Trade (Except of Motor Vehicles and Motorcycles),micro,29471,10302,5587,4715,60391,59488,903
2022,2,Makkah Region,Retail Trade (Except of Motor Vehicles and Motorcycles),medium,387,13303,6575,6728,25034,24541,493
2022,2,Najran Region,Retail Trade (Except of Motor Vehicles and Motorcycles),small,357,935,469,466,3365,3331,34
2022,2,Najran Region,Retail Trade (Except of Motor Vehicles and Motorcycles),micro,2397,667,379,288,5007,4979,28
2022,2,Najran Region,Retail Trade (Except of Motor Vehicles and Motorcycles),medium,17,326,141,185,1186,1180,6
2022,2,Eastern Province,"Crop and Animal Production, Hunting and Related Services",small,264,500,307,193,3065,3061,4
2022,2,Eastern Province,"Crop and Animal Production, Hunting and Related Services",large,4,2887,2755,132,2500,2500,0
2022,2,Eastern Province,"Crop and Animal Production, Hunting and Related Services",micro,1866,240,137,103,2689,2683,6
2022,2,Eastern Province,"Crop and Animal Production, Hunting and Related Services",medium,15,214,129,85,1049,1048,1
2022,2,Al Bahah Region,"Crop and Animal Production, Hunting and Related Services",small,4,7,3,4,35,35,0
2022,2,Al Bahah Region,"Crop and Animal Production, Hunting and Related Services",micro,132,6,5,1,175,175,0
2022,2,Al Jawf Region,"Crop and Animal Production, Hunting and Related Services",small,32,42,34,8,380,373,7
2022,2,Al Jawf Region,"Crop and Animal Production, Hunting and Related Services",large,1,131,124,7,841,838,3
2022,2,Al Jawf Region,"Crop and Animal Production, Hunting and Related Services",micro,604,37,29,8,845,840,5
2022,2,Al Jawf Region,"Crop and Animal Production, Hunting and Related Services",medium,1,9,4,5,111,111,0
2022,2,Northern Borders Region,"Crop and Animal Production, Hunting and Related Services",small,4,3,1,2,39,39,0
2022,2,Northern Borders Region,"Crop and Animal Production, Hunting and Related Services",micro,87,3,3,0,125,125,0
2022,2,Riyadh Region,"Crop and Animal Production, Hunting and Related Services",small,520,857,416,441,6701,6674,27
2022,2,Riyadh Region,"Crop and Animal Production, Hunting and Related Services",large,17,7440,6904,536,28685,28663,22
2022,2,Riyadh Region,"Crop and Animal Production, Hunting and Related Services",micro,6591,548,266,282,12591,12521,70
2022,2,Riyadh Region,"Crop and Animal Production, Hunting and Related Services",medium,78,835,458,377,6949,6944,5
2022,2,Qassim Region,"Crop and Animal Production, Hunting and Related Services",small,111,202,116,86,1401,1394,7
2022,2,Qassim Region,"Crop and Animal Production, Hunting and Related Services",large,4,1566,1136,430,5095,5094,1
2022,2,Qassim Region,"Crop and Animal Production, Hunting and Related Services",micro,999,147,95,52,1674,1666,8
2022,2,Qassim Region,"Crop and Animal Production, Hunting and Related Services",medium,15,178,106,72,1154,1150,4
2022,2,Al Madinah Region,"Crop and Animal Production, Hunting and Related Services",small,63,118,70,48,702,700,2
2022,2,Al Madinah Region,"Crop and Animal Production, Hunting and Related Services",micro,713,66,42,24,1003,996,7
2022,2,Al Madinah Region,"Crop and Animal Production, Hunting and Related Services",medium,4,80,55,25,318,317,1
2022,2,Tabuk Region,"Crop and Animal Production, Hunting and Related Services",small,38,63,25,38,458,458,0
2022,2,Tabuk Region,"Crop and Animal Production, Hunting and Related Services",large,2,270,173,97,1332,1331,1
2022,2,Tabuk Region,"Crop and Animal Production, Hunting and Related Services",micro,775,64,40,24,1077,1075,2
2022,2,Tabuk Region,"Crop and Animal Production, Hunting and Related Services",medium,4,120,56,64,166,165,1
2022,2,Jazan Region,"Crop and Animal Production, Hunting and Related Services",small,34,32,18,14,312,310,2
2022,2,Jazan Region,"Crop and Animal Production, Hunting and Related Services",micro,518,28,21,7,849,844,5
2022,2,Jazan Region,"Crop and Animal Production, Hunting and Related Services",medium,3,20,9,11,197,196,1
2022,2,Hail Region,"Crop and Animal Production, Hunting and Related Services",small,67,49,22,27,665,663,2
2022,2,Hail Region,"Crop and Animal Production, Hunting and Related Services",large,1,477,420,57,2222,2221,1
2022,2,Hail Region,"Crop and Animal Production, Hunting and Related Services",micro,1285,76,47,29,2616,2610,6
2022,2,Hail Region,"Crop and Animal Production, Hunting and Related Services",medium,6,86,76,10,460,458,2
2022,2,Aseer Region,"Crop and Animal Production, Hunting and Related Services",small,50,92,64,28,585,583,2
2022,2,Aseer Region,"Crop and Animal Production, Hunting and Related Services",micro,845,62,34,28,1158,1154,4
2022,2,Aseer Region,"Crop and Animal Production, Hunting and Related Services",medium,5,30,19,11,461,461,0
2022,2,Makkah Region,"Crop and Animal Production, Hunting and Related Services",small,105,146,79,67,1115,1109,6
2022,2,Makkah Region,"Crop and Animal Production, Hunting and Related Services",large,2,592,408,184,2960,2959,1
2022,2,Makkah Region,"Crop and Animal Production, Hunting and Related Services",micro,1580,114,63,51,2356,2338,18
2022,2,Makkah Region,"Crop and Animal Production, Hunting and Related Services",medium,10,220,133,87,841,764,77
2022,2,Najran Region,"Crop and Animal Production, Hunting and Related Services",small,23,22,17,5,216,215,1
2022,2,Najran Region,"Crop and Animal Production, Hunting and Related Services",micro,491,22,15,7,798,796,2
2022,2,Najran Region,"Crop and Animal Production, Hunting and Related Services",medium,1,4,4,0,140,140,0
2022,2,Eastern Province,Support Services to Mining,small,58,444,363,81,535,528,7
2022,2,Eastern Province,Support Services to Mining,large,26,25539,24483,1056,10562,10550,12
2022,2,Eastern Province,Support Services to Mining,micro,71,69,55,14,96,95,1
2022,2,Eastern Province,Support Services to Mining,medium,25,1376,1212,164,1300,1295,5
2022,2,Al Bahah Region,Support Services to Mining,micro,3,0,0,0,7,7,0
2022,2,Al Jawf Region,Support Services to Mining,micro,5,0,0,0,13,13,0
2022,2,Northern Borders Region,Support Services to Mining,small,1,2,1,1,17,17,0
2022,2,Riyadh Region,Support Services to Mining,small,14,86,67,19,110,110,0
2022,2,Riyadh Region,Support Services to Mining,large,1,510,423,87,93,93,0
2022,2,Riyadh Region,Support Services to Mining,micro,41,56,43,13,32,31,1
2022,2,Riyadh Region,Support Services to Mining,medium,3,119,93,26,103,100,3
2022,2,Qassim Region,Support Services to Mining,small,1,1,1,0,6,6,0
2022,2,Qassim Region,Support Services to Mining,micro,2,2,1,1,8,8,0
2022,2,Al Madinah Region,Support Services to Mining,small,4,22,10,12,43,43,0
2022,2,Al Madinah Region,Support Services to Mining,micro,6,1,0,1,11,11,0
2022,2,Tabuk Region,Support Services to Mining,small,1,3,2,1,19,19,0
2022,2,Tabuk Region,Support Services to Mining,micro,1,0,0,0,4,4,0
2022,2,Jazan Region,Support Services to Mining,small,1,0,0,0,22,22,0
2022,2,Jazan Region,Support Services to Mining,micro,5,1,1,0,14,14,0
2022,2,Hail Region,Support Services to Mining,small,2,0,0,0,17,17,0
2022,2,Hail Region,Support Services to Mining,micro,4,0,0,0,10,10,0
2022,2,Aseer Region,Support Services to Mining,small,2,12,11,1,26,26,0
2022,2,Aseer Region,Support Services to Mining,micro,14,3,2,1,33,33,0
2022,2,Makkah Region,Support Services to Mining,small,9,37,28,9,81,80,1
2022,2,Makkah Region,Support Services to Mining,large,2,315,183,132,605,601,4
2022,2,Makkah Region,Support Services to Mining,micro,30,11,8,3,56,55,1
2022,2,Makkah Region,Support Services to Mining,medium,3,82,74,8,352,352,0
2022,2,Najran Region,Support Services to Mining,micro,1,1,1,0,0,0,0
2022,2,Eastern Province,Information Service Activities,small,14,71,45,26,95,94,1
2022,2,Eastern Province,Information Service Activities,large,1,342,230,112,26,24,2
2022,2,Eastern Province,Information Service Activities,micro,50,49,22,27,62,61,1
2022,2,Eastern Province,Information Service Activities,medium,5,287,116,171,137,133,4
2022,2,Al Bahah Region,Information Service Activities,small,1,19,13,6,7,7,0
2022,2,Al Jawf Region,Information Service Activities,small,3,2,1,1,19,19,0
2022,2,Al Jawf Region,Information Service Activities,micro,5,3,2,1,7,7,0
2022,2,Northern Borders Region,Information Service Activities,micro,2,1,1,0,5,5,0
2022,2,Riyadh Region,Information Service Activities,small,175,1281,648,633,1502,1451,51
2022,2,Riyadh Region,Information Service Activities,large,10,8555,5277,3278,3160,3064,96
2022,2,Riyadh Region,Information Service Activities,micro,312,306,169,137,404,382,22
2022,2,Riyadh Region,Information Service Activities,medium,39,2389,1299,1090,1990,1926,64
2022,2,Qassim Region,Information Service Activities,small,1,4,3,1,17,17,0
2022,2,Qassim Region,Information Service Activities,micro,8,6,1,5,11,11,0
2022,2,Al Madinah Region,Information Service Activities,small,4,4,0,4,22,22,0
2022,2,Al Madinah Region,Information Service Activities,micro,15,9,4,5,30,29,1
2022,2,Al Madinah Region,Information Service Activities,medium,1,60,18,42,3,2,1
2022,2,Tabuk Region,Information Service Activities,small,1,1,1,0,5,5,0
2022,2,Tabuk Region,Information Service Activities,micro,6,3,1,2,7,7,0
2022,2,Jazan Region,Information Service Activities,micro,7,2,1,1,18,18,0
2022,2,Hail Region,Information Service Activities,small,1,10,10,0,6,6,0
2022,2,Hail Region,Information Service Activities,micro,4,1,0,1,11,11,0
2022,2,Aseer Region,Information Service Activities,micro,8,7,5,2,13,13,0
2022,2,Makkah Region,Information Service Activities,small,41,243,113,130,348,336,12
2022,2,Makkah Region,Information Service Activities,micro,118,79,36,43,177,172,5
2022,2,Makkah Region,Information Service Activities,medium,2,181,55,126,93,83,10
2022,2,Najran Region,Information Service Activities,micro,1,0,0,0,1,1,0
2022,2,Eastern Province,Food and Beverage Service Activities,small,3094,8638,4226,4412,32271,32141,130
2022,2,Eastern Province,Food and Beverage Service Activities,large,26,4153,2825,1328,10466,10403,63
2022,2,Eastern Province,Food and Beverage Service Activities,micro,8664,3503,1673,1830,17953,17868,85
2022,2,Eastern Province,Food and Beverage Service Activities,medium,202,4596,2046,2550,15360,15324,36
2022,2,Al Bahah Region,Food and Beverage Service Activities,small,181,434,336,98,1845,1843,2
2022,2,Al Bahah Region,Food and Beverage Service Activities,micro,771,290,198,92,1576,1567,9
2022,2,Al Bahah Region,Food and Beverage Service Activities,medium,4,83,55,28,309,308,1
2022,2,Al Jawf Region,Food and Beverage Service Activities,small,208,483,338,145,1936,1935,1
2022,2,Al Jawf Region,Food and Beverage Service Activities,micro,1094,293,198,95,2373,2358,15
2022,2,Al Jawf Region,Food and Beverage Service Activities,medium,5,77,52,25,273,273,0
2022,2,Northern Borders Region,Food and Beverage Service Activities,small,144,279,162,117,1430,1426,4
2022,2,Northern Borders Region,Food and Beverage Service Activities,micro,1027,210,125,85,2568,2560,8
2022,2,Northern Borders Region,Food and Beverage Service Activities,medium,3,52,19,33,177,171,6
2022,2,Riyadh Region,Food and Beverage Service Activities,small,4166,12806,5387,7419,46237,45815,422
2022,2,Riyadh Region,Food and Beverage Service Activities,large,75,15687,10600,5087,43052,42592,460
2022,2,Riyadh Region,Food and Beverage Service Activities,micro,12986,4377,1962,2415,28033,27796,237
2022,2,Riyadh Region,Food and Beverage Service Activities,medium,450,10530,4366,6164,32063,31658,405
2022,2,Qassim Region,Food and Beverage Service Activities,small,926,1995,1240,755,9000,8979,21
2022,2,Qassim Region,Food and Beverage Service Activities,large,3,160,85,75,772,772,0
2022,2,Qassim Region,Food and Beverage Service Activities,micro,3803,984,591,393,9182,9151,31
2022,2,Qassim Region,Food and Beverage Service Activities,medium,49,834,498,336,3234,3226,8
2022,2,Al Madinah Region,Food and Beverage Service Activities,small,1061,2657,1482,1175,10376,10320,56
2022,2,Al Madinah Region,Food and Beverage Service Activities,large,2,213,182,31,445,444,1
2022,2,Al Madinah Region,Food and Beverage Service Activities,micro,4868,1490,903,587,10331,10250,81
2022,2,Al Madinah Region,Food and Beverage Service Activities,medium,41,681,416,265,2792,2781,11
2022,2,Tabuk Region,Food and Beverage Service Activities,small,410,957,466,491,4125,4119,6
2022,2,Tabuk Region,Food and Beverage Service Activities,large,1,112,31,81,319,274,45
2022,2,Tabuk Region,Food and Beverage Service Activities,micro,2195,558,306,252,4833,4816,17
2022,2,Tabuk Region,Food and Beverage Service Activities,medium,18,300,122,178,1289,1286,3
2022,2,Jazan Region,Food and Beverage Service Activities,small,633,1462,753,709,6082,6066,16
2022,2,Jazan Region,Food and Beverage Service Activities,micro,3956,893,514,379,8804,8780,24
2022,2,Jazan Region,Food and Beverage Service Activities,medium,16,281,168,113,901,901,0
2022,2,Hail Region,Food and Beverage Service Activities,small,304,629,391,238,3032,3013,19
2022,2,Hail Region,Food and Beverage Service Activities,large,2,174,77,97,505,500,5
2022,2,Hail Region,Food and Beverage Service Activities,micro,1909,411,234,177,4412,4397,15
2022,2,Hail Region,Food and Beverage Service Activities,medium,15,258,172,86,910,909,1
2022,2,Aseer Region,Food and Beverage Service Activities,small,1134,2552,1495,1057,10938,10903,35
2022,2,Aseer Region,Food and Beverage Service Activities,large,3,170,124,46,645,644,1
2022,2,Aseer Region,Food and Beverage Service Activities,micro,5508,1658,931,727,12100,12053,47
2022,2,Aseer Region,Food and Beverage Service Activities,medium,56,1090,691,399,3833,3831,2
2022,2,Makkah Region,Food and Beverage Service Activities,small,3791,10563,5016,5547,40868,40435,433
2022,2,Makkah Region,Food and Beverage Service Activities,large,32,7850,5476,2374,19780,19560,220
2022,2,Makkah Region,Food and Beverage Service Activities,micro,15391,4864,2441,2423,31963,31558,405
2022,2,Makkah Region,Food and Beverage Service Activities,medium,310,6173,3104,3069,20770,20484,286
2022,2,Najran Region,Food and Beverage Service Activities,small,248,536,247,289,2579,2574,5
2022,2,Najran Region,Food and Beverage Service Activities,large,2,232,130,102,693,688,5
2022,2,Najran Region,Food and Beverage Service Activities,micro,1484,315,142,173,3405,3386,19
2022,2,Najran Region,Food and Beverage Service Activities,medium,11,182,94,88,840,837,3
2022,2,Eastern Province,"Waste Collection, Treatment, and Disposal, Materials Recovery",small,38,130,64,66,547,546,1
2022,2,Eastern Province,"Waste Collection, Treatment, and Disposal, Materials Recovery",large,3,1074,710,364,6621,5104,1517
2022,2,Eastern Province,"Waste Collection, Treatment, and Disposal, Materials Recovery",micro,39,36,24,12,60,60,0
2022,2,Eastern Province,"Waste Collection, Treatment, and Disposal, Materials Recovery",medium,11,294,225,69,1197,1191,6
2022,2,Al Bahah Region,"Waste Collection, Treatment, and Disposal, Materials Recovery",micro,2,0,0,0,3,3,0
2022,2,Al Jawf Region,"Waste Collection, Treatment, and Disposal, Materials Recovery",small,1,2,1,1,17,17,0
2022,2,Al Jawf Region,"Waste Collection, Treatment, and Disposal, Materials Recovery",micro,3,2,0,2,4,4,0
2022,2,Riyadh Region,"Waste Collection, Treatment, and Disposal, Materials Recovery",small,39,115,50,65,518,514,4
2022,2,Riyadh Region,"Waste Collection, Treatment, and Disposal, Materials Recovery",large,12,5690,3129,2561,33438,31488,1950
2022,2,Riyadh Region,"Waste Collection, Treatment, and Disposal, Materials Recovery",micro,77,43,24,19,171,167,4
2022,2,Riyadh Region,"Waste Collection, Treatment, and Disposal, Materials Recovery",medium,12,232,169,63,1061,1059,2
2022,2,Qassim Region,"Waste Collection, Treatment, and Disposal, Materials Recovery",small,7,46,21,25,109,109,0
2022,2,Qassim Region,"Waste Collection, Treatment, and Disposal, Materials Recovery",micro,11,4,2,2,23,23,0
2022,2,Qassim Region,"Waste Collection, Treatment, and Disposal, Materials Recovery",medium,1,10,9,1,50,50,0
2022,2,Al Madinah Region,"Waste Collection, Treatment, and Disposal, Materials Recovery",small,3,10,5,5,27,27,0
2022,2,Al Madinah Region,"Waste Collection, Treatment, and Disposal, Materials Recovery",large,2,137,59,78,992,991,1
2022,2,Al Madinah Region,"Waste Collection, Treatment, and Disposal, Materials Recovery",micro,8,4,0,4,18,17,1
2022,2,Al Madinah Region,"Waste Collection, Treatment, and Disposal, Materials Recovery",medium,3,82,60,22,278,277,1
2022,2,Tabuk Region,"Waste Collection, Treatment, and Disposal, Materials Recovery",micro,3,2,1,1,3,3,0
2022,2,Jazan Region,"Waste Collection, Treatment, and Disposal, Materials Recovery",small,4,37,23,14,67,67,0
2022,2,Jazan Region,"Waste Collection, Treatment, and Disposal, Materials Recovery",micro,4,0,0,0,8,8,0
2022,2,Hail Region,"Waste Collection, Treatment, and Disposal, Materials Recovery",small,1,2,1,1,8,7,1
2022,2,Hail Region,"Waste Collection, Treatment, and Disposal, Materials Recovery",micro,6,2,2,0,12,12,0
2022,2,Aseer Region,"Waste Collection, Treatment, and Disposal, Materials Recovery",small,2,2,1,1,11,11,0
2022,2,Aseer Region,"Waste Collection, Treatment, and Disposal, Materials Recovery",micro,10,2,2,0,21,21,0
2022,2,Aseer Region,"Waste Collection, Treatment, and Disposal, Materials Recovery",medium,3,214,143,71,296,296,0
2022,2,Makkah Region,"Waste Collection, Treatment, and Disposal, Materials Recovery",small,39,145,76,69,511,501,10
2022,2,Makkah Region,"Waste Collection, Treatment, and Disposal, Materials Recovery",large,4,1686,732,954,7754,7698,56
2022,2,Makkah Region,"Waste Collection, Treatment, and Disposal, Materials Recovery",micro,67,40,21,19,114,112,2
2022,2,Makkah Region,"Waste Collection, Treatment, and Disposal, Materials Recovery",medium,1,10,10,0,40,40,0
2022,2,Najran Region,"Waste Collection, Treatment, and Disposal, Materials Recovery",small,4,5,3,2,28,28,0
2022,2,Najran Region,"Waste Collection, Treatment, and Disposal, Materials Recovery",micro,9,2,1,1,25,25,0
2022,2,Eastern Province,Services to Buildings and Landscape Activities,small,536,1841,1059,782,6756,6684,72
2022,2,Eastern Province,Services to Buildings and Landscape Activities,large,62,12982,9139,3843,43717,42589,1128
2022,2,Eastern Province,Services to Buildings and Landscape Activities,micro,1270,441,218,223,2668,2652,16
2022,2,Eastern Province,Services to Buildings and Landscape Activities,medium,142,3271,2166,1105,12258,12069,189
2022,2,Al Bahah Region,Services to Buildings and Landscape Activities,small,10,35,30,5,115,115,0
2022,2,Al Bahah Region,Services to Buildings and Landscape Activities,micro,54,15,9,6,106,106,0
2022,2,Al Bahah Region,Services to Buildings and Landscape Activities,medium,2,44,34,10,95,94,1
2022,2,Al Jawf Region,Services to Buildings and Landscape Activities,small,36,64,46,18,342,341,1
2022,2,Al Jawf Region,Services to Buildings and Landscape Activities,micro,206,36,21,15,473,471,2
2022,2,Al Jawf Region,Services to Buildings and Landscape Activities,medium,6,107,35,72,256,256,0
2022,2,Northern Borders Region,Services to Buildings and Landscape Activities,small,11,35,11,24,100,100,0
2022,2,Northern Borders Region,Services to Buildings and Landscape Activities,large,1,210,110,100,539,519,20
2022,2,Northern Borders Region,Services to Buildings and Landscape Activities,micro,85,12,7,5,203,203,0
2022,2,Northern Borders Region,Services to Buildings and Landscape Activities,medium,2,63,49,14,164,164,0
2022,2,Riyadh Region,Services to Buildings and Landscape Activities,small,1420,4042,1976,2066,19338,19014,324
2022,2,Riyadh Region,Services to Buildings and Landscape Activities,large,158,35529,21323,14206,163084,151931,11153
2022,2,Riyadh Region,Services to Buildings and Landscape Activities,micro,3775,1173,574,599,8094,8006,88
2022,2,Riyadh Region,Services to Buildings and Landscape Activities,medium,444,8836,4543,4293,40163,39317,846
2022,2,Qassim Region,Services to Buildings and Landscape Activities,small,209,389,200,189,3402,3387,15
2022,2,Qassim Region,Services to Buildings and Landscape Activities,large,28,1727,773,954,11427,11089,338
2022,2,Qassim Region,Services to Buildings and Landscape Activities,micro,1093,200,111,89,2717,2702,15
2022,2,Qassim Region,Services to Buildings and Landscape Activities,medium,124,1530,853,677,14237,14094,143
2022,2,Al Madinah Region,Services to Buildings and Landscape Activities,small,170,449,283,166,1943,1922,21
2022,2,Al Madinah Region,Services to Buildings and Landscape Activities,large,3,123,60,63,1099,1081,18
2022,2,Al Madinah Region,Services to Buildings and Landscape Activities,micro,722,154,97,57,1626,1609,17
2022,2,Al Madinah Region,Services to Buildings and Landscape Activities,medium,26,659,523,136,1876,1872,4
2022,2,Tabuk Region,Services to Buildings and Landscape Activities,small,40,131,59,72,371,371,0
2022,2,Tabuk Region,Services to Buildings and Landscape Activities,large,2,1618,1551,67,1607,1556,51
2022,2,Tabuk Region,Services to Buildings and Landscape Activities,micro,288,61,33,28,696,693,3
2022,2,Tabuk Region,Services to Buildings and Landscape Activities,medium,9,169,56,113,794,793,1
2022,2,Jazan Region,Services to Buildings and Landscape Activities,small,42,130,61,69,438,426,12
2022,2,Jazan Region,Services to Buildings and Landscape Activities,micro,316,57,33,24,814,812,2
2022,2,Jazan Region,Services to Buildings and Landscape Activities,medium,4,84,40,44,496,483,13
2022,2,Hail Region,Services to Buildings and Landscape Activities,small,44,106,52,54,540,534,6
2022,2,Hail Region,Services to Buildings and Landscape Activities,large,2,807,549,258,1278,1183,95
2022,2,Hail Region,Services to Buildings and Landscape Activities,micro,308,60,31,29,712,710,2
2022,2,Hail Region,Services to Buildings and Landscape Activities,medium,13,229,130,99,988,962,26
2022,2,Aseer Region,Services to Buildings and Landscape Activities,small,81,252,159,93,979,952,27
2022,2,Aseer Region,Services to Buildings and Landscape Activities,large,5,1670,1363,307,4717,4662,55
2022,2,Aseer Region,Services to Buildings and Landscape Activities,micro,496,106,58,48,1188,1182,6
2022,2,Aseer Region,Services to Buildings and Landscape Activities,medium,12,215,140,75,1115,1109,6
2022,2,Makkah Region,Services to Buildings and Landscape Activities,small,916,2767,1417,1350,11879,11631,248
2022,2,Makkah Region,Services to Buildings and Landscape Activities,large,48,7503,5093,2410,33096,32173,923
2022,2,Makkah Region,Services to Buildings and Landscape Activities,micro,2800,870,471,399,6543,6440,103
2022,2,Makkah Region,Services to Buildings and Landscape Activities,medium,214,5318,2869,2449,18455,17901,554
2022,2,Najran Region,Services to Buildings and Landscape Activities,small,47,103,63,40,762,760,2
2022,2,Najran Region,Services to Buildings and Landscape Activities,large,8,1602,1070,532,8054,7996,58
2022,2,Najran Region,Services to Buildings and Landscape Activities,micro,193,41,23,18,425,414,11
2022,2,Najran Region,Services to Buildings and Landscape Activities,medium,16,401,316,85,1189,1162,27
2022,2,Eastern Province,Publishing Activities,small,26,118,71,47,204,202,2
2022,2,Eastern Province,Publishing Activities,micro,66,43,20,23,119,117,2
2022,2,Eastern Province,Publishing Activities,medium,2,120,104,16,139,139,0
2022,2,Al Bahah Region,Publishing Activities,small,1,4,3,1,13,13,0
2022,2,Al Bahah Region,Publishing Activities,micro,6,3,3,0,13,13,0
2022,2,Al Jawf Region,Publishing Activities,micro,2,0,0,0,3,3,0
2022,2,Northern Borders Region,Publishing Activities,micro,3,1,0,1,3,3,0
2022,2,Riyadh Region,Publishing Activities,small,52,341,159,182,447,441,6
2022,2,Riyadh Region,Publishing Activities,large,3,650,247,403,1289,1268,21
2022,2,Riyadh Region,Publishing Activities,micro,166,123,58,65,228,227,1
2022,2,Riyadh Region,Publishing Activities,medium,12,483,272,211,669,651,18
2022,2,Qassim Region,Publishing Activities,small,2,3,2,1,17,17,0
2022,2,Qassim Region,Publishing Activities,micro,5,0,0,0,10,10,0
2022,2,Qassim Region,Publishing Activities,medium,1,0,0,0,105,105,0
2022,2,Al Madinah Region,Publishing Activities,small,4,8,4,4,18,18,0
2022,2,Al Madinah Region,Publishing Activities,micro,14,4,3,1,24,24,0
2022,2,Tabuk Region,Publishing Activities,micro,2,0,0,0,4,4,0
2022,2,Jazan Region,Publishing Activities,micro,6,1,0,1,8,8,0
2022,2,Hail Region,Publishing Activities,small,1,4,1,3,10,10,0
2022,2,Hail Region,Publishing Activities,micro,31,2,1,1,92,92,0
2022,2,Aseer Region,Publishing Activities,small,2,1,1,0,12,12,0
2022,2,Aseer Region,Publishing Activities,micro,8,4,4,0,17,17,0
2022,2,Aseer Region,Publishing Activities,medium,1,25,15,10,63,63,0
2022,2,Makkah Region,Publishing Activities,small,16,70,34,36,214,212,2
2022,2,Makkah Region,Publishing Activities,micro,92,51,23,28,159,158,1
2022,2,Makkah Region,Publishing Activities,medium,3,94,73,21,192,183,9
2022,2,Najran Region,Publishing Activities,micro,4,1,1,0,10,10,0
2022,2,Najran Region,Publishing Activities,medium,1,0,0,0,137,137,0
2022,2,Eastern Province,Activities of Membership Organizations,small,23,216,82,134,136,136,0
2022,2,Eastern Province,Activities of Membership Organizations,micro,68,61,34,27,96,91,5
2022,2,Eastern Province,Activities of Membership Organizations,medium,2,142,69,73,54,53,1
2022,2,Al Bahah Region,Activities of Membership Organizations,small,1,9,9,0,0,0,0
2022,2,Al Bahah Region,Activities of Membership Organizations,micro,12,18,15,3,4,4,0
2022,2,Al Jawf Region,Activities of Membership Organizations,small,5,47,41,6,26,25,1
2022,2,Al Jawf Region,Activities of Membership Organizations,micro,25,29,17,12,29,29,0
2022,2,Northern Borders Region,Activities of Membership Organizations,small,1,29,25,4,15,12,3
2022,2,Northern Borders Region,Activities of Membership Organizations,micro,6,7,6,1,4,4,0
2022,2,Riyadh Region,Activities of Membership Organizations,small,104,807,468,339,690,674,16
2022,2,Riyadh Region,Activities of Membership Organizations,large,10,11991,7605,4386,2098,1140,958
2022,2,Riyadh Region,Activities of Membership Organizations,micro,2005,336,183,153,4109,4052,57
2022,2,Riyadh Region,Activities of Membership Organizations,medium,21,2407,1647,760,315,260,55
2022,2,Qassim Region,Activities of Membership Organizations,small,12,104,74,30,45,43,2
2022,2,Qassim Region,Activities of Membership Organizations,micro,71,60,48,12,114,114,0
2022,2,Al Madinah Region,Activities of Membership Organizations,small,8,44,40,4,60,59,1
2022,2,Al Madinah Region,Activities of Membership Organizations,large,1,278,266,12,15,15,0
2022,2,Al Madinah Region,Activities of Membership Organizations,micro,64,25,18,7,115,112,3
2022,2,Al Madinah Region,Activities of Membership Organizations,medium,1,42,22,20,42,41,1
2022,2,Tabuk Region,Activities of Membership Organizations,small,7,98,48,50,21,20,1
2022,2,Tabuk Region,Activities of Membership Organizations,micro,16,13,7,6,13,13,0
2022,2,Tabuk Region,Activities of Membership Organizations,medium,2,103,49,54,103,102,1
2022,2,Jazan Region,Activities of Membership Organizations,small,8,109,49,60,26,25,1
2022,2,Jazan Region,Activities of Membership Organizations,micro,111,44,26,18,179,174,5
2022,2,Jazan Region,Activities of Membership Organizations,medium,1,37,35,2,13,13,0
2022,2,Hail Region,Activities of Membership Organizations,small,4,23,12,11,16,16,0
2022,2,Hail Region,Activities of Membership Organizations,micro,19,14,6,8,24,24,0
2022,2,Hail Region,Activities of Membership Organizations,medium,1,75,63,12,0,0,0
2022,2,Aseer Region,Activities of Membership Organizations,small,7,50,25,25,36,31,5
2022,2,Aseer Region,Activities of Membership Organizations,micro,43,51,39,12,38,37,1
2022,2,Aseer Region,Activities of Membership Organizations,medium,1,48,12,36,30,29,1
2022,2,Makkah Region,Activities of Membership Organizations,small,39,228,153,75,319,316,3
2022,2,Makkah Region,Activities of Membership Organizations,large,1,410,189,221,76,76,0
2022,2,Makkah Region,Activities of Membership Organizations,micro,251,180,118,62,365,353,12
2022,2,Makkah Region,Activities of Membership Organizations,medium,4,527,354,173,34,26,8
2022,2,Najran Region,Activities of Membership Organizations,small,1,45,43,2,4,4,0
2022,2,Najran Region,Activities of Membership Organizations,micro,34,21,13,8,55,54,1
2022,2,Eastern Province,"Libraries, Archives, Museums, and Other Cultural Activities",small,10,31,17,14,103,102,1
2022,2,Eastern Province,"Libraries, Archives, Museums, and Other Cultural Activities",micro,34,9,5,4,57,56,1
2022,2,Al Bahah Region,"Libraries, Archives, Museums, and Other Cultural Activities",micro,4,1,0,1,8,8,0
2022,2,Al Jawf Region,"Libraries, Archives, Museums, and Other Cultural Activities",micro,1,0,0,0,1,1,0
2022,2,Northern Borders Region,"Libraries, Archives, Museums, and Other Cultural Activities",micro,4,0,0,0,6,6,0
2022,2,Riyadh Region,"Libraries, Archives, Museums, and Other Cultural Activities",small,7,29,15,14,61,59,2
2022,2,Riyadh Region,"Libraries, Archives, Museums, and Other Cultural Activities",micro,26,13,4,9,44,43,1
2022,2,Riyadh Region,"Libraries, Archives, Museums, and Other Cultural Activities",medium,1,70,47,23,0,0,0
2022,2,Qassim Region,"Libraries, Archives, Museums, and Other Cultural Activities",small,3,6,5,1,14,14,0
2022,2,Qassim Region,"Libraries, Archives, Museums, and Other Cultural Activities",micro,9,2,1,1,17,17,0
2022,2,Al Madinah Region,"Libraries, Archives, Museums, and Other Cultural Activities",small,5,13,10,3,34,34,0
2022,2,Al Madinah Region,"Libraries, Archives, Museums, and Other Cultural Activities",micro,34,18,12,6,67,67,0
2022,2,Tabuk Region,"Libraries, Archives, Museums, and Other Cultural Activities",small,3,6,4,2,20,20,0
2022,2,Tabuk Region,"Libraries, Archives, Museums, and Other Cultural Activities",micro,9,3,3,0,23,23,0
2022,2,Jazan Region,"Libraries, Archives, Museums, and Other Cultural Activities",small,2,2,1,1,19,19,0
2022,2,Jazan Region,"Libraries, Archives, Museums, and Other Cultural Activities",micro,13,0,0,0,31,31,0
2022,2,Hail Region,"Libraries, Archives, Museums, and Other Cultural Activities",micro,4,0,0,0,5,5,0
2022,2,Aseer Region,"Libraries, Archives, Museums, and Other Cultural Activities",small,3,8,8,0,18,18,0
2022,2,Aseer Region,"Libraries, Archives, Museums, and Other Cultural Activities",micro,14,4,2,2,20,20,0
2022,2,Makkah Region,"Libraries, Archives, Museums, and Other Cultural Activities",small,9,13,8,5,86,84,2
2022,2,Makkah Region,"Libraries, Archives, Museums, and Other Cultural Activities",micro,90,27,17,10,164,159,5
2022,2,Makkah Region,"Libraries, Archives, Museums, and Other Cultural Activities",medium,1,17,10,7,86,86,0
2022,2,Najran Region,"Libraries, Archives, Museums, and Other Cultural Activities",micro,6,0,0,0,18,18,0
2022,2,Eastern Province,"Head Office Activities, Management Consultancy Activities",small,38,227,128,99,350,341,9
2022,2,Eastern Province,"Head Office Activities, Management Consultancy Activities",micro,108,105,63,42,136,130,6
2022,2,Eastern Province,"Head Office Activities, Management Consultancy Activities",medium,7,260,166,94,305,294,11
2022,2,Al Bahah Region,"Head Office Activities, Management Consultancy Activities",small,1,2,2,0,6,6,0
2022,2,Al Bahah Region,"Head Office Activities, Management Consultancy Activities",micro,2,1,0,1,3,3,0
2022,2,Al Jawf Region,"Head Office Activities, Management Consultancy Activities",large,1,69,9,60,190,140,50
2022,2,Al Jawf Region,"Head Office Activities, Management Consultancy Activities",micro,1,1,1,0,1,1,0
2022,2,Northern Borders Region,"Head Office Activities, Management Consultancy Activities",small,1,6,4,2,6,6,0
2022,2,Northern Borders Region,"Head Office Activities, Management Consultancy Activities",micro,3,1,0,1,6,6,0
2022,2,Riyadh Region,"Head Office Activities, Management Consultancy Activities",small,208,1580,851,729,1689,1539,150
2022,2,Riyadh Region,"Head Office Activities, Management Consultancy Activities",large,12,10449,6349,4100,3442,3271,171
2022,2,Riyadh Region,"Head Office Activities, Management Consultancy Activities",micro,623,592,291,301,870,825,45
2022,2,Riyadh Region,"Head Office Activities, Management Consultancy Activities",medium,28,1669,1045,624,1645,1579,66
2022,2,Qassim Region,"Head Office Activities, Management Consultancy Activities",small,4,11,8,3,45,45,0
2022,2,Qassim Region,"Head Office Activities, Management Consultancy Activities",large,1,395,283,112,886,886,0
2022,2,Qassim Region,"Head Office Activities, Management Consultancy Activities",micro,16,11,8,3,24,24,0
2022,2,Al Madinah Region,"Head Office Activities, Management Consultancy Activities",small,4,9,6,3,20,20,0
2022,2,Al Madinah Region,"Head Office Activities, Management Consultancy Activities",micro,30,14,6,8,38,38,0
2022,2,Al Madinah Region,"Head Office Activities, Management Consultancy Activities",medium,1,127,91,36,1,1,0
2022,2,Tabuk Region,"Head Office Activities, Management Consultancy Activities",micro,3,2,1,1,1,1,0
2022,2,Jazan Region,"Head Office Activities, Management Consultancy Activities",small,1,11,5,6,0,0,0
2022,2,Jazan Region,"Head Office Activities, Management Consultancy Activities",micro,6,8,0,8,13,13,0
2022,2,Jazan Region,"Head Office Activities, Management Consultancy Activities",medium,1,28,20,8,42,42,0
2022,2,Hail Region,"Head Office Activities, Management Consultancy Activities",micro,8,2,2,0,19,19,0
2022,2,Aseer Region,"Head Office Activities, Management Consultancy Activities",micro,16,8,3,5,24,23,1
2022,2,Makkah Region,"Head Office Activities, Management Consultancy Activities",small,75,385,214,171,556,524,32
2022,2,Makkah Region,"Head Office Activities, Management Consultancy Activities",large,1,644,321,323,864,817,47
2022,2,Makkah Region,"Head Office Activities, Management Consultancy Activities",micro,228,184,96,88,313,295,18
2022,2,Makkah Region,"Head Office Activities, Management Consultancy Activities",medium,3,98,61,37,249,229,20
2022,2,Najran Region,"Head Office Activities, Management Consultancy Activities",micro,4,2,0,2,15,15,0
2022,2,Eastern Province,"Architectural and Engineering Activities, Technical Testing, and Analysis",small,237,1452,939,513,2216,2184,32
2022,2,Eastern Province,"Architectural and Engineering Activities, Technical Testing, and Analysis",large,24,5302,4356,946,6803,6782,21
2022,2,Eastern Province,"Architectural and Engineering Activities, Technical Testing, and Analysis",micro,438,359,201,158,704,698,6
2022,2,Eastern Province,"Architectural and Engineering Activities, Technical Testing, and Analysis",medium,69,2701,2057,644,4368,4347,21
2022,2,Al Bahah Region,"Architectural and Engineering Activities, Technical Testing, and Analysis",small,16,50,28,22,165,165,0
2022,2,Al Bahah Region,"Architectural and Engineering Activities, Technical Testing, and Analysis",micro,95,20,13,7,195,195,0
2022,2,Al Bahah Region,"Architectural and Engineering Activities, Technical Testing, and Analysis",medium,1,24,15,9,58,58,0
2022,2,Al Jawf Region,"Architectural and Engineering Activities, Technical Testing, and Analysis",small,17,40,27,13,162,161,1
2022,2,Al Jawf Region,"Architectural and Engineering Activities, Technical Testing, and Analysis",micro,96,38,22,16,174,174,0
2022,2,Al Jawf Region,"Architectural and Engineering Activities, Technical Testing, and Analysis",medium,1,15,12,3,38,38,0
2022,2,Northern Borders Region,"Architectural and Engineering Activities, Technical Testing, and Analysis",small,8,31,15,16,59,59,0
2022,2,Northern Borders Region,"Architectural and Engineering Activities, Technical Testing, and Analysis",micro,62,14,6,8,132,131,1
2022,2,Riyadh Region,"Architectural and Engineering Activities, Technical Testing, and Analysis",small,474,2615,1539,1076,4476,4395,81
2022,2,Riyadh Region,"Architectural and Engineering Activities, Technical Testing, and Analysis",large,24,5250,3860,1390,7023,6961,62
2022,2,Riyadh Region,"Architectural and Engineering Activities, Technical Testing, and Analysis",micro,2841,918,480,438,5277,5232,45
2022,2,Riyadh Region,"Architectural and Engineering Activities, Technical Testing, and Analysis",medium,106,4905,3191,1714,7042,6947,95
2022,2,Qassim Region,"Architectural and Engineering Activities, Technical Testing, and Analysis",small,35,142,101,41,369,367,2
2022,2,Qassim Region,"Architectural and Engineering Activities, Technical Testing, and Analysis",micro,173,67,49,18,315,315,0
2022,2,Qassim Region,"Architectural and Engineering Activities, Technical Testing, and Analysis",medium,6,181,139,42,315,314,1
2022,2,Al Madinah Region,"Architectural and Engineering Activities, Technical Testing, and Analysis",small,69,320,181,139,619,614,5
2022,2,Al Madinah Region,"Architectural and Engineering Activities, Technical Testing, and Analysis",micro,125,57,31,26,223,221,2
2022,2,Al Madinah Region,"Architectural and Engineering Activities, Technical Testing, and Analysis",medium,5,288,205,83,354,353,1
2022,2,Tabuk Region,"Architectural and Engineering Activities, Technical Testing, and Analysis",small,25,106,59,47,207,204,3
2022,2,Tabuk Region,"Architectural and Engineering Activities, Technical Testing, and Analysis",micro,64,40,27,13,117,117,0
2022,2,Tabuk Region,"Architectural and Engineering Activities, Technical Testing, and Analysis",medium,1,30,19,11,30,30,0
2022,2,Jazan Region,"Architectural and Engineering Activities, Technical Testing, and Analysis",small,15,75,48,27,125,123,2
2022,2,Jazan Region,"Architectural and Engineering Activities, Technical Testing, and Analysis",micro,103,48,30,18,184,180,4
2022,2,Jazan Region,"Architectural and Engineering Activities, Technical Testing, and Analysis",medium,1,35,17,18,59,59,0
2022,2,Hail Region,"Architectural and Engineering Activities, Technical Testing, and Analysis",small,14,58,33,25,180,179,1
2022,2,Hail Region,"Architectural and Engineering Activities, Technical Testing, and Analysis",micro,148,36,27,9,295,294,1
2022,2,Hail Region,"Architectural and Engineering Activities, Technical Testing, and Analysis",medium,1,48,38,10,61,61,0
2022,2,Aseer Region,"Architectural and Engineering Activities, Technical Testing, and Analysis",small,48,186,122,64,330,325,5
2022,2,Aseer Region,"Architectural and Engineering Activities, Technical Testing, and Analysis",micro,205,124,81,43,362,360,2
2022,2,Aseer Region,"Architectural and Engineering Activities, Technical Testing, and Analysis",medium,2,56,49,7,111,110,1
2022,2,Makkah Region,"Architectural and Engineering Activities, Technical Testing, and Analysis",small,376,1648,960,688,3250,3208,42
2022,2,Makkah Region,"Architectural and Engineering Activities, Technical Testing, and Analysis",large,10,1320,874,446,2518,2499,19
2022,2,Makkah Region,"Architectural and Engineering Activities, Technical Testing, and Analysis",micro,870,517,300,217,1478,1449,29
2022,2,Makkah Region,"Architectural and Engineering Activities, Technical Testing, and Analysis",medium,27,840,537,303,1614,1601,13
2022,2,Najran Region,"Architectural and Engineering Activities, Technical Testing, and Analysis",small,13,54,43,11,118,118,0
2022,2,Najran Region,"Architectural and Engineering Activities, Technical Testing, and Analysis",micro,139,30,21,9,270,270,0
2022,2,Najran Region,"Architectural and Engineering Activities, Technical Testing, and Analysis",medium,1,23,17,6,77,77,0
2022,2,Eastern Province,"Treatment and Disposal of Non-Hazardous Waste, Other Waste Management Services",small,5,29,21,8,108,108,0
2022,2,Eastern Province,"Treatment and Disposal of Non-Hazardous Waste, Other Waste Management Services",micro,5,4,3,1,6,6,0
2022,2,Riyadh Region,"Treatment and Disposal of Non-Hazardous Waste, Other Waste Management Services",small,2,31,30,1,22,22,0
2022,2,Riyadh Region,"Treatment and Disposal of Non-Hazardous Waste, Other Waste Management Services",large,1,2065,1545,520,579,579,0
2022,2,Riyadh Region,"Treatment and Disposal of Non-Hazardous Waste, Other Waste Management Services",micro,3,2,1,1,7,7,0
2022,2,Makkah Region,"Treatment and Disposal of Non-Hazardous Waste, Other Waste Management Services",small,1,4,2,2,19,19,0
2022,2,Makkah Region,"Treatment and Disposal of Non-Hazardous Waste, Other Waste Management Services",micro,2,2,1,1,3,3,0
2022,2,Najran Region,"Treatment and Disposal of Non-Hazardous Waste, Other Waste Management Services",small,1,1,0,1,18,18,0
2022,2,Eastern Province,Social Work Activities Without Accommodation,small,154,1667,324,1343,449,373,76
2022,2,Eastern Province,Social Work Activities Without Accommodation,large,2,293,138,155,357,254,103
2022,2,Eastern Province,Social Work Activities Without Accommodation,micro,190,335,55,280,130,111,19
2022,2,Eastern Province,Social Work Activities Without Accommodation,medium,13,807,269,538,268,190,78
2022,2,Al Bahah Region,Social Work Activities Without Accommodation,small,22,201,119,82,60,56,4
2022,2,Al Bahah Region,Social Work Activities Without Accommodation,micro,43,94,75,19,41,41,0
2022,2,Al Jawf Region,Social Work Activities Without Accommodation,small,21,182,102,80,112,106,6
2022,2,Al Jawf Region,Social Work Activities Without Accommodation,micro,22,46,24,22,12,12,0
2022,2,Northern Borders Region,Social Work Activities Without Accommodation,small,12,104,47,57,34,32,2
2022,2,Northern Borders Region,Social Work Activities Without Accommodation,micro,22,37,23,14,24,24,0
2022,2,Riyadh Region,Social Work Activities Without Accommodation,small,263,2463,714,1749,1445,1259,186
2022,2,Riyadh Region,Social Work Activities Without Accommodation,large,9,3668,2083,1585,1655,1318,337
2022,2,Riyadh Region,Social Work Activities Without Accommodation,micro,407,556,223,333,439,395,44
2022,2,Riyadh Region,Social Work Activities Without Accommodation,medium,33,2688,1482,1206,1065,937,128
2022,2,Qassim Region,Social Work Activities Without Accommodation,small,68,696,329,367,328,305,23
2022,2,Qassim Region,Social Work Activities Without Accommodation,micro,84,136,85,51,91,89,2
2022,2,Qassim Region,Social Work Activities Without Accommodation,medium,5,316,145,171,176,136,40
2022,2,Al Madinah Region,Social Work Activities Without Accommodation,small,70,732,376,356,264,215,49
2022,2,Al Madinah Region,Social Work Activities Without Accommodation,large,1,552,327,225,24,16,8
2022,2,Al Madinah Region,Social Work Activities Without Accommodation,micro,150,282,170,112,121,112,9
2022,2,Al Madinah Region,Social Work Activities Without Accommodation,medium,8,441,256,185,249,227,22
2022,2,Tabuk Region,Social Work Activities Without Accommodation,small,11,94,45,49,26,22,4
2022,2,Tabuk Region,Social Work Activities Without Accommodation,micro,37,90,59,31,18,18,0
2022,2,Tabuk Region,Social Work Activities Without Accommodation,medium,1,70,61,9,155,154,1
2022,2,Jazan Region,Social Work Activities Without Accommodation,small,24,179,120,59,56,53,3
2022,2,Jazan Region,Social Work Activities Without Accommodation,micro,63,100,69,31,54,53,1
2022,2,Jazan Region,Social Work Activities Without Accommodation,medium,3,95,31,64,94,89,5
2022,2,Hail Region,Social Work Activities Without Accommodation,small,20,234,93,141,58,54,4
2022,2,Hail Region,Social Work Activities Without Accommodation,micro,66,95,64,31,69,68,1
2022,2,Aseer Region,Social Work Activities Without Accommodation,small,57,412,203,209,337,308,29
2022,2,Aseer Region,Social Work Activities Without Accommodation,micro,103,210,156,54,62,58,4
2022,2,Aseer Region,Social Work Activities Without Accommodation,medium,2,80,45,35,40,39,1
2022,2,Makkah Region,Social Work Activities Without Accommodation,small,235,2115,751,1364,1226,942,284
2022,2,Makkah Region,Social Work Activities Without Accommodation,micro,393,559,243,316,370,325,45
2022,2,Makkah Region,Social Work Activities Without Accommodation,medium,22,1289,698,591,898,806,92
2022,2,Najran Region,Social Work Activities Without Accommodation,small,7,43,23,20,76,76,0
2022,2,Najran Region,Social Work Activities Without Accommodation,micro,34,50,32,18,42,42,0
2022,2,Eastern Province,"Financial Service Activities, Except Insurance and Pension Funding",small,84,539,338,201,741,736,5
2022,2,Eastern Province,"Financial Service Activities, Except Insurance and Pension Funding",large,2,712,433,279,143,129,14
2022,2,Eastern Province,"Financial Service Activities, Except Insurance and Pension Funding",micro,196,139,86,53,324,317,7
2022,2,Eastern Province,"Financial Service Activities, Except Insurance and Pension Funding",medium,26,1283,827,456,1112,1094,18
2022,2,Al Bahah Region,"Financial Service Activities, Except Insurance and Pension Funding",small,1,6,3,3,15,15,0
2022,2,Al Bahah Region,"Financial Service Activities, Except Insurance and Pension Funding",micro,9,3,2,1,15,15,0
2022,2,Al Jawf Region,"Financial Service Activities, Except Insurance and Pension Funding",micro,9,4,2,2,16,16,0
2022,2,Northern Borders Region,"Financial Service Activities, Except Insurance and Pension Funding",small,3,1,0,1,62,62,0
2022,2,Northern Borders Region,"Financial Service Activities, Except Insurance and Pension Funding",micro,7,4,0,4,17,17,0
2022,2,Riyadh Region,"Financial Service Activities, Except Insurance and Pension Funding",small,186,1525,968,557,1399,1345,54
2022,2,Riyadh Region,"Financial Service Activities, Except Insurance and Pension Funding",large,7,7446,5548,1898,697,678,19
2022,2,Riyadh Region,"Financial Service Activities, Except Insurance and Pension Funding",micro,434,419,269,150,580,567,13
2022,2,Riyadh Region,"Financial Service Activities, Except Insurance and Pension Funding",medium,39,2624,1791,833,1519,1422,97
2022,2,Qassim Region,"Financial Service Activities, Except Insurance and Pension Funding",small,3,39,39,0,14,14,0
2022,2,Qassim Region,"Financial Service Activities, Except Insurance and Pension Funding",micro,25,7,6,1,54,54,0
2022,2,Al Madinah Region,"Financial Service Activities, Except Insurance and Pension Funding",small,6,30,25,5,41,41,0
2022,2,Al Madinah Region,"Financial Service Activities, Except Insurance and Pension Funding",micro,45,30,18,12,85,81,4
2022,2,Al Madinah Region,"Financial Service Activities, Except Insurance and Pension Funding",medium,1,62,48,14,53,53,0
2022,2,Tabuk Region,"Financial Service Activities, Except Insurance and Pension Funding",micro,18,4,2,2,37,37,0
2022,2,Jazan Region,"Financial Service Activities, Except Insurance and Pension Funding",small,2,11,11,0,7,7,0
2022,2,Jazan Region,"Financial Service Activities, Except Insurance and Pension Funding",micro,18,1,1,0,46,46,0
2022,2,Hail Region,"Financial Service Activities, Except Insurance and Pension Funding",small,4,21,15,6,9,9,0
2022,2,Hail Region,"Financial Service Activities, Except Insurance and Pension Funding",micro,22,3,2,1,59,59,0
2022,2,Aseer Region,"Financial Service Activities, Except Insurance and Pension Funding",small,8,58,23,35,86,86,0
2022,2,Aseer Region,"Financial Service Activities, Except Insurance and Pension Funding",micro,23,11,6,5,44,44,0
2022,2,Makkah Region,"Financial Service Activities, Except Insurance and Pension Funding",small,137,757,455,302,1319,1273,46
2022,2,Makkah Region,"Financial Service Activities, Except Insurance and Pension Funding",large,3,11925,10236,1689,420,419,1
2022,2,Makkah Region,"Financial Service Activities, Except Insurance and Pension Funding",micro,335,202,124,78,619,598,21
2022,2,Makkah Region,"Financial Service Activities, Except Insurance and Pension Funding",medium,20,1019,676,343,787,776,11
2022,2,Najran Region,"Financial Service Activities, Except Insurance and Pension Funding",small,1,2,0,2,4,4,0
2022,2,Najran Region,"Financial Service Activities, Except Insurance and Pension Funding",micro,15,3,2,1,36,36,0
2022,2,Eastern Province,Other Personal Service Activities,small,723,1476,407,1069,5977,4299,1678
2022,2,Eastern Province,Other Personal Service Activities,large,1,284,131,153,2219,2219,0
2022,2,Eastern Province,Other Personal Service Activities,micro,5713,1331,527,804,12140,11030,1110
2022,2,Eastern Province,Other Personal Service Activities,medium,16,381,136,245,1229,1180,49
2022,2,Al Bahah Region,Other Personal Service Activities,small,15,17,11,6,90,85,5
2022,2,Al Bahah Region,Other Personal Service Activities,micro,403,73,49,24,809,769,40
2022,2,Al Jawf Region,Other Personal Service Activities,small,44,55,32,23,352,322,30
2022,2,Al Jawf Region,Other Personal Service Activities,micro,705,113,56,57,1432,1326,106
2022,2,Al Jawf Region,Other Personal Service Activities,medium,2,16,12,4,107,106,1
2022,2,Northern Borders Region,Other Personal Service Activities,small,25,34,10,24,203,150,53
2022,2,Northern Borders Region,Other Personal Service Activities,micro,545,75,37,38,1247,1187,60
2022,2,Riyadh Region,Other Personal Service Activities,small,1308,2952,699,2253,11303,7998,3305
2022,2,Riyadh Region,Other Personal Service Activities,large,5,2315,1485,830,1519,1064,455
2022,2,Riyadh Region,Other Personal Service Activities,micro,9157,2188,780,1408,19141,16997,2144
2022,2,Riyadh Region,Other Personal Service Activities,medium,43,820,183,637,2814,2112,702
2022,2,Qassim Region,Other Personal Service Activities,small,144,219,55,164,1342,987,355
2022,2,Qassim Region,Other Personal Service Activities,micro,1876,299,148,151,4140,3844,296
2022,2,Qassim Region,Other Personal Service Activities,medium,6,71,33,38,362,301,61
2022,2,Al Madinah Region,Other Personal Service Activities,small,161,342,105,237,1341,975,366
2022,2,Al Madinah Region,Other Personal Service Activities,micro,2579,396,186,210,5209,4863,346
2022,2,Al Madinah Region,Other Personal Service Activities,medium,1,7,6,1,45,45,0
2022,2,Tabuk Region,Other Personal Service Activities,small,62,92,36,56,555,477,78
2022,2,Tabuk Region,Other Personal Service Activities,micro,1292,197,90,107,2673,2550,123
2022,2,Jazan Region,Other Personal Service Activities,small,79,194,79,115,572,440,132
2022,2,Jazan Region,Other Personal Service Activities,micro,1772,202,107,95,3943,3789,154
2022,2,Jazan Region,Other Personal Service Activities,medium,2,37,36,1,201,201,0
2022,2,Hail Region,Other Personal Service Activities,small,72,132,37,95,581,449,132
2022,2,Hail Region,Other Personal Service Activities,micro,1047,154,68,86,2301,2132,169
2022,2,Hail Region,Other Personal Service Activities,medium,1,46,3,43,58,8,50
2022,2,Aseer Region,Other Personal Service Activities,small,133,223,109,114,1079,963,116
2022,2,Aseer Region,Other Personal Service Activities,micro,2307,381,180,201,4765,4498,267
2022,2,Makkah Region,Other Personal Service Activities,small,798,1755,473,1282,6860,4812,2048
2022,2,Makkah Region,Other Personal Service Activities,large,2,299,203,96,254,36,218
2022,2,Makkah Region,Other Personal Service Activities,micro,8256,1731,763,968,17194,15591,1603
2022,2,Makkah Region,Other Personal Service Activities,medium,16,321,73,248,928,438,490
2022,2,Najran Region,Other Personal Service Activities,small,32,36,14,22,224,189,35
2022,2,Najran Region,Other Personal Service Activities,micro,786,125,54,71,1798,1675,123
2022,2,Eastern Province,Specialized Construction Activities,small,1834,4623,2521,2102,22817,22754,63
2022,2,Eastern Province,Specialized Construction Activities,large,86,15565,12667,2898,76367,76294,73
2022,2,Eastern Province,Specialized Construction Activities,micro,5985,1904,930,974,13462,13441,21
2022,2,Eastern Province,Specialized Construction Activities,medium,240,4663,2997,1666,20562,20517,45
2022,2,Al Bahah Region,Specialized Construction Activities,small,51,94,63,31,477,477,0
2022,2,Al Bahah Region,Specialized Construction Activities,micro,449,81,58,23,999,998,1
2022,2,Al Bahah Region,Specialized Construction Activities,medium,4,98,61,37,460,460,0
2022,2,Al Jawf Region,Specialized Construction Activities,small,83,160,119,41,920,910,10
2022,2,Al Jawf Region,Specialized Construction Activities,micro,691,110,73,37,1534,1527,7
2022,2,Al Jawf Region,Specialized Construction Activities,medium,3,30,20,10,236,236,0
2022,2,Northern Borders Region,Specialized Construction Activities,small,43,75,52,23,366,366,0
2022,2,Northern Borders Region,Specialized Construction Activities,micro,419,80,44,36,1013,1013,0
2022,2,Northern Borders Region,Specialized Construction Activities,medium,1,5,5,0,86,86,0
2022,2,Riyadh Region,Specialized Construction Activities,small,3026,8102,3628,4474,38519,38215,304
2022,2,Riyadh Region,Specialized Construction Activities,large,153,32404,24059,8345,114796,112775,2021
2022,2,Riyadh Region,Specialized Construction Activities,micro,11315,3120,1363,1757,25528,25310,218
2022,2,Riyadh Region,Specialized Construction Activities,medium,480,8612,4894,3718,39391,39204,187
2022,2,Qassim Region,Specialized Construction Activities,small,412,554,320,234,5105,5089,16
2022,2,Qassim Region,Specialized Construction Activities,large,12,814,569,245,7043,6800,243
2022,2,Qassim Region,Specialized Construction Activities,micro,2704,433,249,184,6411,6392,19
2022,2,Qassim Region,Specialized Construction Activities,medium,52,368,241,127,4976,4973,3
2022,2,Al Madinah Region,Specialized Construction Activities,small,368,702,400,302,3895,3880,15
2022,2,Al Madinah Region,Specialized Construction Activities,large,6,913,625,288,4337,4195,142
2022,2,Al Madinah Region,Specialized Construction Activities,micro,2620,553,313,240,6181,6148,33
2022,2,Al Madinah Region,Specialized Construction Activities,medium,28,487,299,188,2062,2043,19
2022,2,Tabuk Region,Specialized Construction Activities,small,80,167,85,82,751,751,0
2022,2,Tabuk Region,Specialized Construction Activities,large,1,85,77,8,571,571,0
2022,2,Tabuk Region,Specialized Construction Activities,micro,1206,223,110,113,2838,2835,3
2022,2,Tabuk Region,Specialized Construction Activities,medium,4,46,25,21,247,247,0
2022,2,Jazan Region,Specialized Construction Activities,small,106,199,96,103,949,938,11
2022,2,Jazan Region,Specialized Construction Activities,micro,1898,314,190,124,4551,4533,18
2022,2,Jazan Region,Specialized Construction Activities,medium,2,30,28,2,217,217,0
2022,2,Hail Region,Specialized Construction Activities,small,128,186,83,103,1271,1269,2
2022,2,Hail Region,Specialized Construction Activities,large,2,197,142,55,826,821,5
2022,2,Hail Region,Specialized Construction Activities,micro,1154,166,89,77,2770,2760,10
2022,2,Hail Region,Specialized Construction Activities,medium,10,153,121,32,878,868,10
2022,2,Aseer Region,Specialized Construction Activities,small,338,677,413,264,3233,3209,24
2022,2,Aseer Region,Specialized Construction Activities,large,4,603,295,308,2865,2865,0
2022,2,Aseer Region,Specialized Construction Activities,micro,2701,484,278,206,5900,5891,9
2022,2,Aseer Region,Specialized Construction Activities,medium,20,439,274,165,1582,1581,1
2022,2,Makkah Region,Specialized Construction Activities,small,1966,4822,2446,2376,22988,22818,170
2022,2,Makkah Region,Specialized Construction Activities,large,49,4998,3529,1469,25200,25067,133
2022,2,Makkah Region,Specialized Construction Activities,micro,10010,2453,1214,1239,22157,21929,228
2022,2,Makkah Region,Specialized Construction Activities,medium,205,3923,2570,1353,17221,17158,63
2022,2,Najran Region,Specialized Construction Activities,small,141,197,109,88,1502,1490,12
2022,2,Najran Region,Specialized Construction Activities,large,5,266,168,98,1241,1241,0
2022,2,Najran Region,Specialized Construction Activities,micro,1165,135,75,60,2589,2574,15
2022,2,Najran Region,Specialized Construction Activities,medium,10,179,126,53,734,734,0
2022,2,Eastern Province,Postal and Courier Activities,small,10,49,24,25,86,86,0
2022,2,Eastern Province,Postal and Courier Activities,micro,33,30,9,21,44,44,0
2022,2,Eastern Province,Postal and Courier Activities,medium,2,56,20,36,127,127,0
2022,2,Al Jawf Region,Postal and Courier Activities,micro,2,1,1,0,4,4,0
2022,2,Riyadh Region,Postal and Courier Activities,small,95,444,209,235,1047,1028,19
2022,2,Riyadh Region,Postal and Courier Activities,large,5,1046,567,479,4752,4724,28
2022,2,Riyadh Region,Postal and Courier Activities,micro,244,153,90,63,441,427,14
2022,2,Riyadh Region,Postal and Courier Activities,medium,12,359,236,123,680,666,14
2022,2,Qassim Region,Postal and Courier Activities,micro,10,5,1,4,26,26,0
2022,2,Al Madinah Region,Postal and Courier Activities,small,2,0,0,0,15,15,0
2022,2,Al Madinah Region,Postal and Courier Activities,micro,12,4,3,1,25,25,0
2022,2,Tabuk Region,Postal and Courier Activities,micro,7,1,0,1,16,15,1
2022,2,Jazan Region,Postal and Courier Activities,micro,3,0,0,0,6,6,0
2022,2,Hail Region,Postal and Courier Activities,micro,3,0,0,0,9,9,0
2022,2,Aseer Region,Postal and Courier Activities,small,2,30,28,2,12,11,1
2022,2,Aseer Region,Postal and Courier Activities,micro,11,5,4,1,31,31,0
2022,2,Makkah Region,Postal and Courier Activities,small,12,77,31,46,191,188,3
2022,2,Makkah Region,Postal and Courier Activities,micro,77,57,28,29,123,119,4
2022,2,Makkah Region,Postal and Courier Activities,medium,1,17,0,17,67,67,0
2022,2,Najran Region,Postal and Courier Activities,micro,2,0,0,0,2,2,0
2022,2,Eastern Province,Programming and Broadcasting Activities,small,2,7,6,1,17,17,0
2022,2,Eastern Province,Programming and Broadcasting Activities,micro,10,7,2,5,24,23,1
2022,2,Al Jawf Region,Programming and Broadcasting Activities,micro,1,0,0,0,1,1,0
2022,2,Riyadh Region,Programming and Broadcasting Activities,small,13,86,49,37,64,62,2
2022,2,Riyadh Region,Programming and Broadcasting Activities,micro,54,38,17,21,98,98,0
2022,2,Riyadh Region,Programming and Broadcasting Activities,medium,2,74,40,34,87,80,7
2022,2,Qassim Region,Programming and Broadcasting Activities,micro,2,0,0,0,3,3,0
2022,2,Al Madinah Region,Programming and Broadcasting Activities,micro,3,1,0,1,9,9,0
2022,2,Tabuk Region,Programming and Broadcasting Activities,micro,2,0,0,0,8,8,0
2022,2,Jazan Region,Programming and Broadcasting Activities,micro,1,1,0,1,4,4,0
2022,2,Hail Region,Programming and Broadcasting Activities,small,1,2,1,1,5,5,0
2022,2,Aseer Region,Programming and Broadcasting Activities,micro,7,1,1,0,14,14,0
2022,2,Makkah Region,Programming and Broadcasting Activities,small,14,71,43,28,125,120,5
2022,2,Makkah Region,Programming and Broadcasting Activities,micro,20,7,5,2,43,39,4
2022,2,Makkah Region,Programming and Broadcasting Activities,medium,1,55,30,25,70,70,0
2022,2,Najran Region,Programming and Broadcasting Activities,micro,2,2,1,1,3,3,0
2022,2,Eastern Province,"Computer Programming, Consultancy, and Related Activities",small,107,723,390,333,962,946,16
2022,2,Eastern Province,"Computer Programming, Consultancy, and Related Activities",large,3,952,836,116,717,710,7
2022,2,Eastern Province,"Computer Programming, Consultancy, and Related Activities",micro,260,217,109,108,366,359,7
2022,2,Eastern Province,"Computer Programming, Consultancy, and Related Activities",medium,12,518,299,219,447,439,8
2022,2,Al Bahah Region,"Computer Programming, Consultancy, and Related Activities",micro,2,3,1,2,2,2,0
2022,2,Al Jawf Region,"Computer Programming, Consultancy, and Related Activities",micro,14,5,4,1,25,25,0
2022,2,Northern Borders Region,"Computer Programming, Consultancy, and Related Activities",micro,6,3,1,2,12,12,0
2022,2,Riyadh Region,"Computer Programming, Consultancy, and Related Activities",small,592,4090,2045,2045,5459,5264,195
2022,2,Riyadh Region,"Computer Programming, Consultancy, and Related Activities",large,25,13957,8820,5137,6912,6613,299
2022,2,Riyadh Region,"Computer Programming, Consultancy, and Related Activities",micro,1300,1005,488,517,1935,1877,58
2022,2,Riyadh Region,"Computer Programming, Consultancy, and Related Activities",medium,97,4724,2696,2028,4844,4708,136
2022,2,Qassim Region,"Computer Programming, Consultancy, and Related Activities",small,17,92,49,43,148,140,8
2022,2,Qassim Region,"Computer Programming, Consultancy, and Related Activities",micro,71,23,11,12,148,148,0
2022,2,Al Madinah Region,"Computer Programming, Consultancy, and Related Activities",small,7,27,11,16,46,46,0
2022,2,Al Madinah Region,"Computer Programming, Consultancy, and Related Activities",micro,84,43,17,26,138,134,4
2022,2,Al Madinah Region,"Computer Programming, Consultancy, and Related Activities",medium,1,34,33,1,17,17,0
2022,2,Tabuk Region,"Computer Programming, Consultancy, and Related Activities",micro,19,10,3,7,34,33,1
2022,2,Jazan Region,"Computer Programming, Consultancy, and Related Activities",small,1,3,3,0,6,6,0
2022,2,Jazan Region,"Computer Programming, Consultancy, and Related Activities",micro,26,8,3,5,60,60,0
2022,2,Hail Region,"Computer Programming, Consultancy, and Related Activities",small,3,6,2,4,35,35,0
2022,2,Hail Region,"Computer Programming, Consultancy, and Related Activities",micro,12,4,2,2,23,23,0
2022,2,Aseer Region,"Computer Programming, Consultancy, and Related Activities",small,11,26,16,10,81,80,1
2022,2,Aseer Region,"Computer Programming, Consultancy, and Related Activities",micro,48,20,11,9,91,90,1
2022,2,Makkah Region,"Computer Programming, Consultancy, and Related Activities",small,148,647,313,334,1267,1221,46
2022,2,Makkah Region,"Computer Programming, Consultancy, and Related Activities",large,2,857,828,29,308,305,3
2022,2,Makkah Region,"Computer Programming, Consultancy, and Related Activities",micro,502,320,149,171,826,792,34
2022,2,Makkah Region,"Computer Programming, Consultancy, and Related Activities",medium,13,506,252,254,651,605,46
2022,2,Najran Region,"Computer Programming, Consultancy, and Related Activities",micro,13,2,2,0,25,25,0
2022,2,Eastern Province,Public Order and Safety Activities,small,23,492,439,53,35,35,0
2022,2,Eastern Province,Public Order and Safety Activities,large,6,3393,3126,267,0,0,0
2022,2,Eastern Province,Public Order and Safety Activities,micro,51,62,54,8,61,61,0
2022,2,Eastern Province,Public Order and Safety Activities,medium,14,1565,1439,126,83,83,0
2022,2,Al Jawf Region,Public Order and Safety Activities,small,2,64,47,17,2,2,0
2022,2,Al Jawf Region,Public Order and Safety Activities,micro,1,3,3,0,0,0,0
2022,2,Northern Borders Region,Public Order and Safety Activities,small,2,24,18,6,0,0,0
2022,2,Northern Borders Region,Public Order and Safety Activities,large,1,0,0,0,336,336,0
2022,2,Northern Borders Region,Public Order and Safety Activities,micro,1,1,1,0,1,1,0
2022,2,Riyadh Region,Public Order and Safety Activities,small,47,665,587,78,210,209,1
2022,2,Riyadh Region,Public Order and Safety Activities,large,17,15616,13911,1705,334,332,2
2022,2,Riyadh Region,Public Order and Safety Activities,micro,118,137,98,39,116,116,0
2022,2,Riyadh Region,Public Order and Safety Activities,medium,22,2932,2573,359,110,105,5
2022,2,Qassim Region,Public Order and Safety Activities,small,6,87,81,6,14,14,0
2022,2,Qassim Region,Public Order and Safety Activities,micro,12,6,6,0,19,19,0
2022,2,Al Madinah Region,Public Order and Safety Activities,small,5,62,58,4,28,28,0
2022,2,Al Madinah Region,Public Order and Safety Activities,micro,13,13,11,2,11,11,0
2022,2,Al Madinah Region,Public Order and Safety Activities,medium,1,124,124,0,0,0,0
2022,2,Tabuk Region,Public Order and Safety Activities,micro,6,2,2,0,5,5,0
2022,2,Jazan Region,Public Order and Safety Activities,small,2,24,20,4,11,9,2
2022,2,Jazan Region,Public Order and Safety Activities,micro,9,8,7,1,14,14,0
2022,2,Hail Region,Public Order and Safety Activities,small,2,11,10,1,4,4,0
2022,2,Hail Region,Public Order and Safety Activities,micro,5,5,2,3,7,7,0
2022,2,Hail Region,Public Order and Safety Activities,medium,1,88,85,3,0,0,0
2022,2,Aseer Region,Public Order and Safety Activities,small,2,35,34,1,0,0,0
2022,2,Aseer Region,Public Order and Safety Activities,large,2,1732,1682,50,0,0,0
2022,2,Aseer Region,Public Order and Safety Activities,micro,9,9,5,4,5,5,0
2022,2,Aseer Region,Public Order and Safety Activities,medium,2,153,146,7,0,0,0
2022,2,Makkah Region,Public Order and Safety Activities,small,35,508,417,91,53,52,1
2022,2,Makkah Region,Public Order and Safety Activities,large,6,2529,2307,222,0,0,0
2022,2,Makkah Region,Public Order and Safety Activities,micro,51,55,46,9,64,61,3
2022,2,Makkah Region,Public Order and Safety Activities,medium,8,919,786,133,2,2,0
2022,2,Najran Region,Public Order and Safety Activities,large,1,304,275,29,0,0,0
2022,2,Najran Region,Public Order and Safety Activities,micro,2,1,1,0,3,3,0
2022,2,Eastern Province,Activities of Households as Employers of Domestic Personnel,micro,9,2,2,0,16,15,1
2022,2,Al Bahah Region,Activities of Households as Employers of Domestic Personnel,micro,1,0,0,0,1,1,0
2022,2,Riyadh Region,Activities of Households as Employers of Domestic Personnel,micro,9,1,1,0,15,14,1
2022,2,Qassim Region,Activities of Households as Employers of Domestic Personnel,small,1,0,0,0,7,7,0
2022,2,Qassim Region,Activities of Households as Employers of Domestic Personnel,micro,6,1,1,0,11,11,0
2022,2,Al Madinah Region,Activities of Households as Employers of Domestic Personnel,micro,2,1,0,1,3,3,0
2022,2,Hail Region,Activities of Households as Employers of Domestic Personnel,micro,4,0,0,0,6,6,0
2022,2,Aseer Region,Activities of Households as Employers of Domestic Personnel,small,1,0,0,0,7,7,0
2022,2,Aseer Region,Activities of Households as Employers of Domestic Personnel,micro,1,0,0,0,1,1,0
2022,2,Makkah Region,Activities of Households as Employers of Domestic Personnel,micro,2,0,0,0,2,2,0
2022,2,Najran Region,Activities of Households as Employers of Domestic Personnel,micro,1,0,0,0,1,1,0
2022,2,Eastern Province,Extraction of Natural Gas,small,53,207,124,83,346,321,25
2022,2,Eastern Province,Extraction of Natural Gas,large,25,596,440,156,42158,32502,9656
2022,2,Eastern Province,Extraction of Natural Gas,micro,285,321,188,133,394,367,27
2022,2,Eastern Province,Extraction of Natural Gas,medium,9,51,23,28,1103,271,832
2022,2,Al Bahah Region,Extraction of Natural Gas,micro,13,8,6,2,23,23,0
2022,2,Al Jawf Region,Extraction of Natural Gas,small,2,12,7,5,12,12,0
2022,2,Al Jawf Region,Extraction of Natural Gas,micro,24,29,10,19,32,32,0
2022,2,Northern Borders Region,Extraction of Natural Gas,small,5,12,3,9,42,13,29
2022,2,Northern Borders Region,Extraction of Natural Gas,micro,13,7,5,2,17,17,0
2022,2,Riyadh Region,Extraction of Natural Gas,small,170,925,365,560,1188,980,208
2022,2,Riyadh Region,Extraction of Natural Gas,large,58,7984,3090,4894,187205,111053,76152
2022,2,Riyadh Region,Extraction of Natural Gas,micro,725,694,352,342,997,959,38
2022,2,Riyadh Region,Extraction of Natural Gas,medium,23,942,548,394,2222,1005,1217
2022,2,Qassim Region,Extraction of Natural Gas,small,17,66,25,41,105,79,26
2022,2,Qassim Region,Extraction of Natural Gas,micro,67,57,36,21,114,112,2
2022,2,Qassim Region,Extraction of Natural Gas,medium,1,6,6,0,44,44,0
2022,2,Al Madinah Region,Extraction of Natural Gas,small,11,57,30,27,41,30,11
2022,2,Al Madinah Region,Extraction of Natural Gas,micro,84,72,43,29,127,123,4
2022,2,Tabuk Region,Extraction of Natural Gas,small,5,10,5,5,89,89,0
2022,2,Tabuk Region,Extraction of Natural Gas,micro,49,37,17,20,81,77,4
2022,2,Jazan Region,Extraction of Natural Gas,small,4,7,2,5,27,27,0
2022,2,Jazan Region,Extraction of Natural Gas,micro,34,13,10,3,62,62,0
2022,2,Hail Region,Extraction of Natural Gas,small,10,49,23,26,83,43,40
2022,2,Hail Region,Extraction of Natural Gas,micro,40,33,23,10,66,63,3
2022,2,Aseer Region,Extraction of Natural Gas,small,11,15,7,8,77,29,48
2022,2,Aseer Region,Extraction of Natural Gas,large,3,121,46,75,15213,10490,4723
2022,2,Aseer Region,Extraction of Natural Gas,micro,101,72,45,27,152,145,7
2022,2,Aseer Region,Extraction of Natural Gas,medium,3,102,44,58,387,336,51
2022,2,Makkah Region,Extraction of Natural Gas,small,54,169,77,92,317,305,12
2022,2,Makkah Region,Extraction of Natural Gas,large,8,125,48,77,15943,12726,3217
2022,2,Makkah Region,Extraction of Natural Gas,micro,341,286,171,115,498,478,20
2022,2,Makkah Region,Extraction of Natural Gas,medium,7,189,57,132,715,459,256
2022,2,Najran Region,Extraction of Natural Gas,small,13,28,11,17,90,68,22
2022,2,Najran Region,Extraction of Natural Gas,micro,41,27,11,16,58,49,9
2022,2,Eastern Province,Civil Engineering,small,390,1474,870,604,5542,5524,18
2022,2,Eastern Province,Civil Engineering,large,95,25082,20720,4362,105456,105351,105
2022,2,Eastern Province,Civil Engineering,micro,498,300,164,136,1003,998,5
2022,2,Eastern Province,Civil Engineering,medium,162,3439,2471,968,14976,14959,17
2022,2,Al Bahah Region,Civil Engineering,small,7,15,15,0,62,62,0
2022,2,Al Bahah Region,Civil Engineering,large,1,52,46,6,283,283,0
2022,2,Al Bahah Region,Civil Engineering,micro,22,2,1,1,40,39,1
2022,2,Al Bahah Region,Civil Engineering,medium,2,51,45,6,96,96,0
2022,2,Al Jawf Region,Civil Engineering,small,16,75,35,40,175,174,1
2022,2,Al Jawf Region,Civil Engineering,large,1,118,80,38,304,274,30
2022,2,Al Jawf Region,Civil Engineering,micro,42,16,13,3,88,88,0
2022,2,Al Jawf Region,Civil Engineering,medium,6,139,110,29,475,475,0
2022,2,Northern Borders Region,Civil Engineering,small,10,30,22,8,132,132,0
2022,2,Northern Borders Region,Civil Engineering,micro,31,6,3,3,69,69,0
2022,2,Northern Borders Region,Civil Engineering,medium,2,49,26,23,204,204,0
2022,2,Riyadh Region,Civil Engineering,small,652,2133,1057,1076,9393,9337,56
2022,2,Riyadh Region,Civil Engineering,large,123,25320,18213,7107,137981,137171,810
2022,2,Riyadh Region,Civil Engineering,micro,1138,487,212,275,2441,2422,19
2022,2,Riyadh Region,Civil Engineering,medium,205,4530,2874,1656,19493,19439,54
2022,2,Qassim Region,Civil Engineering,small,78,257,169,88,1061,1055,6
2022,2,Qassim Region,Civil Engineering,large,8,1263,826,437,8080,8077,3
2022,2,Qassim Region,Civil Engineering,micro,138,46,26,20,316,315,1
2022,2,Qassim Region,Civil Engineering,medium,21,426,311,115,1879,1876,3
2022,2,Al Madinah Region,Civil Engineering,small,71,213,139,74,950,949,1
2022,2,Al Madinah Region,Civil Engineering,large,8,1031,665,366,3394,3385,9
2022,2,Al Madinah Region,Civil Engineering,micro,162,62,32,30,351,349,2
2022,2,Al Madinah Region,Civil Engineering,medium,20,414,308,106,1447,1446,1
2022,2,Tabuk Region,Civil Engineering,small,19,68,35,33,247,247,0
2022,2,Tabuk Region,Civil Engineering,large,1,57,45,12,299,299,0
2022,2,Tabuk Region,Civil Engineering,micro,51,15,9,6,118,118,0
2022,2,Tabuk Region,Civil Engineering,medium,4,86,61,25,336,336,0
2022,2,Jazan Region,Civil Engineering,small,23,49,25,24,323,321,2
2022,2,Jazan Region,Civil Engineering,large,1,70,53,17,416,416,0
2022,2,Jazan Region,Civil Engineering,micro,86,28,19,9,211,211,0
2022,2,Jazan Region,Civil Engineering,medium,8,206,139,67,875,875,0
2022,2,Hail Region,Civil Engineering,small,29,74,38,36,307,301,6
2022,2,Hail Region,Civil Engineering,large,1,110,89,21,662,662,0
2022,2,Hail Region,Civil Engineering,micro,57,20,10,10,117,117,0
2022,2,Hail Region,Civil Engineering,medium,7,153,118,35,608,606,2
2022,2,Aseer Region,Civil Engineering,small,60,192,116,76,813,811,2
2022,2,Aseer Region,Civil Engineering,large,8,703,602,101,3300,3300,0
2022,2,Aseer Region,Civil Engineering,micro,126,50,29,21,272,272,0
2022,2,Aseer Region,Civil Engineering,medium,18,462,354,108,1799,1799,0
2022,2,Makkah Region,Civil Engineering,small,353,1162,612,550,4799,4762,37
2022,2,Makkah Region,Civil Engineering,large,36,7795,5998,1797,38441,38211,230
2022,2,Makkah Region,Civil Engineering,micro,554,240,131,109,1222,1204,18
2022,2,Makkah Region,Civil Engineering,medium,91,1847,1204,643,8093,8064,29
2022,2,Najran Region,Civil Engineering,small,28,107,63,44,335,334,1
2022,2,Najran Region,Civil Engineering,large,6,699,560,139,2969,2967,2
2022,2,Najran Region,Civil Engineering,micro,45,24,13,11,104,104,0
2022,2,Najran Region,Civil Engineering,medium,10,189,108,81,896,896,0
2022,2,Eastern Province,Water Transport,small,21,161,138,23,129,125,4
2022,2,Eastern Province,Water Transport,micro,52,38,33,5,84,84,0
2022,2,Eastern Province,Water Transport,medium,12,691,538,153,375,367,8
2022,2,Al Bahah Region,Water Transport,micro,1,0,0,0,2,2,0
2022,2,Al Jawf Region,Water Transport,micro,1,1,0,1,0,0,0
2022,2,Northern Borders Region,Water Transport,micro,1,0,0,0,1,1,0
2022,2,Riyadh Region,Water Transport,small,18,151,67,84,169,169,0
2022,2,Riyadh Region,Water Transport,micro,119,36,23,13,271,268,3
2022,2,Riyadh Region,Water Transport,medium,2,122,109,13,55,55,0
2022,2,Qassim Region,Water Transport,small,2,0,0,0,20,20,0
2022,2,Qassim Region,Water Transport,micro,6,1,0,1,16,16,0
2022,2,Al Madinah Region,Water Transport,small,7,60,45,15,49,48,1
2022,2,Al Madinah Region,Water Transport,micro,21,13,10,3,34,34,0
2022,2,Al Madinah Region,Water Transport,medium,1,31,25,6,21,20,1
2022,2,Tabuk Region,Water Transport,small,3,28,21,7,40,28,12
2022,2,Tabuk Region,Water Transport,micro,13,6,4,2,13,13,0
2022,2,Jazan Region,Water Transport,small,3,44,26,18,33,33,0
2022,2,Jazan Region,Water Transport,micro,5,2,2,0,9,9,0
2022,2,Jazan Region,Water Transport,medium,1,13,4,9,50,50,0
2022,2,Aseer Region,Water Transport,micro,14,1,0,1,33,33,0
2022,2,Makkah Region,Water Transport,small,33,149,96,53,273,268,5
2022,2,Makkah Region,Water Transport,large,1,103,78,25,156,155,1
2022,2,Makkah Region,Water Transport,micro,114,54,28,26,177,174,3
2022,2,Makkah Region,Water Transport,medium,6,231,146,85,263,263,0
2022,2,Najran Region,Water Transport,small,1,0,0,0,6,6,0
2022,2,Najran Region,Water Transport,micro,7,0,0,0,12,12,0
2022,2,Eastern Province,Air Transport,small,26,119,75,44,290,289,1
2022,2,Eastern Province,Air Transport,micro,60,23,14,9,112,110,2
2022,2,Al Bahah Region,Air Transport,small,1,1,1,0,5,5,0
2022,2,Al Jawf Region,Air Transport,small,1,0,0,0,12,12,0
2022,2,Al Jawf Region,Air Transport,micro,9,3,2,1,21,21,0
2022,2,Northern Borders Region,Air Transport,small,2,12,11,1,28,28,0
2022,2,Riyadh Region,Air Transport,small,32,197,150,47,340,339,1
2022,2,Riyadh Region,Air Transport,large,4,2523,2321,202,1583,1104,479
2022,2,Riyadh Region,Air Transport,micro,244,57,30,27,586,578,8
2022,2,Riyadh Region,Air Transport,medium,8,441,379,62,495,491,4
2022,2,Qassim Region,Air Transport,micro,8,3,1,2,21,21,0
2022,2,Al Madinah Region,Air Transport,small,3,9,6,3,12,12,0
2022,2,Al Madinah Region,Air Transport,micro,10,2,2,0,19,19,0
2022,2,Tabuk Region,Air Transport,small,1,4,3,1,6,6,0
2022,2,Tabuk Region,Air Transport,micro,6,2,0,2,14,14,0
2022,2,Tabuk Region,Air Transport,medium,1,20,18,2,49,49,0
2022,2,Jazan Region,Air Transport,small,1,0,0,0,10,10,0
2022,2,Jazan Region,Air Transport,micro,11,2,1,1,27,27,0
2022,2,Hail Region,Air Transport,small,3,10,6,4,31,31,0
2022,2,Hail Region,Air Transport,micro,16,1,1,0,44,44,0
2022,2,Aseer Region,Air Transport,small,1,2,2,0,8,8,0
2022,2,Aseer Region,Air Transport,micro,13,5,3,2,32,32,0
2022,2,Makkah Region,Air Transport,small,28,146,102,44,345,341,4
2022,2,Makkah Region,Air Transport,large,2,5659,5077,582,202,121,81
2022,2,Makkah Region,Air Transport,micro,72,38,19,19,141,137,4
2022,2,Makkah Region,Air Transport,medium,4,135,116,19,204,204,0
2022,2,Najran Region,Air Transport,small,1,0,0,0,6,6,0
2022,2,Najran Region,Air Transport,micro,1,0,0,0,4,4,0
2022,2,Eastern Province,Land Transport and Transport Via Pipelines,small,748,2489,1424,1065,10915,10903,12
2022,2,Eastern Province,Land Transport and Transport Via Pipelines,large,48,8976,7427,1549,23257,23246,11
2022,2,Eastern Province,Land Transport and Transport Via Pipelines,micro,2185,629,279,350,4335,4323,12
2022,2,Eastern Province,Land Transport and Transport Via Pipelines,medium,162,4056,2794,1262,12570,12558,12
2022,2,Al Bahah Region,Land Transport and Transport Via Pipelines,small,12,26,14,12,96,96,0
2022,2,Al Bahah Region,Land Transport and Transport Via Pipelines,micro,191,27,18,9,374,374,0
2022,2,Al Bahah Region,Land Transport and Transport Via Pipelines,medium,3,51,31,20,134,119,15
2022,2,Al Jawf Region,Land Transport and Transport Via Pipelines,small,77,176,117,59,920,920,0
2022,2,Al Jawf Region,Land Transport and Transport Via Pipelines,micro,586,73,48,25,1222,1218,4
2022,2,Al Jawf Region,Land Transport and Transport Via Pipelines,medium,4,103,47,56,306,306,0
2022,2,Northern Borders Region,Land Transport and Transport Via Pipelines,small,56,106,45,61,590,589,1
2022,2,Northern Borders Region,Land Transport and Transport Via Pipelines,micro,349,55,37,18,677,677,0
2022,2,Northern Borders Region,Land Transport and Transport Via Pipelines,medium,3,66,49,17,266,266,0
2022,2,Riyadh Region,Land Transport and Transport Via Pipelines,small,1225,3291,1478,1813,15153,15084,69
2022,2,Riyadh Region,Land Transport and Transport Via Pipelines,large,43,14076,11731,2345,24259,24232,27
2022,2,Riyadh Region,Land Transport and Transport Via Pipelines,micro,13289,1926,951,975,34345,34185,160
2022,2,Riyadh Region,Land Transport and Transport Via Pipelines,medium,202,4667,2470,2197,16722,16707,15
2022,2,Qassim Region,Land Transport and Transport Via Pipelines,small,253,646,368,278,2857,2857,0
2022,2,Qassim Region,Land Transport and Transport Via Pipelines,large,4,615,535,80,1896,1896,0
2022,2,Qassim Region,Land Transport and Transport Via Pipelines,micro,1111,218,131,87,2440,2437,3
2022,2,Qassim Region,Land Transport and Transport Via Pipelines,medium,28,710,539,171,2356,2355,1
2022,2,Al Madinah Region,Land Transport and Transport Via Pipelines,small,138,383,235,148,1697,1695,2
2022,2,Al Madinah Region,Land Transport and Transport Via Pipelines,large,1,93,39,54,320,319,1
2022,2,Al Madinah Region,Land Transport and Transport Via Pipelines,micro,1101,159,76,83,2170,2166,4
2022,2,Al Madinah Region,Land Transport and Transport Via Pipelines,medium,20,345,238,107,1299,1299,0
2022,2,Tabuk Region,Land Transport and Transport Via Pipelines,small,70,148,73,75,631,631,0
2022,2,Tabuk Region,Land Transport and Transport Via Pipelines,micro,587,100,58,42,1110,1109,1
2022,2,Tabuk Region,Land Transport and Transport Via Pipelines,medium,6,146,123,23,373,373,0
2022,2,Jazan Region,Land Transport and Transport Via Pipelines,small,44,58,30,28,426,426,0
2022,2,Jazan Region,Land Transport and Transport Via Pipelines,large,1,969,747,222,581,549,32
2022,2,Jazan Region,Land Transport and Transport Via Pipelines,micro,523,93,55,38,1118,1113,5
2022,2,Jazan Region,Land Transport and Transport Via Pipelines,medium,5,105,73,32,509,508,1
2022,2,Hail Region,Land Transport and Transport Via Pipelines,small,54,105,45,60,595,594,1
2022,2,Hail Region,Land Transport and Transport Via Pipelines,micro,647,84,46,38,1543,1540,3
2022,2,Hail Region,Land Transport and Transport Via Pipelines,medium,3,31,11,20,175,175,0
2022,2,Aseer Region,Land Transport and Transport Via Pipelines,small,270,583,334,249,2748,2743,5
2022,2,Aseer Region,Land Transport and Transport Via Pipelines,large,3,181,137,44,640,640,0
2022,2,Aseer Region,Land Transport and Transport Via Pipelines,micro,1854,307,166,141,3618,3610,8
2022,2,Aseer Region,Land Transport and Transport Via Pipelines,medium,17,313,171,142,1274,1274,0
2022,2,Makkah Region,Land Transport and Transport Via Pipelines,small,868,2601,1339,1262,11257,11214,43
2022,2,Makkah Region,Land Transport and Transport Via Pipelines,large,15,2216,1585,631,7772,7737,35
2022,2,Makkah Region,Land Transport and Transport Via Pipelines,micro,3679,827,430,397,7556,7461,95
2022,2,Makkah Region,Land Transport and Transport Via Pipelines,medium,127,2556,1551,1005,9549,9504,45
2022,2,Najran Region,Land Transport and Transport Via Pipelines,small,101,197,105,92,1152,1150,2
2022,2,Najran Region,Land Transport and Transport Via Pipelines,micro,1015,117,62,55,2447,2443,4
2022,2,Najran Region,Land Transport and Transport Via Pipelines,medium,4,76,48,28,256,256,0
2022,2,Eastern Province,Printing and Reproduction of Recorded Media,small,52,262,134,128,545,545,0
2022,2,Eastern Province,Printing and Reproduction of Recorded Media,large,1,1333,1009,324,982,976,6
2022,2,Eastern Province,Printing and Reproduction of Recorded Media,micro,88,67,27,40,130,130,0
2022,2,Eastern Province,Printing and Reproduction of Recorded Media,medium,4,125,76,49,253,253,0
2022,2,Al Bahah Region,Printing and Reproduction of Recorded Media,small,5,16,8,8,31,31,0
2022,2,Al Bahah Region,Printing and Reproduction of Recorded Media,micro,6,3,1,2,14,14,0
2022,2,Al Jawf Region,Printing and Reproduction of Recorded Media,small,1,1,0,1,5,5,0
2022,2,Al Jawf Region,Printing and Reproduction of Recorded Media,micro,8,3,2,1,16,16,0
2022,2,Northern Borders Region,Printing and Reproduction of Recorded Media,small,3,7,4,3,29,29,0
2022,2,Northern Borders Region,Printing and Reproduction of Recorded Media,micro,5,0,0,0,6,6,0
2022,2,Riyadh Region,Printing and Reproduction of Recorded Media,small,151,840,326,514,1666,1657,9
2022,2,Riyadh Region,Printing and Reproduction of Recorded Media,large,1,100,100,0,268,268,0
2022,2,Riyadh Region,Printing and Reproduction of Recorded Media,micro,259,173,79,94,458,449,9
2022,2,Riyadh Region,Printing and Reproduction of Recorded Media,medium,20,600,279,321,1386,1379,7
2022,2,Qassim Region,Printing and Reproduction of Recorded Media,small,10,60,34,26,117,117,0
2022,2,Qassim Region,Printing and Reproduction of Recorded Media,micro,30,12,6,6,53,53,0
2022,2,Qassim Region,Printing and Reproduction of Recorded Media,medium,2,54,16,38,96,96,0
2022,2,Al Madinah Region,Printing and Reproduction of Recorded Media,small,8,17,5,12,55,55,0
2022,2,Al Madinah Region,Printing and Reproduction of Recorded Media,large,1,864,864,0,110,110,0
2022,2,Al Madinah Region,Printing and Reproduction of Recorded Media,micro,49,16,11,5,97,97,0
2022,2,Al Madinah Region,Printing and Reproduction of Recorded Media,medium,1,46,37,9,33,33,0
2022,2,Tabuk Region,Printing and Reproduction of Recorded Media,small,4,11,3,8,37,37,0
2022,2,Tabuk Region,Printing and Reproduction of Recorded Media,micro,15,12,8,4,27,25,2
2022,2,Jazan Region,Printing and Reproduction of Recorded Media,small,1,6,3,3,14,14,0
2022,2,Jazan Region,Printing and Reproduction of Recorded Media,micro,14,5,4,1,33,33,0
2022,2,Hail Region,Printing and Reproduction of Recorded Media,small,3,18,15,3,44,44,0
2022,2,Hail Region,Printing and Reproduction of Recorded Media,micro,24,15,10,5,46,46,0
2022,2,Aseer Region,Printing and Reproduction of Recorded Media,small,11,49,19,30,125,124,1
2022,2,Aseer Region,Printing and Reproduction of Recorded Media,micro,24,16,9,7,44,43,1
2022,2,Makkah Region,Printing and Reproduction of Recorded Media,small,92,416,188,228,981,970,11
2022,2,Makkah Region,Printing and Reproduction of Recorded Media,micro,219,100,55,45,427,418,9
2022,2,Makkah Region,Printing and Reproduction of Recorded Media,medium,12,338,139,199,697,684,13
2022,2,Najran Region,Printing and Reproduction of Recorded Media,small,3,8,3,5,26,25,1
2022,2,Najran Region,Printing and Reproduction of Recorded Media,micro,5,0,0,0,13,13,0
2022,2,Eastern Province,Other Manufacturing,small,77,372,290,82,1090,1088,2
2022,2,Eastern Province,Other Manufacturing,large,3,704,681,23,773,770,3
2022,2,Eastern Province,Other Manufacturing,micro,97,61,47,14,171,167,4
2022,2,Eastern Province,Other Manufacturing,medium,21,645,425,220,1245,1244,1
2022,2,Al Bahah Region,Other Manufacturing,small,2,2,0,2,10,9,1
2022,2,Al Bahah Region,Other Manufacturing,micro,5,1,1,0,11,11,0
2022,2,Al Jawf Region,Other Manufacturing,small,1,0,0,0,8,8,0
2022,2,Al Jawf Region,Other Manufacturing,micro,5,2,2,0,6,6,0
2022,2,Northern Borders Region,Other Manufacturing,micro,2,0,0,0,5,5,0
2022,2,Riyadh Region,Other Manufacturing,small,160,617,281,336,2323,2248,75
2022,2,Riyadh Region,Other Manufacturing,large,7,931,412,519,3381,3354,27
2022,2,Riyadh Region,Other Manufacturing,micro,198,101,58,43,384,377,7
2022,2,Riyadh Region,Other Manufacturing,medium,46,995,638,357,3268,3256,12
2022,2,Qassim Region,Other Manufacturing,small,11,69,48,21,120,120,0
2022,2,Qassim Region,Other Manufacturing,micro,19,14,13,1,38,36,2
2022,2,Qassim Region,Other Manufacturing,medium,1,0,0,0,113,113,0
2022,2,Al Madinah Region,Other Manufacturing,small,9,31,19,12,85,83,2
2022,2,Al Madinah Region,Other Manufacturing,large,1,303,299,4,221,221,0
2022,2,Al Madinah Region,Other Manufacturing,micro,31,19,14,5,56,56,0
2022,2,Al Madinah Region,Other Manufacturing,medium,2,33,22,11,160,160,0
2022,2,Tabuk Region,Other Manufacturing,micro,11,5,4,1,23,21,2
2022,2,Jazan Region,Other Manufacturing,small,2,4,4,0,22,22,0
2022,2,Jazan Region,Other Manufacturing,micro,19,7,5,2,40,40,0
2022,2,Hail Region,Other Manufacturing,small,2,5,5,0,8,8,0
2022,2,Hail Region,Other Manufacturing,micro,13,3,2,1,33,32,1
2022,2,Aseer Region,Other Manufacturing,small,14,49,34,15,158,156,2
2022,2,Aseer Region,Other Manufacturing,micro,31,15,10,5,63,61,2
2022,2,Makkah Region,Other Manufacturing,small,99,471,234,237,1490,1475,15
2022,2,Makkah Region,Other Manufacturing,large,6,711,546,165,2353,2341,12
2022,2,Makkah Region,Other Manufacturing,micro,163,80,39,41,303,290,13
2022,2,Makkah Region,Other Manufacturing,medium,21,516,332,184,1631,1627,4
2022,2,Najran Region,Other Manufacturing,small,1,2,1,1,6,6,0
2022,2,Najran Region,Other Manufacturing,micro,3,3,3,0,6,6,0
2022,2,Najran Region,Other Manufacturing,medium,1,31,31,0,116,116,0
2022,2,Eastern Province,Sewerage,small,18,62,36,26,241,241,0
2022,2,Eastern Province,Sewerage,large,2,322,273,49,1760,1760,0
2022,2,Eastern Province,Sewerage,micro,27,16,9,7,60,59,1
2022,2,Eastern Province,Sewerage,medium,2,20,10,10,96,95,1
2022,2,Al Bahah Region,Sewerage,small,1,0,0,0,10,10,0
2022,2,Al Bahah Region,Sewerage,micro,3,3,1,2,11,11,0
2022,2,Al Jawf Region,Sewerage,micro,7,1,0,1,13,13,0
2022,2,Northern Borders Region,Sewerage,micro,3,0,0,0,11,11,0
2022,2,Riyadh Region,Sewerage,small,29,62,32,30,400,399,1
2022,2,Riyadh Region,Sewerage,large,2,38,17,21,1919,1918,1
2022,2,Riyadh Region,Sewerage,micro,106,27,11,16,245,243,2
2022,2,Riyadh Region,Sewerage,medium,5,83,68,15,426,426,0
2022,2,Qassim Region,Sewerage,small,9,12,4,8,63,62,1
2022,2,Qassim Region,Sewerage,micro,16,3,2,1,38,38,0
2022,2,Al Madinah Region,Sewerage,small,10,11,9,2,89,89,0
2022,2,Al Madinah Region,Sewerage,micro,10,2,0,2,22,22,0
2022,2,Tabuk Region,Sewerage,small,1,1,0,1,8,8,0
2022,2,Tabuk Region,Sewerage,micro,6,2,2,0,15,15,0
2022,2,Jazan Region,Sewerage,micro,21,4,4,0,51,51,0
2022,2,Hail Region,Sewerage,small,4,10,6,4,40,40,0
2022,2,Hail Region,Sewerage,micro,11,3,3,0,36,36,0
2022,2,Hail Region,Sewerage,medium,1,14,13,1,36,36,0
2022,2,Aseer Region,Sewerage,small,2,6,4,2,48,48,0
2022,2,Aseer Region,Sewerage,micro,11,1,0,1,26,26,0
2022,2,Aseer Region,Sewerage,medium,1,26,20,6,90,90,0
2022,2,Makkah Region,Sewerage,small,20,36,23,13,219,218,1
2022,2,Makkah Region,Sewerage,large,1,245,222,23,134,134,0
2022,2,Makkah Region,Sewerage,micro,71,21,9,12,156,155,1
2022,2,Makkah Region,Sewerage,medium,5,33,24,9,275,274,1
2022,2,Najran Region,Sewerage,micro,2,0,0,0,5,5,0
2022,2,Eastern Province,Human Health Activities,small,295,2322,517,1805,3683,1887,1796
2022,2,Eastern Province,Human Health Activities,large,49,22818,10452,12366,19526,9134,10392
2022,2,Eastern Province,Human Health Activities,micro,233,204,64,140,383,252,131
2022,2,Eastern Province,Human Health Activities,medium,116,5204,1565,3639,7580,4220,3360
2022,2,Al Bahah Region,Human Health Activities,small,28,216,84,132,377,150,227
2022,2,Al Bahah Region,Human Health Activities,large,1,802,669,133,3,2,1
2022,2,Al Bahah Region,Human Health Activities,micro,25,24,11,13,38,27,11
2022,2,Al Bahah Region,Human Health Activities,medium,2,201,169,32,71,29,42
2022,2,Al Jawf Region,Human Health Activities,small,39,293,120,173,390,220,170
2022,2,Al Jawf Region,Human Health Activities,large,3,1342,880,462,1,1,0
2022,2,Al Jawf Region,Human Health Activities,micro,18,9,3,6,24,18,6
2022,2,Al Jawf Region,Human Health Activities,medium,14,718,397,321,496,251,245
2022,2,Northern Borders Region,Human Health Activities,small,28,140,36,104,292,163,129
2022,2,Northern Borders Region,Human Health Activities,micro,20,25,9,16,41,27,14
2022,2,Northern Borders Region,Human Health Activities,medium,10,753,428,325,211,114,97
2022,2,Riyadh Region,Human Health Activities,small,849,6162,2064,4098,11038,5452,5586
2022,2,Riyadh Region,Human Health Activities,large,90,47897,26213,21684,54639,31571,23068
2022,2,Riyadh Region,Human Health Activities,micro,669,504,192,312,1074,734,340
2022,2,Riyadh Region,Human Health Activities,medium,275,10645,4127,6518,18871,10860,8011
2022,2,Qassim Region,Human Health Activities,small,106,810,329,481,1383,658,725
2022,2,Qassim Region,Human Health Activities,large,15,4393,3216,1177,4025,1294,2731
2022,2,Qassim Region,Human Health Activities,micro,66,43,23,20,121,93,28
2022,2,Qassim Region,Human Health Activities,medium,44,1508,868,640,2982,1651,1331
2022,2,Al Madinah Region,Human Health Activities,small,151,1119,417,702,1973,889,1084
2022,2,Al Madinah Region,Human Health Activities,large,24,11263,7825,3438,4960,2377,2583
2022,2,Al Madinah Region,Human Health Activities,micro,78,58,27,31,129,85,44
2022,2,Al Madinah Region,Human Health Activities,medium,31,947,353,594,1571,732,839
2022,2,Tabuk Region,Human Health Activities,small,53,374,89,285,617,325,292
2022,2,Tabuk Region,Human Health Activities,large,3,4192,2538,1654,2153,939,1214
2022,2,Tabuk Region,Human Health Activities,micro,31,31,10,21,52,41,11
2022,2,Tabuk Region,Human Health Activities,medium,12,445,202,243,657,357,300
2022,2,Jazan Region,Human Health Activities,small,95,1081,357,724,1200,569,631
2022,2,Jazan Region,Human Health Activities,large,6,3037,1727,1310,1231,372,859
2022,2,Jazan Region,Human Health Activities,micro,75,67,19,48,135,106,29
2022,2,Jazan Region,Human Health Activities,medium,18,896,303,593,671,370,301
2022,2,Hail Region,Human Health Activities,small,56,391,137,254,592,328,264
2022,2,Hail Region,Human Health Activities,large,7,2087,1261,826,1653,480,1173
2022,2,Hail Region,Human Health Activities,micro,50,41,19,22,78,65,13
2022,2,Hail Region,Human Health Activities,medium,17,876,453,423,1108,506,602
2022,2,Aseer Region,Human Health Activities,small,157,1073,304,769,1931,898,1033
2022,2,Aseer Region,Human Health Activities,large,13,4087,2483,1604,4472,2307,2165
2022,2,Aseer Region,Human Health Activities,micro,110,85,24,61,190,129,61
2022,2,Aseer Region,Human Health Activities,medium,46,2004,785,1219,2923,1316,1607
2022,2,Makkah Region,Human Health Activities,small,667,5110,1387,3723,8095,3975,4120
2022,2,Makkah Region,Human Health Activities,large,49,21833,12270,9563,20334,9449,10885
2022,2,Makkah Region,Human Health Activities,micro,439,349,142,207,720,521,199
2022,2,Makkah Region,Human Health Activities,medium,191,7024,2346,4678,12099,6081,6018
2022,2,Najran Region,Human Health Activities,small,57,375,195,180,652,313,339
2022,2,Najran Region,Human Health Activities,large,3,693,637,56,188,106,82
2022,2,Najran Region,Human Health Activities,micro,30,20,11,9,57,36,21
2022,2,Najran Region,Human Health Activities,medium,20,942,705,237,1177,771,406
2022,2,Eastern Province,Residential Care Activities,small,6,80,3,77,38,16,22
2022,2,Eastern Province,Residential Care Activities,micro,7,10,4,6,8,4,4
2022,2,Eastern Province,Residential Care Activities,medium,1,63,17,46,65,47,18
2022,2,Al Jawf Region,Residential Care Activities,micro,4,6,1,5,3,3,0
2022,2,Riyadh Region,Residential Care Activities,small,18,125,16,109,107,44,63
2022,2,Riyadh Region,Residential Care Activities,micro,26,21,6,15,38,33,5
2022,2,Riyadh Region,Residential Care Activities,medium,4,119,26,93,164,106,58
2022,2,Qassim Region,Residential Care Activities,small,4,42,11,31,49,41,8
2022,2,Qassim Region,Residential Care Activities,micro,3,5,0,5,4,3,1
2022,2,Al Madinah Region,Residential Care Activities,small,3,39,21,18,39,30,9
2022,2,Al Madinah Region,Residential Care Activities,micro,7,13,11,2,5,3,2
2022,2,Tabuk Region,Residential Care Activities,small,1,10,1,9,18,16,2
2022,2,Tabuk Region,Residential Care Activities,micro,2,4,1,3,2,1,1
2022,2,Jazan Region,Residential Care Activities,small,4,52,16,36,14,8,6
2022,2,Jazan Region,Residential Care Activities,micro,1,1,1,0,1,1,0
2022,2,Hail Region,Residential Care Activities,small,2,26,8,18,5,3,2
2022,2,Hail Region,Residential Care Activities,micro,1,2,0,2,0,0,0
2022,2,Aseer Region,Residential Care Activities,small,4,55,2,53,24,5,19
2022,2,Aseer Region,Residential Care Activities,micro,5,4,0,4,7,7,0
2022,2,Makkah Region,Residential Care Activities,small,13,143,30,113,109,67,42
2022,2,Makkah Region,Residential Care Activities,micro,20,26,2,24,32,19,13
2022,2,Makkah Region,Residential Care Activities,medium,1,44,7,37,19,6,13
2022,2,Najran Region,Residential Care Activities,small,1,6,0,6,4,0,4
2022,2,Eastern Province,Forestry and Logging,micro,3,1,0,1,4,4,0
2022,2,Riyadh Region,Forestry and Logging,small,1,4,2,2,2,2,0
2022,2,Riyadh Region,Forestry and Logging,micro,4,0,0,0,7,7,0
2022,2,Qassim Region,Forestry and Logging,micro,1,0,0,0,1,1,0
2022,2,Jazan Region,Forestry and Logging,micro,1,1,0,1,0,0,0
2022,2,Makkah Region,Forestry and Logging,micro,3,0,0,0,9,9,0
2022,2,Eastern Province,Education,small,276,3185,901,2284,1973,1702,271
2022,2,Eastern Province,Education,large,17,5110,2609,2501,1652,1304,348
2022,2,Eastern Province,Education,micro,351,361,123,238,418,374,44
2022,2,Eastern Province,Education,medium,93,5509,1891,3618,4275,3610,665
2022,2,Al Bahah Region,Education,small,8,110,43,67,86,80,6
2022,2,Al Bahah Region,Education,micro,22,17,6,11,31,27,4
2022,2,Al Bahah Region,Education,medium,1,175,103,72,0,0,0
2022,2,Al Jawf Region,Education,small,31,415,141,274,231,199,32
2022,2,Al Jawf Region,Education,micro,47,35,15,20,61,54,7
2022,2,Al Jawf Region,Education,medium,10,443,228,215,355,348,7
2022,2,Northern Borders Region,Education,small,18,191,142,49,163,162,1
2022,2,Northern Borders Region,Education,large,1,56,39,17,450,266,184
2022,2,Northern Borders Region,Education,micro,24,24,3,21,35,34,1
2022,2,Northern Borders Region,Education,medium,3,183,55,128,63,49,14
2022,2,Riyadh Region,Education,small,585,5522,1440,4082,4641,3913,728
2022,2,Riyadh Region,Education,large,56,21969,10488,11481,13747,10905,2842
2022,2,Riyadh Region,Education,micro,4793,1138,473,665,9510,9348,162
2022,2,Riyadh Region,Education,medium,214,14247,5219,9028,10463,8972,1491
2022,2,Qassim Region,Education,small,55,706,198,508,424,386,38
2022,2,Qassim Region,Education,large,4,666,350,316,1577,972,605
2022,2,Qassim Region,Education,micro,121,68,21,47,193,184,9
2022,2,Qassim Region,Education,medium,16,886,451,435,476,396,80
2022,2,Al Madinah Region,Education,small,91,1161,286,875,477,411,66
2022,2,Al Madinah Region,Education,large,3,1505,790,715,140,105,35
2022,2,Al Madinah Region,Education,micro,147,120,28,92,213,196,17
2022,2,Al Madinah Region,Education,medium,33,2224,897,1327,1556,1269,287
2022,2,Tabuk Region,Education,small,41,467,150,317,299,269,30
2022,2,Tabuk Region,Education,large,3,430,176,254,814,594,220
2022,2,Tabuk Region,Education,micro,43,58,10,48,52,49,3
2022,2,Tabuk Region,Education,medium,15,867,438,429,607,566,41
2022,2,Jazan Region,Education,small,47,396,145,251,299,271,28
2022,2,Jazan Region,Education,large,1,29,23,6,1408,745,663
2022,2,Jazan Region,Education,micro,100,65,22,43,158,150,8
2022,2,Jazan Region,Education,medium,3,122,64,58,119,65,54
2022,2,Hail Region,Education,small,26,303,63,240,108,92,16
2022,2,Hail Region,Education,large,1,31,13,18,811,452,359
2022,2,Hail Region,Education,micro,100,34,13,21,209,207,2
2022,2,Hail Region,Education,medium,5,314,215,99,223,221,2
2022,2,Aseer Region,Education,small,60,787,226,561,406,373,33
2022,2,Aseer Region,Education,large,1,11,9,2,423,271,152
2022,2,Aseer Region,Education,micro,102,73,23,50,136,127,9
2022,2,Aseer Region,Education,medium,16,1002,527,475,551,487,64
2022,2,Makkah Region,Education,small,357,3977,822,3155,2606,1939,667
2022,2,Makkah Region,Education,large,17,6410,3448,2962,4244,2897,1347
2022,2,Makkah Region,Education,micro,594,426,134,292,896,778,118
2022,2,Makkah Region,Education,medium,139,7833,3263,4570,6485,5162,1323
2022,2,Najran Region,Education,small,19,163,55,108,112,109,3
2022,2,Najran Region,Education,micro,68,25,5,20,125,123,2
2022,2,Najran Region,Education,medium,7,252,138,114,211,206,5
2022,2,Eastern Province,Warehousing and Support Activities for Transportation,small,244,1195,905,290,2279,2268,11
2022,2,Eastern Province,Warehousing and Support Activities for Transportation,large,10,3185,2850,335,6023,5976,47
2022,2,Eastern Province,Warehousing and Support Activities for Transportation,micro,696,485,355,130,1177,1169,8
2022,2,Eastern Province,Warehousing and Support Activities for Transportation,medium,55,2062,1473,589,3379,3362,17
2022,2,Al Bahah Region,Warehousing and Support Activities for Transportation,micro,28,7,4,3,49,48,1
2022,2,Al Jawf Region,Warehousing and Support Activities for Transportation,small,23,90,82,8,242,241,1
2022,2,Al Jawf Region,Warehousing and Support Activities for Transportation,micro,106,36,30,6,196,196,0
2022,2,Northern Borders Region,Warehousing and Support Activities for Transportation,small,2,4,2,2,19,19,0
2022,2,Northern Borders Region,Warehousing and Support Activities for Transportation,micro,30,4,4,0,54,54,0
2022,2,Riyadh Region,Warehousing and Support Activities for Transportation,small,409,1896,1020,876,4837,4792,45
2022,2,Riyadh Region,Warehousing and Support Activities for Transportation,large,32,11843,8921,2922,11677,11520,157
2022,2,Riyadh Region,Warehousing and Support Activities for Transportation,micro,1446,510,298,212,3012,2999,13
2022,2,Riyadh Region,Warehousing and Support Activities for Transportation,medium,90,2776,1526,1250,6876,6819,57
2022,2,Qassim Region,Warehousing and Support Activities for Transportation,small,29,70,49,21,330,330,0
2022,2,Qassim Region,Warehousing and Support Activities for Transportation,large,1,18,16,2,356,356,0
2022,2,Qassim Region,Warehousing and Support Activities for Transportation,micro,148,50,29,21,310,309,1
2022,2,Qassim Region,Warehousing and Support Activities for Transportation,medium,5,129,82,47,395,395,0
2022,2,Al Madinah Region,Warehousing and Support Activities for Transportation,small,36,149,106,43,313,310,3
2022,2,Al Madinah Region,Warehousing and Support Activities for Transportation,large,2,1043,953,90,319,319,0
2022,2,Al Madinah Region,Warehousing and Support Activities for Transportation,micro,223,39,24,15,441,441,0
2022,2,Al Madinah Region,Warehousing and Support Activities for Transportation,medium,5,177,160,17,274,274,0
2022,2,Tabuk Region,Warehousing and Support Activities for Transportation,small,18,73,48,25,119,119,0
2022,2,Tabuk Region,Warehousing and Support Activities for Transportation,micro,77,38,27,11,125,125,0
2022,2,Tabuk Region,Warehousing and Support Activities for Transportation,medium,1,45,11,34,34,34,0
2022,2,Jazan Region,Warehousing and Support Activities for Transportation,small,13,46,35,11,95,94,1
2022,2,Jazan Region,Warehousing and Support Activities for Transportation,micro,74,25,19,6,151,150,1
2022,2,Jazan Region,Warehousing and Support Activities for Transportation,medium,1,23,7,16,31,31,0
2022,2,Hail Region,Warehousing and Support Activities for Transportation,small,11,9,8,1,86,86,0
2022,2,Hail Region,Warehousing and Support Activities for Transportation,micro,61,21,13,8,128,128,0
2022,2,Aseer Region,Warehousing and Support Activities for Transportation,small,24,103,79,24,321,321,0
2022,2,Aseer Region,Warehousing and Support Activities for Transportation,micro,131,48,31,17,287,287,0
2022,2,Aseer Region,Warehousing and Support Activities for Transportation,medium,4,131,103,28,212,212,0
2022,2,Makkah Region,Warehousing and Support Activities for Transportation,small,382,1643,1052,591,4212,4155,57
2022,2,Makkah Region,Warehousing and Support Activities for Transportation,large,26,7416,6468,948,11706,11683,23
2022,2,Makkah Region,Warehousing and Support Activities for Transportation,micro,818,461,309,152,1438,1412,26
2022,2,Makkah Region,Warehousing and Support Activities for Transportation,medium,78,2666,2008,658,5608,5570,38
2022,2,Najran Region,Warehousing and Support Activities for Transportation,small,95,57,30,27,863,863,0
2022,2,Najran Region,Warehousing and Support Activities for Transportation,micro,473,58,31,27,1241,1238,3
2022,2,Eastern Province,"Research and Development in the Physical, Engineering, and Life Sciences",small,10,48,33,15,42,41,1
2022,2,Eastern Province,"Research and Development in the Physical, Engineering, and Life Sciences",micro,11,10,4,6,9,9,0
2022,2,Eastern Province,"Research and Development in the Physical, Engineering, and Life Sciences",medium,2,127,75,52,116,115,1
2022,2,Northern Borders Region,"Research and Development in the Physical, Engineering, and Life Sciences",micro,1,1,1,0,2,2,0
2022,2,Riyadh Region,"Research and Development in the Physical, Engineering, and Life Sciences",small,35,264,166,98,212,198,14
2022,2,Riyadh Region,"Research and Development in the Physical, Engineering, and Life Sciences",micro,77,81,47,34,77,71,6
2022,2,Riyadh Region,"Research and Development in the Physical, Engineering, and Life Sciences",medium,5,289,173,116,239,230,9
2022,2,Qassim Region,"Research and Development in the Physical, Engineering, and Life Sciences",micro,4,1,0,1,6,6,0
2022,2,Al Madinah Region,"Research and Development in the Physical, Engineering, and Life Sciences",micro,10,10,5,5,11,10,1
2022,2,Tabuk Region,"Research and Development in the Physical, Engineering, and Life Sciences",small,1,1,1,0,6,6,0
2022,2,Tabuk Region,"Research and Development in the Physical, Engineering, and Life Sciences",micro,1,0,0,0,1,1,0
2022,2,Jazan Region,"Research and Development in the Physical, Engineering, and Life Sciences",small,1,5,4,1,1,1,0
2022,2,Jazan Region,"Research and Development in the Physical, Engineering, and Life Sciences",micro,2,3,0,3,2,2,0
2022,2,Hail Region,"Research and Development in the Physical, Engineering, and Life Sciences",micro,1,3,0,3,0,0,0
2022,2,Aseer Region,"Research and Development in the Physical, Engineering, and Life Sciences",micro,4,7,0,7,3,3,0
2022,2,Makkah Region,"Research and Development in the Physical, Engineering, and Life Sciences",small,9,55,27,28,85,84,1
2022,2,Makkah Region,"Research and Development in the Physical, Engineering, and Life Sciences",micro,44,42,14,28,60,55,5
2022,2,Makkah Region,"Research and Development in the Physical, Engineering, and Life Sciences",medium,4,307,302,5,180,175,5
2022,2,Eastern Province,Undifferentiated Goods-Producing Activities of Private Households for Own Use,small,1,0,0,0,12,12,0
2022,2,Eastern Province,Undifferentiated Goods-Producing Activities of Private Households for Own Use,micro,2,0,0,0,2,2,0
2022,2,Riyadh Region,Undifferentiated Goods-Producing Activities of Private Households for Own Use,small,1,1,0,1,6,6,0
2022,2,Riyadh Region,Undifferentiated Goods-Producing Activities of Private Households for Own Use,micro,2,0,0,0,2,2,0
2022,2,Qassim Region,Undifferentiated Goods-Producing Activities of Private Households for Own Use,micro,2,0,0,0,3,3,0
2022,2,Makkah Region,Undifferentiated Goods-Producing Activities of Private Households for Own Use,micro,1,0,0,0,1,0,1
2022,2,Eastern Province,"Other Professional, Scientific, and Technical Activities",small,32,136,59,77,209,191,18
2022,2,Eastern Province,"Other Professional, Scientific, and Technical Activities",large,1,276,234,42,355,353,2
2022,2,Eastern Province,"Other Professional, Scientific, and Technical Activities",micro,190,156,74,82,245,207,38
2022,2,Al Bahah Region,"Other Professional, Scientific, and Technical Activities",micro,11,3,2,1,18,16,2
2022,2,Al Jawf Region,"Other Professional, Scientific, and Technical Activities",small,3,3,2,1,26,26,0
2022,2,Al Jawf Region,"Other Professional, Scientific, and Technical Activities",micro,16,5,4,1,27,25,2
2022,2,Northern Borders Region,"Other Professional, Scientific, and Technical Activities",micro,10,1,1,0,20,16,4
2022,2,Riyadh Region,"Other Professional, Scientific, and Technical Activities",small,122,683,304,379,881,769,112
2022,2,Riyadh Region,"Other Professional, Scientific, and Technical Activities",large,5,784,585,199,891,882,9
2022,2,Riyadh Region,"Other Professional, Scientific, and Technical Activities",micro,513,327,126,201,822,698,124
2022,2,Riyadh Region,"Other Professional, Scientific, and Technical Activities",medium,9,610,352,258,503,480,23
2022,2,Qassim Region,"Other Professional, Scientific, and Technical Activities",small,8,56,37,19,147,147,0
2022,2,Qassim Region,"Other Professional, Scientific, and Technical Activities",micro,40,18,13,5,69,61,8
2022,2,Al Madinah Region,"Other Professional, Scientific, and Technical Activities",small,8,28,17,11,64,52,12
2022,2,Al Madinah Region,"Other Professional, Scientific, and Technical Activities",micro,87,37,15,22,149,125,24
2022,2,Tabuk Region,"Other Professional, Scientific, and Technical Activities",micro,32,6,3,3,69,67,2
2022,2,Jazan Region,"Other Professional, Scientific, and Technical Activities",small,2,14,1,13,5,5,0
2022,2,Jazan Region,"Other Professional, Scientific, and Technical Activities",micro,36,9,3,6,56,53,3
2022,2,Hail Region,"Other Professional, Scientific, and Technical Activities",small,1,2,0,2,5,5,0
2022,2,Hail Region,"Other Professional, Scientific, and Technical Activities",micro,22,3,0,3,38,33,5
2022,2,Aseer Region,"Other Professional, Scientific, and Technical Activities",small,7,23,9,14,43,31,12
2022,2,Aseer Region,"Other Professional, Scientific, and Technical Activities",micro,46,12,6,6,91,86,5
2022,2,Aseer Region,"Other Professional, Scientific, and Technical Activities",medium,1,21,20,1,67,67,0
2022,2,Makkah Region,"Other Professional, Scientific, and Technical Activities",small,72,322,162,160,623,576,47
2022,2,Makkah Region,"Other Professional, Scientific, and Technical Activities",micro,408,220,70,150,714,600,114
2022,2,Makkah Region,"Other Professional, Scientific, and Technical Activities",medium,5,162,131,31,176,175,1
2022,2,Najran Region,"Other Professional, Scientific, and Technical Activities",micro,27,1,1,0,59,56,3
2022,2,Eastern Province,Activities Auxiliary to Financial Services and Insurance Activities,small,27,304,192,112,140,138,2
2022,2,Eastern Province,Activities Auxiliary to Financial Services and Insurance Activities,large,1,218,97,121,45,41,4
2022,2,Eastern Province,Activities Auxiliary to Financial Services and Insurance Activities,micro,38,32,27,5,53,47,6
2022,2,Eastern Province,Activities Auxiliary to Financial Services and Insurance Activities,medium,3,211,102,109,70,64,6
2022,2,Al Jawf Region,Activities Auxiliary to Financial Services and Insurance Activities,micro,2,0,0,0,4,4,0
2022,2,Riyadh Region,Activities Auxiliary to Financial Services and Insurance Activities,small,141,1866,1160,706,788,752,36
2022,2,Riyadh Region,Activities Auxiliary to Financial Services and Insurance Activities,large,13,29331,23382,5949,1846,1807,39
2022,2,Riyadh Region,Activities Auxiliary to Financial Services and Insurance Activities,micro,165,234,142,92,152,149,3
2022,2,Riyadh Region,Activities Auxiliary to Financial Services and Insurance Activities,medium,38,4075,2871,1204,862,810,52
2022,2,Qassim Region,Activities Auxiliary to Financial Services and Insurance Activities,small,1,0,0,0,12,12,0
2022,2,Qassim Region,Activities Auxiliary to Financial Services and Insurance Activities,micro,5,5,2,3,3,3,0
2022,2,Al Madinah Region,Activities Auxiliary to Financial Services and Insurance Activities,small,2,11,8,3,4,4,0
2022,2,Al Madinah Region,Activities Auxiliary to Financial Services and Insurance Activities,micro,15,33,31,2,19,19,0
2022,2,Al Madinah Region,Activities Auxiliary to Financial Services and Insurance Activities,medium,1,21,13,8,85,85,0
2022,2,Tabuk Region,Activities Auxiliary to Financial Services and Insurance Activities,micro,2,0,0,0,4,4,0
2022,2,Jazan Region,Activities Auxiliary to Financial Services and Insurance Activities,micro,1,0,0,0,2,2,0
2022,2,Aseer Region,Activities Auxiliary to Financial Services and Insurance Activities,micro,5,1,1,0,5,5,0
2022,2,Makkah Region,Activities Auxiliary to Financial Services and Insurance Activities,small,49,480,275,205,272,261,11
2022,2,Makkah Region,Activities Auxiliary to Financial Services and Insurance Activities,micro,64,87,56,31,79,77,2
2022,2,Makkah Region,Activities Auxiliary to Financial Services and Insurance Activities,medium,13,915,586,329,261,251,10
2022,2,Najran Region,Activities Auxiliary to Financial Services and Insurance Activities,small,1,21,20,1,11,11,0
2022,2,Najran Region,Activities Auxiliary to Financial Services and Insurance Activities,micro,2,0,0,0,3,3,0
2022,2,Eastern Province,Legal and Accounting Activities,small,96,669,413,256,451,441,10
2022,2,Eastern Province,Legal and Accounting Activities,micro,247,330,202,128,255,248,7
2022,2,Eastern Province,Legal and Accounting Activities,medium,8,414,216,198,440,426,14
2022,2,Al Bahah Region,Legal and Accounting Activities,micro,11,18,8,10,16,16,0
2022,2,Al Jawf Region,Legal and Accounting Activities,small,7,32,21,11,10,10,0
2022,2,Al Jawf Region,Legal and Accounting Activities,micro,25,34,24,10,22,22,0
2022,2,Northern Borders Region,Legal and Accounting Activities,micro,6,8,4,4,5,5,0
2022,2,Riyadh Region,Legal and Accounting Activities,small,428,3218,1959,1259,2434,2342,92
2022,2,Riyadh Region,Legal and Accounting Activities,large,1,428,241,187,297,283,14
2022,2,Riyadh Region,Legal and Accounting Activities,micro,1352,1314,850,464,1835,1805,30
2022,2,Riyadh Region,Legal and Accounting Activities,medium,30,1230,703,527,1521,1459,62
2022,2,Qassim Region,Legal and Accounting Activities,small,14,83,45,38,30,30,0
2022,2,Qassim Region,Legal and Accounting Activities,micro,77,91,49,42,61,60,1
2022,2,Al Madinah Region,Legal and Accounting Activities,small,25,184,106,78,98,95,3
2022,2,Al Madinah Region,Legal and Accounting Activities,micro,81,105,75,30,79,76,3
2022,2,Tabuk Region,Legal and Accounting Activities,small,3,17,9,8,4,4,0
2022,2,Tabuk Region,Legal and Accounting Activities,micro,15,18,4,14,11,11,0
2022,2,Jazan Region,Legal and Accounting Activities,small,5,48,32,16,8,8,0
2022,2,Jazan Region,Legal and Accounting Activities,micro,28,28,20,8,26,26,0
2022,2,Hail Region,Legal and Accounting Activities,small,1,7,7,0,9,9,0
2022,2,Hail Region,Legal and Accounting Activities,micro,29,35,24,11,29,29,0
2022,2,Aseer Region,Legal and Accounting Activities,small,5,34,28,6,61,61,0
2022,2,Aseer Region,Legal and Accounting Activities,micro,58,63,50,13,70,69,1
2022,2,Aseer Region,Legal and Accounting Activities,medium,2,77,43,34,82,82,0
2022,2,Makkah Region,Legal and Accounting Activities,small,244,1816,1105,711,1170,1107,63
2022,2,Makkah Region,Legal and Accounting Activities,micro,650,847,546,301,685,658,27
2022,2,Makkah Region,Legal and Accounting Activities,medium,11,556,377,179,698,679,19
2022,2,Najran Region,Legal and Accounting Activities,small,1,9,8,1,18,18,0
2022,2,Najran Region,Legal and Accounting Activities,micro,34,6,4,2,63,62,1
2022,2,Eastern Province,Real Estate Activities,small,222,1194,754,440,1946,1925,21
2022,2,Eastern Province,Real Estate Activities,large,3,359,99,260,580,570,10
2022,2,Eastern Province,Real Estate Activities,micro,622,474,281,193,882,873,9
2022,2,Eastern Province,Real Estate Activities,medium,19,765,553,212,1185,1176,9
2022,2,Al Bahah Region,Real Estate Activities,small,5,28,24,4,47,47,0
2022,2,Al Bahah Region,Real Estate Activities,micro,20,14,8,6,32,32,0
2022,2,Al Jawf Region,Real Estate Activities,small,7,40,26,14,65,64,1
2022,2,Al Jawf Region,Real Estate Activities,micro,47,30,22,8,71,71,0
2022,2,Al Jawf Region,Real Estate Activities,medium,1,20,11,9,50,49,1
2022,2,Northern Borders Region,Real Estate Activities,small,6,36,24,12,78,78,0
2022,2,Northern Borders Region,Real Estate Activities,micro,41,11,9,2,74,74,0
2022,2,Riyadh Region,Real Estate Activities,small,719,4528,2737,1791,6424,6287,137
2022,2,Riyadh Region,Real Estate Activities,large,13,2685,1841,844,5236,4180,1056
2022,2,Riyadh Region,Real Estate Activities,micro,2106,1793,1088,705,2806,2769,37
2022,2,Riyadh Region,Real Estate Activities,medium,85,3751,1969,1782,4215,4157,58
2022,2,Qassim Region,Real Estate Activities,small,32,127,76,51,201,199,2
2022,2,Qassim Region,Real Estate Activities,large,1,129,77,52,294,294,0
2022,2,Qassim Region,Real Estate Activities,micro,184,102,72,30,290,287,3
2022,2,Qassim Region,Real Estate Activities,medium,7,249,164,85,617,617,0
2022,2,Al Madinah Region,Real Estate Activities,small,48,194,131,63,478,473,5
2022,2,Al Madinah Region,Real Estate Activities,large,1,171,154,17,201,201,0
2022,2,Al Madinah Region,Real Estate Activities,micro,269,142,75,67,416,416,0
2022,2,Al Madinah Region,Real Estate Activities,medium,3,71,44,27,301,293,8
2022,2,Tabuk Region,Real Estate Activities,small,11,39,30,9,109,109,0
2022,2,Tabuk Region,Real Estate Activities,micro,105,44,26,18,165,165,0
2022,2,Jazan Region,Real Estate Activities,small,21,56,25,31,185,185,0
2022,2,Jazan Region,Real Estate Activities,micro,135,56,31,25,226,224,2
2022,2,Jazan Region,Real Estate Activities,medium,4,190,41,149,196,196,0
2022,2,Hail Region,Real Estate Activities,small,10,30,18,12,75,75,0
2022,2,Hail Region,Real Estate Activities,micro,93,45,21,24,159,159,0
2022,2,Hail Region,Real Estate Activities,medium,1,0,0,0,134,134,0
2022,2,Aseer Region,Real Estate Activities,small,37,184,113,71,344,344,0
2022,2,Aseer Region,Real Estate Activities,micro,243,114,64,50,396,395,1
2022,2,Aseer Region,Real Estate Activities,medium,4,86,47,39,312,311,1
2022,2,Makkah Region,Real Estate Activities,small,461,2341,1399,942,4276,4179,97
2022,2,Makkah Region,Real Estate Activities,large,6,1464,1007,457,2602,2565,37
2022,2,Makkah Region,Real Estate Activities,micro,1651,1047,628,419,2533,2475,58
2022,2,Makkah Region,Real Estate Activities,medium,43,1700,1205,495,2784,2717,67
2022,2,Najran Region,Real Estate Activities,small,5,25,15,10,39,39,0
2022,2,Najran Region,Real Estate Activities,micro,51,6,3,3,92,92,0
2022,2,Eastern Province,"Sports, Entertainment, and Recreation Activities",small,129,567,299,268,1012,902,110
2022,2,Eastern Province,"Sports, Entertainment, and Recreation Activities",large,1,22,11,11,291,272,19
2022,2,Eastern Province,"Sports, Entertainment, and Recreation Activities",micro,286,275,104,171,430,383,47
2022,2,Eastern Province,"Sports, Entertainment, and Recreation Activities",medium,9,229,97,132,559,556,3
2022,2,Al Bahah Region,"Sports, Entertainment, and Recreation Activities",small,5,20,15,5,33,32,1
2022,2,Al Bahah Region,"Sports, Entertainment, and Recreation Activities",micro,25,16,9,7,46,42,4
2022,2,Al Jawf Region,"Sports, Entertainment, and Recreation Activities",small,9,55,41,14,62,58,4
2022,2,Al Jawf Region,"Sports, Entertainment, and Recreation Activities",micro,41,18,12,6,73,66,7
2022,2,Northern Borders Region,"Sports, Entertainment, and Recreation Activities",small,10,36,16,20,72,63,9
2022,2,Northern Borders Region,"Sports, Entertainment, and Recreation Activities",micro,37,19,10,9,92,81,11
2022,2,Riyadh Region,"Sports, Entertainment, and Recreation Activities",small,258,1459,596,863,2446,2096,350
2022,2,Riyadh Region,"Sports, Entertainment, and Recreation Activities",large,5,1574,966,608,1993,1740,253
2022,2,Riyadh Region,"Sports, Entertainment, and Recreation Activities",micro,645,504,201,303,994,901,93
2022,2,Riyadh Region,"Sports, Entertainment, and Recreation Activities",medium,26,1155,551,604,1720,1523,197
2022,2,Qassim Region,"Sports, Entertainment, and Recreation Activities",small,39,243,122,121,360,332,28
2022,2,Qassim Region,"Sports, Entertainment, and Recreation Activities",micro,75,67,20,47,127,109,18
2022,2,Qassim Region,"Sports, Entertainment, and Recreation Activities",medium,3,75,37,38,251,251,0
2022,2,Al Madinah Region,"Sports, Entertainment, and Recreation Activities",small,27,202,76,126,247,228,19
2022,2,Al Madinah Region,"Sports, Entertainment, and Recreation Activities",micro,93,67,28,39,163,141,22
2022,2,Al Madinah Region,"Sports, Entertainment, and Recreation Activities",medium,2,80,48,32,72,63,9
2022,2,Tabuk Region,"Sports, Entertainment, and Recreation Activities",small,12,42,10,32,86,74,12
2022,2,Tabuk Region,"Sports, Entertainment, and Recreation Activities",micro,74,51,28,23,127,117,10
2022,2,Tabuk Region,"Sports, Entertainment, and Recreation Activities",medium,1,40,34,6,22,22,0
2022,2,Jazan Region,"Sports, Entertainment, and Recreation Activities",small,7,18,12,6,44,39,5
2022,2,Jazan Region,"Sports, Entertainment, and Recreation Activities",micro,67,38,20,18,123,109,14
2022,2,Jazan Region,"Sports, Entertainment, and Recreation Activities",medium,2,46,14,32,125,125,0
2022,2,Hail Region,"Sports, Entertainment, and Recreation Activities",small,23,86,56,30,226,224,2
2022,2,Hail Region,"Sports, Entertainment, and Recreation Activities",micro,52,30,18,12,94,82,12
2022,2,Hail Region,"Sports, Entertainment, and Recreation Activities",medium,1,13,2,11,46,46,0
2022,2,Aseer Region,"Sports, Entertainment, and Recreation Activities",small,50,254,102,152,452,405,47
2022,2,Aseer Region,"Sports, Entertainment, and Recreation Activities",micro,130,85,44,41,239,218,21
2022,2,Aseer Region,"Sports, Entertainment, and Recreation Activities",medium,1,10,6,4,86,86,0
2022,2,Makkah Region,"Sports, Entertainment, and Recreation Activities",small,175,915,349,566,1447,1250,197
2022,2,Makkah Region,"Sports, Entertainment, and Recreation Activities",micro,516,364,156,208,805,737,68
2022,2,Makkah Region,"Sports, Entertainment, and Recreation Activities",medium,22,934,450,484,1033,913,120
2022,2,Najran Region,"Sports, Entertainment, and Recreation Activities",small,17,75,43,32,129,122,7
2022,2,Najran Region,"Sports, Entertainment, and Recreation Activities",micro,27,17,8,9,61,57,4
2022,2,Eastern Province,Veterinary Activities,small,8,15,8,7,51,49,2
2022,2,Eastern Province,Veterinary Activities,micro,39,32,18,14,67,62,5
2022,2,Eastern Province,Veterinary Activities,medium,2,44,22,22,61,57,4
2022,2,Al Bahah Region,Veterinary Activities,micro,1,0,0,0,2,2,0
2022,2,Al Jawf Region,Veterinary Activities,micro,2,0,0,0,3,3,0
2022,2,Northern Borders Region,Veterinary Activities,micro,6,2,1,1,14,14,0
2022,2,Riyadh Region,Veterinary Activities,small,25,96,50,46,238,223,15
2022,2,Riyadh Region,Veterinary Activities,micro,66,41,18,23,113,111,2
2022,2,Riyadh Region,Veterinary Activities,medium,5,150,68,82,327,297,30
2022,2,Qassim Region,Veterinary Activities,small,4,10,7,3,20,20,0
2022,2,Qassim Region,Veterinary Activities,micro,12,1,0,1,23,23,0
2022,2,Qassim Region,Veterinary Activities,medium,1,23,23,0,41,41,0
2022,2,Al Madinah Region,Veterinary Activities,small,4,8,4,4,23,20,3
2022,2,Al Madinah Region,Veterinary Activities,micro,18,3,1,2,36,32,4
2022,2,Tabuk Region,Veterinary Activities,small,1,5,0,5,9,9,0
2022,2,Tabuk Region,Veterinary Activities,micro,6,1,1,0,9,9,0
2022,2,Jazan Region,Veterinary Activities,micro,7,3,3,0,20,20,0
2022,2,Hail Region,Veterinary Activities,micro,7,1,0,1,13,13,0
2022,2,Aseer Region,Veterinary Activities,small,3,33,8,25,16,15,1
2022,2,Aseer Region,Veterinary Activities,micro,22,6,4,2,39,39,0
2022,2,Makkah Region,Veterinary Activities,small,14,60,13,47,136,123,13
2022,2,Makkah Region,Veterinary Activities,micro,51,26,11,15,97,92,5
2022,2,Makkah Region,Veterinary Activities,medium,2,40,18,22,74,61,13
2022,2,Najran Region,Veterinary Activities,micro,10,0,0,0,26,26,0
2022,2,Eastern Province,Rental and Leasing Activities,small,312,948,578,370,3455,3444,11
2022,2,Eastern Province,Rental and Leasing Activities,large,8,1020,811,209,2571,2569,2
2022,2,Eastern Province,Rental and Leasing Activities,micro,2035,411,220,191,4276,4271,5
2022,2,Eastern Province,Rental and Leasing Activities,medium,37,987,783,204,2880,2877,3
2022,2,Al Bahah Region,Rental and Leasing Activities,small,6,9,3,6,52,52,0
2022,2,Al Bahah Region,Rental and Leasing Activities,micro,140,16,12,4,279,277,2
2022,2,Al Jawf Region,Rental and Leasing Activities,small,29,26,20,6,202,201,1
2022,2,Al Jawf Region,Rental and Leasing Activities,micro,602,51,37,14,1224,1217,7
2022,2,Northern Borders Region,Rental and Leasing Activities,small,7,31,18,13,61,61,0
2022,2,Northern Borders Region,Rental and Leasing Activities,micro,229,24,18,6,491,487,4
2022,2,Riyadh Region,Rental and Leasing Activities,small,1297,1477,843,634,10537,10478,59
2022,2,Riyadh Region,Rental and Leasing Activities,large,11,2439,2048,391,4167,4163,4
2022,2,Riyadh Region,Rental and Leasing Activities,micro,54145,3686,1812,1874,135472,134879,593
2022,2,Riyadh Region,Rental and Leasing Activities,medium,44,956,696,260,3591,3582,9
2022,2,Qassim Region,Rental and Leasing Activities,small,74,120,79,41,629,626,3
2022,2,Qassim Region,Rental and Leasing Activities,large,2,124,111,13,528,528,0
2022,2,Qassim Region,Rental and Leasing Activities,micro,1239,191,112,79,2830,2822,8
2022,2,Qassim Region,Rental and Leasing Activities,medium,4,68,58,10,306,306,0
2022,2,Al Madinah Region,Rental and Leasing Activities,small,91,197,109,88,844,838,6
2022,2,Al Madinah Region,Rental and Leasing Activities,large,1,85,64,21,268,268,0
2022,2,Al Madinah Region,Rental and Leasing Activities,micro,1015,128,73,55,2148,2135,13
2022,2,Al Madinah Region,Rental and Leasing Activities,medium,6,193,160,33,576,576,0
2022,2,Tabuk Region,Rental and Leasing Activities,small,11,36,25,11,79,79,0
2022,2,Tabuk Region,Rental and Leasing Activities,micro,462,54,30,24,871,869,2
2022,2,Tabuk Region,Rental and Leasing Activities,medium,1,65,65,0,134,134,0
2022,2,Jazan Region,Rental and Leasing Activities,small,30,44,30,14,298,282,16
2022,2,Jazan Region,Rental and Leasing Activities,micro,1203,94,55,39,2801,2791,10
2022,2,Jazan Region,Rental and Leasing Activities,medium,1,18,12,6,57,57,0
2022,2,Hail Region,Rental and Leasing Activities,small,43,51,38,13,311,308,3
2022,2,Hail Region,Rental and Leasing Activities,micro,925,92,45,47,2256,2244,12
2022,2,Hail Region,Rental and Leasing Activities,medium,1,9,9,0,53,53,0
2022,2,Aseer Region,Rental and Leasing Activities,small,78,122,85,37,599,598,1
2022,2,Aseer Region,Rental and Leasing Activities,micro,1405,189,122,67,2721,2711,10
2022,2,Aseer Region,Rental and Leasing Activities,medium,2,74,55,19,76,76,0
2022,2,Makkah Region,Rental and Leasing Activities,small,256,658,409,249,2441,2403,38
2022,2,Makkah Region,Rental and Leasing Activities,large,4,982,872,110,1559,1557,2
2022,2,Makkah Region,Rental and Leasing Activities,micro,3340,446,263,183,7161,7078,83
2022,2,Makkah Region,Rental and Leasing Activities,medium,23,573,416,157,1504,1502,2
2022,2,Najran Region,Rental and Leasing Activities,small,62,52,28,24,519,512,7
2022,2,Najran Region,Rental and Leasing Activities,micro,1300,103,55,48,3120,3101,19
2022,2,Eastern Province,"Office Administrative, Office Support, and Other Business Support Activities",small,132,673,327,346,1090,1072,18
2022,2,Eastern Province,"Office Administrative, Office Support, and Other Business Support Activities",large,3,693,472,221,1238,1234,4
2022,2,Eastern Province,"Office Administrative, Office Support, and Other Business Support Activities",micro,640,386,162,224,1032,1002,30
2022,2,Eastern Province,"Office Administrative, Office Support, and Other Business Support Activities",medium,18,794,541,253,994,981,13
2022,2,Al Bahah Region,"Office Administrative, Office Support, and Other Business Support Activities",small,6,22,19,3,41,41,0
2022,2,Al Bahah Region,"Office Administrative, Office Support, and Other Business Support Activities",micro,37,16,11,5,57,57,0
2022,2,Al Bahah Region,"Office Administrative, Office Support, and Other Business Support Activities",medium,1,53,25,28,174,174,0
2022,2,Al Jawf Region,"Office Administrative, Office Support, and Other Business Support Activities",small,3,4,2,2,41,41,0
2022,2,Al Jawf Region,"Office Administrative, Office Support, and Other Business Support Activities",micro,68,32,18,14,127,126,1
2022,2,Northern Borders Region,"Office Administrative, Office Support, and Other Business Support Activities",small,7,27,1,26,44,44,0
2022,2,Northern Borders Region,"Office Administrative, Office Support, and Other Business Support Activities",micro,36,10,7,3,71,71,0
2022,2,Riyadh Region,"Office Administrative, Office Support, and Other Business Support Activities",small,555,3186,1435,1751,4823,4582,241
2022,2,Riyadh Region,"Office Administrative, Office Support, and Other Business Support Activities",large,11,3762,2571,1191,3787,3597,190
2022,2,Riyadh Region,"Office Administrative, Office Support, and Other Business Support Activities",micro,1978,1224,595,629,3244,3112,132
2022,2,Riyadh Region,"Office Administrative, Office Support, and Other Business Support Activities",medium,42,1935,873,1062,2255,2123,132
2022,2,Qassim Region,"Office Administrative, Office Support, and Other Business Support Activities",small,20,52,29,23,182,172,10
2022,2,Qassim Region,"Office Administrative, Office Support, and Other Business Support Activities",micro,199,76,47,29,344,342,2
2022,2,Qassim Region,"Office Administrative, Office Support, and Other Business Support Activities",medium,3,40,6,34,189,188,1
2022,2,Al Madinah Region,"Office Administrative, Office Support, and Other Business Support Activities",small,33,126,52,74,255,246,9
2022,2,Al Madinah Region,"Office Administrative, Office Support, and Other Business Support Activities",micro,245,107,68,39,444,427,17
2022,2,Al Madinah Region,"Office Administrative, Office Support, and Other Business Support Activities",medium,5,156,114,42,402,397,5
2022,2,Tabuk Region,"Office Administrative, Office Support, and Other Business Support Activities",small,7,21,15,6,60,59,1
2022,2,Tabuk Region,"Office Administrative, Office Support, and Other Business Support Activities",micro,103,38,8,30,165,163,2
2022,2,Jazan Region,"Office Administrative, Office Support, and Other Business Support Activities",small,4,18,11,7,27,27,0
2022,2,Jazan Region,"Office Administrative, Office Support, and Other Business Support Activities",micro,93,26,13,13,179,178,1
2022,2,Hail Region,"Office Administrative, Office Support, and Other Business Support Activities",small,9,26,16,10,46,46,0
2022,2,Hail Region,"Office Administrative, Office Support, and Other Business Support Activities",micro,150,34,16,18,274,268,6
2022,2,Hail Region,"Office Administrative, Office Support, and Other Business Support Activities",medium,1,1,0,1,54,54,0
2022,2,Aseer Region,"Office Administrative, Office Support, and Other Business Support Activities",small,23,64,25,39,185,185,0
2022,2,Aseer Region,"Office Administrative, Office Support, and Other Business Support Activities",micro,243,87,51,36,404,398,6
2022,2,Aseer Region,"Office Administrative, Office Support, and Other Business Support Activities",medium,1,28,18,10,32,32,0
2022,2,Makkah Region,"Office Administrative, Office Support, and Other Business Support Activities",small,269,1365,648,717,2255,2116,139
2022,2,Makkah Region,"Office Administrative, Office Support, and Other Business Support Activities",large,5,2908,1882,1026,1194,1143,51
2022,2,Makkah Region,"Office Administrative, Office Support, and Other Business Support Activities",micro,1298,623,313,310,2372,2259,113
2022,2,Makkah Region,"Office Administrative, Office Support, and Other Business Support Activities",medium,27,1002,536,466,1575,1506,69
2022,2,Najran Region,"Office Administrative, Office Support, and Other Business Support Activities",small,3,2,1,1,17,15,2
2022,2,Najran Region,"Office Administrative, Office Support, and Other Business Support Activities",micro,87,27,15,12,158,157,1
2022,2,Eastern Province,Other Mining and Quarrying Activities,small,47,169,78,91,585,581,4
2022,2,Eastern Province,Other Mining and Quarrying Activities,large,3,1048,912,136,2382,2379,3
2022,2,Eastern Province,Other Mining and Quarrying Activities,micro,80,52,34,18,142,140,2
2022,2,Eastern Province,Other Mining and Quarrying Activities,medium,16,381,301,80,1178,1177,1
2022,2,Al Bahah Region,Other Mining and Quarrying Activities,small,3,16,5,11,64,64,0
2022,2,Al Bahah Region,Other Mining and Quarrying Activities,micro,1,2,1,1,3,3,0
2022,2,Al Bahah Region,Other Mining and Quarrying Activities,medium,1,14,8,6,36,36,0
2022,2,Al Jawf Region,Other Mining and Quarrying Activities,small,2,14,11,3,76,76,0
2022,2,Al Jawf Region,Other Mining and Quarrying Activities,micro,12,3,3,0,16,16,0
2022,2,Northern Borders Region,Other Mining and Quarrying Activities,small,5,12,9,3,68,68,0
2022,2,Northern Borders Region,Other Mining and Quarrying Activities,micro,6,3,2,1,7,7,0
2022,2,Northern Borders Region,Other Mining and Quarrying Activities,medium,1,13,4,9,40,40,0
2022,2,Riyadh Region,Other Mining and Quarrying Activities,small,152,631,351,280,1919,1914,5
2022,2,Riyadh Region,Other Mining and Quarrying Activities,large,6,637,378,259,2257,2256,1
2022,2,Riyadh Region,Other Mining and Quarrying Activities,micro,228,155,86,69,375,371,4
2022,2,Riyadh Region,Other Mining and Quarrying Activities,medium,27,731,417,314,2088,2088,0
2022,2,Qassim Region,Other Mining and Quarrying Activities,small,8,52,27,25,134,134,0
2022,2,Qassim Region,Other Mining and Quarrying Activities,micro,26,15,7,8,47,47,0
2022,2,Qassim Region,Other Mining and Quarrying Activities,medium,3,59,33,26,220,220,0
2022,2,Al Madinah Region,Other Mining and Quarrying Activities,small,25,136,101,35,375,375,0
2022,2,Al Madinah Region,Other Mining and Quarrying Activities,large,2,315,302,13,457,457,0
2022,2,Al Madinah Region,Other Mining and Quarrying Activities,micro,41,25,16,9,70,70,0
2022,2,Al Madinah Region,Other Mining and Quarrying Activities,medium,1,25,25,0,47,47,0
2022,2,Tabuk Region,Other Mining and Quarrying Activities,small,6,35,23,12,49,49,0
2022,2,Tabuk Region,Other Mining and Quarrying Activities,micro,8,5,5,0,9,9,0
2022,2,Tabuk Region,Other Mining and Quarrying Activities,medium,1,27,15,12,116,115,1
2022,2,Jazan Region,Other Mining and Quarrying Activities,small,16,80,54,26,195,195,0
2022,2,Jazan Region,Other Mining and Quarrying Activities,micro,21,12,6,6,35,35,0
2022,2,Jazan Region,Other Mining and Quarrying Activities,medium,2,13,4,9,145,145,0
2022,2,Hail Region,Other Mining and Quarrying Activities,small,1,0,0,0,6,6,0
2022,2,Hail Region,Other Mining and Quarrying Activities,micro,17,5,2,3,24,24,0
2022,2,Aseer Region,Other Mining and Quarrying Activities,small,23,91,75,16,255,254,1
2022,2,Aseer Region,Other Mining and Quarrying Activities,micro,45,30,22,8,83,83,0
2022,2,Makkah Region,Other Mining and Quarrying Activities,small,61,225,121,104,682,680,2
2022,2,Makkah Region,Other Mining and Quarrying Activities,large,4,1278,1194,84,1207,1207,0
2022,2,Makkah Region,Other Mining and Quarrying Activities,micro,112,72,47,25,185,184,1
2022,2,Makkah Region,Other Mining and Quarrying Activities,medium,9,219,136,83,673,671,2
2022,2,Najran Region,Other Mining and Quarrying Activities,small,8,25,9,16,93,93,0
2022,2,Najran Region,Other Mining and Quarrying Activities,micro,11,9,5,4,20,20,0
2022,2,Najran Region,Other Mining and Quarrying Activities,medium,1,16,13,3,46,46,0
2022,2,Eastern Province,"Creative, Arts, and Entertainment Activities",small,4,13,7,6,39,39,0
2022,2,Eastern Province,"Creative, Arts, and Entertainment Activities",micro,33,21,9,12,44,39,5
2022,2,Al Bahah Region,"Creative, Arts, and Entertainment Activities",micro,2,1,1,0,4,4,0
2022,2,Al Jawf Region,"Creative, Arts, and Entertainment Activities",micro,2,1,0,1,2,2,0
2022,2,Riyadh Region,"Creative, Arts, and Entertainment Activities",small,23,121,41,80,156,143,13
2022,2,Riyadh Region,"Creative, Arts, and Entertainment Activities",large,2,158,113,45,570,565,5
2022,2,Riyadh Region,"Creative, Arts, and Entertainment Activities",micro,102,62,30,32,147,136,11
2022,2,Riyadh Region,"Creative, Arts, and Entertainment Activities",medium,2,159,120,39,146,143,3
2022,2,Qassim Region,"Creative, Arts, and Entertainment Activities",micro,4,1,1,0,10,10,0
2022,2,Al Madinah Region,"Creative, Arts, and Entertainment Activities",small,1,0,0,0,9,9,0
2022,2,Al Madinah Region,"Creative, Arts, and Entertainment Activities",micro,17,5,2,3,25,24,1
2022,2,Tabuk Region,"Creative, Arts, and Entertainment Activities",micro,2,0,0,0,4,4,0
2022,2,Jazan Region,"Creative, Arts, and Entertainment Activities",micro,1,1,1,0,2,2,0
2022,2,Hail Region,"Creative, Arts, and Entertainment Activities",micro,1,0,0,0,1,1,0
2022,2,Aseer Region,"Creative, Arts, and Entertainment Activities",small,2,24,3,21,10,10,0
2022,2,Aseer Region,"Creative, Arts, and Entertainment Activities",micro,11,4,3,1,28,28,0
2022,2,Makkah Region,"Creative, Arts, and Entertainment Activities",small,11,39,21,18,75,73,2
2022,2,Makkah Region,"Creative, Arts, and Entertainment Activities",micro,94,65,20,45,145,131,14
2022,2,Makkah Region,"Creative, Arts, and Entertainment Activities",medium,1,1,1,0,52,52,0
2022,2,Najran Region,"Creative, Arts, and Entertainment Activities",micro,3,1,1,0,4,4,0
2022,2,Eastern Province,Accommodation,small,222,1086,606,480,2118,2097,21
2022,2,Eastern Province,Accommodation,large,2,176,130,46,469,432,37
2022,2,Eastern Province,Accommodation,micro,298,261,156,105,490,485,5
2022,2,Eastern Province,Accommodation,medium,35,1312,723,589,2106,2042,64
2022,2,Al Bahah Region,Accommodation,small,23,81,48,33,197,197,0
2022,2,Al Bahah Region,Accommodation,micro,65,45,35,10,103,103,0
2022,2,Al Bahah Region,Accommodation,medium,1,26,12,14,44,44,0
2022,2,Al Jawf Region,Accommodation,small,11,20,12,8,70,70,0
2022,2,Al Jawf Region,Accommodation,micro,52,25,12,13,101,101,0
2022,2,Al Jawf Region,Accommodation,medium,1,17,8,9,47,47,0
2022,2,Northern Borders Region,Accommodation,small,10,32,16,16,87,87,0
2022,2,Northern Borders Region,Accommodation,micro,36,19,15,4,63,63,0
2022,2,Northern Borders Region,Accommodation,medium,1,18,13,5,37,37,0
2022,2,Riyadh Region,Accommodation,small,328,1707,881,826,3577,3543,34
2022,2,Riyadh Region,Accommodation,large,9,2103,1245,858,3307,3221,86
2022,2,Riyadh Region,Accommodation,micro,680,525,282,243,1244,1224,20
2022,2,Riyadh Region,Accommodation,medium,78,2913,1671,1242,4957,4874,83
2022,2,Qassim Region,Accommodation,small,56,264,179,85,472,471,1
2022,2,Qassim Region,Accommodation,large,1,0,0,0,351,350,1
2022,2,Qassim Region,Accommodation,micro,98,66,51,15,190,190,0
2022,2,Qassim Region,Accommodation,medium,4,100,53,47,175,175,0
2022,2,Al Madinah Region,Accommodation,small,149,885,644,241,1396,1386,10
2022,2,Al Madinah Region,Accommodation,large,4,524,372,152,774,764,10
2022,2,Al Madinah Region,Accommodation,micro,311,231,169,62,504,492,12
2022,2,Al Madinah Region,Accommodation,medium,33,1237,892,345,2083,2065,18
2022,2,Tabuk Region,Accommodation,small,38,239,133,106,315,314,1
2022,2,Tabuk Region,Accommodation,micro,88,78,51,27,146,146,0
2022,2,Tabuk Region,Accommodation,medium,4,155,91,64,342,330,12
2022,2,Jazan Region,Accommodation,small,43,153,87,66,420,411,9
2022,2,Jazan Region,Accommodation,micro,226,123,72,51,360,358,2
2022,2,Jazan Region,Accommodation,medium,5,199,72,127,269,229,40
2022,2,Hail Region,Accommodation,small,22,96,68,28,223,223,0
2022,2,Hail Region,Accommodation,micro,62,43,23,20,130,130,0
2022,2,Hail Region,Accommodation,medium,1,24,16,8,86,86,0
2022,2,Aseer Region,Accommodation,small,96,348,210,138,833,824,9
2022,2,Aseer Region,Accommodation,micro,365,247,145,102,630,627,3
2022,2,Aseer Region,Accommodation,medium,5,167,112,55,300,297,3
2022,2,Makkah Region,Accommodation,small,498,2248,1338,910,4690,4568,122
2022,2,Makkah Region,Accommodation,large,13,1976,1429,547,2728,2684,44
2022,2,Makkah Region,Accommodation,micro,1023,787,509,278,1690,1661,29
2022,2,Makkah Region,Accommodation,medium,80,3103,2209,894,5620,5503,117
2022,2,Najran Region,Accommodation,small,22,106,51,55,240,239,1
2022,2,Najran Region,Accommodation,micro,94,48,30,18,209,207,2
2022,2,Najran Region,Accommodation,medium,2,83,15,68,223,220,3
2022,2,Eastern Province,Public Administration and Defense; Compulsory Social Security,small,55,763,578,185,438,429,9
2022,2,Eastern Province,Public Administration and Defense; Compulsory Social Security,large,21,13717,11003,2714,5932,4317,1615
2022,2,Eastern Province,Public Administration and Defense; Compulsory Social Security,micro,127,110,76,34,187,184,3
2022,2,Eastern Province,Public Administration and Defense; Compulsory Social Security,medium,30,2409,2022,387,1302,1247,55
2022,2,Al Bahah Region,Public Administration and Defense; Compulsory Social Security,small,3,27,18,9,20,19,1
2022,2,Al Bahah Region,Public Administration and Defense; Compulsory Social Security,large,3,582,424,158,560,559,1
2022,2,Al Bahah Region,Public Administration and Defense; Compulsory Social Security,micro,11,7,7,0,23,23,0
2022,2,Al Bahah Region,Public Administration and Defense; Compulsory Social Security,medium,14,510,427,83,1131,1111,20
2022,2,Al Jawf Region,Public Administration and Defense; Compulsory Social Security,small,7,87,76,11,14,14,0
2022,2,Al Jawf Region,Public Administration and Defense; Compulsory Social Security,large,3,489,403,86,798,617,181
2022,2,Al Jawf Region,Public Administration and Defense; Compulsory Social Security,micro,17,6,3,3,23,22,1
2022,2,Al Jawf Region,Public Administration and Defense; Compulsory Social Security,medium,13,937,770,167,852,821,31
2022,2,Northern Borders Region,Public Administration and Defense; Compulsory Social Security,small,7,51,43,8,56,56,0
2022,2,Northern Borders Region,Public Administration and Defense; Compulsory Social Security,large,3,805,363,442,291,291,0
2022,2,Northern Borders Region,Public Administration and Defense; Compulsory Social Security,micro,8,13,10,3,4,4,0
2022,2,Northern Borders Region,Public Administration and Defense; Compulsory Social Security,medium,10,338,300,38,917,916,1
2022,2,Riyadh Region,Public Administration and Defense; Compulsory Social Security,small,186,3142,2400,742,838,780,58
2022,2,Riyadh Region,Public Administration and Defense; Compulsory Social Security,large,74,118244,98433,19811,9952,7101,2851
2022,2,Riyadh Region,Public Administration and Defense; Compulsory Social Security,micro,323,254,161,93,483,467,16
2022,2,Riyadh Region,Public Administration and Defense; Compulsory Social Security,medium,120,12898,10014,2884,1879,1815,64
2022,2,Qassim Region,Public Administration and Defense; Compulsory Social Security,small,9,116,84,32,45,45,0
2022,2,Qassim Region,Public Administration and Defense; Compulsory Social Security,large,12,2179,1562,617,3958,3952,6
2022,2,Qassim Region,Public Administration and Defense; Compulsory Social Security,micro,32,13,8,5,72,69,3
2022,2,Qassim Region,Public Administration and Defense; Compulsory Social Security,medium,20,546,426,120,1824,1816,8
2022,2,Al Madinah Region,Public Administration and Defense; Compulsory Social Security,small,18,236,212,24,81,80,1
2022,2,Al Madinah Region,Public Administration and Defense; Compulsory Social Security,large,3,523,455,68,1052,1052,0
2022,2,Al Madinah Region,Public Administration and Defense; Compulsory Social Security,micro,49,19,15,4,106,105,1
2022,2,Al Madinah Region,Public Administration and Defense; Compulsory Social Security,medium,12,423,386,37,990,990,0
2022,2,Tabuk Region,Public Administration and Defense; Compulsory Social Security,small,8,120,99,21,36,35,1
2022,2,Tabuk Region,Public Administration and Defense; Compulsory Social Security,large,1,316,180,136,0,0,0
2022,2,Tabuk Region,Public Administration and Defense; Compulsory Social Security,micro,20,6,5,1,52,51,1
2022,2,Tabuk Region,Public Administration and Defense; Compulsory Social Security,medium,11,745,564,181,498,498,0
2022,2,Jazan Region,Public Administration and Defense; Compulsory Social Security,small,13,164,159,5,107,103,4
2022,2,Jazan Region,Public Administration and Defense; Compulsory Social Security,large,3,1534,977,557,0,0,0
2022,2,Jazan Region,Public Administration and Defense; Compulsory Social Security,micro,40,12,9,3,107,107,0
2022,2,Jazan Region,Public Administration and Defense; Compulsory Social Security,medium,16,1186,1132,54,567,567,0
2022,2,Hail Region,Public Administration and Defense; Compulsory Social Security,small,5,87,70,17,11,11,0
2022,2,Hail Region,Public Administration and Defense; Compulsory Social Security,large,2,952,556,396,428,428,0
2022,2,Hail Region,Public Administration and Defense; Compulsory Social Security,micro,19,9,9,0,30,30,0
2022,2,Hail Region,Public Administration and Defense; Compulsory Social Security,medium,17,856,823,33,1855,1854,1
2022,2,Aseer Region,Public Administration and Defense; Compulsory Social Security,small,12,246,223,23,45,45,0
2022,2,Aseer Region,Public Administration and Defense; Compulsory Social Security,large,17,5685,4117,1568,6452,5877,575
2022,2,Aseer Region,Public Administration and Defense; Compulsory Social Security,micro,28,12,7,5,78,78,0
2022,2,Aseer Region,Public Administration and Defense; Compulsory Social Security,medium,32,2020,1523,497,3284,3283,1
2022,2,Makkah Region,Public Administration and Defense; Compulsory Social Security,small,92,848,654,194,568,534,34
2022,2,Makkah Region,Public Administration and Defense; Compulsory Social Security,large,25,20991,12525,8466,9362,5026,4336
2022,2,Makkah Region,Public Administration and Defense; Compulsory Social Security,micro,281,156,107,49,480,465,15
2022,2,Makkah Region,Public Administration and Defense; Compulsory Social Security,medium,41,3054,2458,596,2236,2195,41
2022,2,Najran Region,Public Administration and Defense; Compulsory Social Security,small,5,89,68,21,17,17,0
2022,2,Najran Region,Public Administration and Defense; Compulsory Social Security,large,6,1595,1363,232,1744,1147,597
2022,2,Najran Region,Public Administration and Defense; Compulsory Social Security,micro,32,15,15,0,50,50,0
2022,2,Najran Region,Public Administration and Defense; Compulsory Social Security,medium,15,1084,930,154,754,754,0
2022,2,Eastern Province,Telecommunications,small,34,159,101,58,258,252,6
2022,2,Eastern Province,Telecommunications,micro,91,48,28,20,144,144,0
2022,2,Eastern Province,Telecommunications,medium,3,94,78,16,154,154,0
2022,2,Al Bahah Region,Telecommunications,small,1,4,1,3,11,11,0
2022,2,Al Bahah Region,Telecommunications,micro,5,1,1,0,9,9,0
2022,2,Al Jawf Region,Telecommunications,small,1,1,1,0,6,6,0
2022,2,Al Jawf Region,Telecommunications,micro,16,1,0,1,33,33,0
2022,2,Northern Borders Region,Telecommunications,small,2,5,0,5,12,12,0
2022,2,Northern Borders Region,Telecommunications,micro,13,4,2,2,25,24,1
2022,2,Riyadh Region,Telecommunications,small,149,836,427,409,1640,1568,72
2022,2,Riyadh Region,Telecommunications,large,15,21273,16731,4542,3198,3131,67
2022,2,Riyadh Region,Telecommunications,micro,335,171,108,63,579,569,10
2022,2,Riyadh Region,Telecommunications,medium,33,2236,1591,645,1416,1381,35
2022,2,Qassim Region,Telecommunications,small,15,13,10,3,174,174,0
2022,2,Qassim Region,Telecommunications,micro,54,19,7,12,101,101,0
2022,2,Al Madinah Region,Telecommunications,small,3,18,7,11,6,6,0
2022,2,Al Madinah Region,Telecommunications,micro,38,10,4,6,61,59,2
2022,2,Tabuk Region,Telecommunications,micro,17,1,1,0,29,29,0
2022,2,Jazan Region,Telecommunications,small,1,2,2,0,7,7,0
2022,2,Jazan Region,Telecommunications,micro,24,8,5,3,36,36,0
2022,2,Hail Region,Telecommunications,small,1,5,0,5,4,4,0
2022,2,Hail Region,Telecommunications,micro,23,7,0,7,44,43,1
2022,2,Aseer Region,Telecommunications,small,4,6,3,3,36,36,0
2022,2,Aseer Region,Telecommunications,micro,46,10,7,3,84,83,1
2022,2,Makkah Region,Telecommunications,small,39,173,81,92,406,403,3
2022,2,Makkah Region,Telecommunications,micro,247,91,55,36,419,409,10
2022,2,Makkah Region,Telecommunications,medium,1,62,26,36,82,71,11
2022,2,Najran Region,Telecommunications,small,3,0,0,0,41,39,2
2022,2,Najran Region,Telecommunications,micro,20,7,4,3,30,30,0
2022,2,Eastern Province,Repair and Installation of Machinery and Equipment,small,244,907,623,284,2907,2901,6
2022,2,Eastern Province,Repair and Installation of Machinery and Equipment,large,18,3051,2501,550,8822,8803,19
2022,2,Eastern Province,Repair and Installation of Machinery and Equipment,micro,764,337,190,147,1583,1582,1
2022,2,Eastern Province,Repair and Installation of Machinery and Equipment,medium,58,1721,1367,354,4270,4267,3
2022,2,Al Bahah Region,Repair and Installation of Machinery and Equipment,small,1,1,1,0,11,11,0
2022,2,Al Bahah Region,Repair and Installation of Machinery and Equipment,micro,37,8,7,1,66,66,0
2022,2,Al Jawf Region,Repair and Installation of Machinery and Equipment,small,7,7,2,5,62,62,0
2022,2,Al Jawf Region,Repair and Installation of Machinery and Equipment,micro,49,6,3,3,97,97,0
2022,2,Northern Borders Region,Repair and Installation of Machinery and Equipment,small,3,18,14,4,5,5,0
2022,2,Northern Borders Region,Repair and Installation of Machinery and Equipment,micro,50,5,2,3,137,137,0
2022,2,Riyadh Region,Repair and Installation of Machinery and Equipment,small,245,943,533,410,2885,2875,10
2022,2,Riyadh Region,Repair and Installation of Machinery and Equipment,large,14,4543,4099,444,4335,4296,39
2022,2,Riyadh Region,Repair and Installation of Machinery and Equipment,micro,968,294,157,137,2156,2144,12
2022,2,Riyadh Region,Repair and Installation of Machinery and Equipment,medium,63,1934,1585,349,4553,4479,74
2022,2,Qassim Region,Repair and Installation of Machinery and Equipment,small,34,76,40,36,307,307,0
2022,2,Qassim Region,Repair and Installation of Machinery and Equipment,micro,206,29,21,8,456,456,0
2022,2,Qassim Region,Repair and Installation of Machinery and Equipment,medium,7,117,85,32,597,597,0
2022,2,Al Madinah Region,Repair and Installation of Machinery and Equipment,small,24,94,68,26,191,190,1
2022,2,Al Madinah Region,Repair and Installation of Machinery and Equipment,large,1,47,21,26,208,208,0
2022,2,Al Madinah Region,Repair and Installation of Machinery and Equipment,micro,233,49,32,17,471,468,3
2022,2,Al Madinah Region,Repair and Installation of Machinery and Equipment,medium,2,26,16,10,108,108,0
2022,2,Tabuk Region,Repair and Installation of Machinery and Equipment,small,1,1,0,1,11,11,0
2022,2,Tabuk Region,Repair and Installation of Machinery and Equipment,micro,111,18,13,5,240,238,2
2022,2,Tabuk Region,Repair and Installation of Machinery and Equipment,medium,1,31,31,0,22,22,0
2022,2,Jazan Region,Repair and Installation of Machinery and Equipment,small,14,13,9,4,103,103,0
2022,2,Jazan Region,Repair and Installation of Machinery and Equipment,micro,295,30,17,13,697,697,0
2022,2,Jazan Region,Repair and Installation of Machinery and Equipment,medium,1,0,0,0,64,64,0
2022,2,Hail Region,Repair and Installation of Machinery and Equipment,small,6,9,4,5,77,77,0
2022,2,Hail Region,Repair and Installation of Machinery and Equipment,micro,70,10,7,3,150,149,1
2022,2,Aseer Region,Repair and Installation of Machinery and Equipment,small,12,25,23,2,110,110,0
2022,2,Aseer Region,Repair and Installation of Machinery and Equipment,large,1,51,37,14,283,283,0
2022,2,Aseer Region,Repair and Installation of Machinery and Equipment,micro,176,31,21,10,412,410,2
2022,2,Aseer Region,Repair and Installation of Machinery and Equipment,medium,1,16,15,1,134,134,0
2022,2,Makkah Region,Repair and Installation of Machinery and Equipment,small,127,387,245,142,1414,1404,10
2022,2,Makkah Region,Repair and Installation of Machinery and Equipment,large,2,398,369,29,297,297,0
2022,2,Makkah Region,Repair and Installation of Machinery and Equipment,micro,849,209,109,100,1938,1933,5
2022,2,Makkah Region,Repair and Installation of Machinery and Equipment,medium,26,1132,914,218,1773,1763,10
2022,2,Najran Region,Repair and Installation of Machinery and Equipment,small,5,6,1,5,40,40,0
2022,2,Najran Region,Repair and Installation of Machinery and Equipment,micro,42,8,5,3,99,99,0
2022,2,Eastern Province,Repair of Computers and Personal and Household Goods,small,134,298,215,83,1380,1368,12
2022,2,Eastern Province,Repair of Computers and Personal and Household Goods,large,1,0,0,0,282,282,0
2022,2,Eastern Province,Repair of Computers and Personal and Household Goods,micro,867,221,124,97,1823,1820,3
2022,2,Eastern Province,Repair of Computers and Personal and Household Goods,medium,12,363,285,78,1083,1083,0
2022,2,Al Bahah Region,Repair of Computers and Personal and Household Goods,small,2,3,3,0,12,12,0
2022,2,Al Bahah Region,Repair of Computers and Personal and Household Goods,micro,52,17,13,4,101,101,0
2022,2,Al Jawf Region,Repair of Computers and Personal and Household Goods,small,12,8,7,1,175,175,0
2022,2,Al Jawf Region,Repair of Computers and Personal and Household Goods,micro,127,17,11,6,284,284,0
2022,2,Al Jawf Region,Repair of Computers and Personal and Household Goods,medium,1,0,0,0,85,85,0
2022,2,Northern Borders Region,Repair of Computers and Personal and Household Goods,small,2,1,1,0,12,12,0
2022,2,Northern Borders Region,Repair of Computers and Personal and Household Goods,micro,73,12,9,3,174,174,0
2022,2,Riyadh Region,Repair of Computers and Personal and Household Goods,small,447,462,239,223,6558,6527,31
2022,2,Riyadh Region,Repair of Computers and Personal and Household Goods,large,39,540,426,114,24955,24950,5
2022,2,Riyadh Region,Repair of Computers and Personal and Household Goods,micro,1877,337,179,158,4453,4426,27
2022,2,Riyadh Region,Repair of Computers and Personal and Household Goods,medium,158,116,55,61,19676,19577,99
2022,2,Qassim Region,Repair of Computers and Personal and Household Goods,small,210,93,64,29,3186,3174,12
2022,2,Qassim Region,Repair of Computers and Personal and Household Goods,large,6,0,0,0,5088,5088,0
2022,2,Qassim Region,Repair of Computers and Personal and Household Goods,micro,593,95,59,36,1430,1425,5
2022,2,Qassim Region,Repair of Computers and Personal and Household Goods,medium,45,6,3,3,4296,4292,4
2022,2,Al Madinah Region,Repair of Computers and Personal and Household Goods,small,28,34,21,13,259,255,4
2022,2,Al Madinah Region,Repair of Computers and Personal and Household Goods,micro,321,64,33,31,692,687,5
2022,2,Tabuk Region,Repair of Computers and Personal and Household Goods,small,25,35,21,14,207,206,1
2022,2,Tabuk Region,Repair of Computers and Personal and Household Goods,micro,246,47,31,16,544,542,2
2022,2,Tabuk Region,Repair of Computers and Personal and Household Goods,medium,2,1,1,0,238,238,0
2022,2,Jazan Region,Repair of Computers and Personal and Household Goods,small,18,22,18,4,164,164,0
2022,2,Jazan Region,Repair of Computers and Personal and Household Goods,micro,263,41,24,17,614,611,3
2022,2,Hail Region,Repair of Computers and Personal and Household Goods,small,41,25,13,12,418,418,0
2022,2,Hail Region,Repair of Computers and Personal and Household Goods,micro,288,26,21,5,697,684,13
2022,2,Aseer Region,Repair of Computers and Personal and Household Goods,small,62,50,38,12,605,603,2
2022,2,Aseer Region,Repair of Computers and Personal and Household Goods,micro,451,71,48,23,999,998,1
2022,2,Makkah Region,Repair of Computers and Personal and Household Goods,small,141,203,114,89,1299,1286,13
2022,2,Makkah Region,Repair of Computers and Personal and Household Goods,micro,1305,277,149,128,2826,2795,31
2022,2,Makkah Region,Repair of Computers and Personal and Household Goods,medium,8,187,140,47,586,584,2
2022,2,Najran Region,Repair of Computers and Personal and Household Goods,small,61,25,7,18,906,905,1
2022,2,Najran Region,Repair of Computers and Personal and Household Goods,large,3,0,0,0,953,953,0
2022,2,Najran Region,Repair of Computers and Personal and Household Goods,micro,200,26,10,16,504,503,1
2022,2,Najran Region,Repair of Computers and Personal and Household Goods,medium,11,3,2,1,931,931,0
2022,2,Eastern Province,Extraction of Crude Petroleum and Natural Gas,small,16,98,74,24,189,189,0
2022,2,Eastern Province,Extraction of Crude Petroleum and Natural Gas,large,5,64406,61068,3338,7214,6599,615
2022,2,Eastern Province,Extraction of Crude Petroleum and Natural Gas,micro,27,20,13,7,55,54,1
2022,2,Eastern Province,Extraction of Crude Petroleum and Natural Gas,medium,10,612,568,44,427,422,5
2022,2,Al Jawf Region,Extraction of Crude Petroleum and Natural Gas,micro,5,1,1,0,9,9,0
2022,2,Riyadh Region,Extraction of Crude Petroleum and Natural Gas,small,7,2,2,0,139,139,0
2022,2,Riyadh Region,Extraction of Crude Petroleum and Natural Gas,micro,14,6,3,3,36,36,0
2022,2,Riyadh Region,Extraction of Crude Petroleum and Natural Gas,medium,2,48,35,13,112,112,0
2022,2,Qassim Region,Extraction of Crude Petroleum and Natural Gas,micro,1,1,0,1,4,4,0
2022,2,Al Madinah Region,Extraction of Crude Petroleum and Natural Gas,micro,2,0,0,0,3,3,0
2022,2,Jazan Region,Extraction of Crude Petroleum and Natural Gas,small,1,3,3,0,5,5,0
2022,2,Aseer Region,Extraction of Crude Petroleum and Natural Gas,micro,2,1,0,1,3,3,0
2022,2,Makkah Region,Extraction of Crude Petroleum and Natural Gas,small,1,0,0,0,17,17,0
2022,2,Makkah Region,Extraction of Crude Petroleum and Natural Gas,large,1,488,470,18,100,100,0
2022,2,Makkah Region,Extraction of Crude Petroleum and Natural Gas,micro,2,0,0,0,9,9,0
2022,2,Najran Region,Extraction of Crude Petroleum and Natural Gas,small,2,4,4,0,16,16,0
2022,2,Najran Region,Extraction of Crude Petroleum and Natural Gas,micro,7,2,2,0,11,10,1
2022,2,Eastern Province,Advertising and Market Research,small,189,911,431,480,1663,1645,18
2022,2,Eastern Province,Advertising and Market Research,large,3,2089,1616,473,4499,4495,4
2022,2,Eastern Province,Advertising and Market Research,micro,585,388,147,241,1045,1023,22
2022,2,Eastern Province,Advertising and Market Research,medium,6,312,70,242,304,300,4
2022,2,Al Bahah Region,Advertising and Market Research,small,5,13,6,7,22,22,0
2022,2,Al Bahah Region,Advertising and Market Research,micro,15,8,5,3,30,30,0
2022,2,Al Jawf Region,Advertising and Market Research,small,9,9,8,1,56,56,0
2022,2,Al Jawf Region,Advertising and Market Research,micro,69,14,9,5,146,144,2
2022,2,Northern Borders Region,Advertising and Market Research,small,5,15,9,6,46,46,0
2022,2,Northern Borders Region,Advertising and Market Research,micro,19,8,3,5,33,33,0
2022,2,Riyadh Region,Advertising and Market Research,small,581,3435,1520,1915,4708,4501,207
2022,2,Riyadh Region,Advertising and Market Research,large,9,6536,5205,1331,1619,1394,225
2022,2,Riyadh Region,Advertising and Market Research,micro,1710,1170,461,709,2683,2568,115
2022,2,Riyadh Region,Advertising and Market Research,medium,27,852,476,376,1477,1396,81
2022,2,Qassim Region,Advertising and Market Research,small,40,105,58,47,380,376,4
2022,2,Qassim Region,Advertising and Market Research,micro,130,58,26,32,209,206,3
2022,2,Qassim Region,Advertising and Market Research,medium,2,27,13,14,147,146,1
2022,2,Al Madinah Region,Advertising and Market Research,small,31,77,45,32,223,222,1
2022,2,Al Madinah Region,Advertising and Market Research,micro,189,103,56,47,317,312,5
2022,2,Tabuk Region,Advertising and Market Research,small,6,29,14,15,69,69,0
2022,2,Tabuk Region,Advertising and Market Research,micro,71,22,11,11,137,135,2
2022,2,Jazan Region,Advertising and Market Research,small,8,36,16,20,65,64,1
2022,2,Jazan Region,Advertising and Market Research,micro,90,32,16,16,179,179,0
2022,2,Hail Region,Advertising and Market Research,small,7,8,5,3,49,49,0
2022,2,Hail Region,Advertising and Market Research,micro,59,20,9,11,117,117,0
2022,2,Aseer Region,Advertising and Market Research,small,22,89,51,38,207,207,0
2022,2,Aseer Region,Advertising and Market Research,micro,153,76,41,35,291,290,1
2022,2,Aseer Region,Advertising and Market Research,medium,1,26,11,15,59,59,0
2022,2,Makkah Region,Advertising and Market Research,small,320,1564,678,886,2820,2690,130
2022,2,Makkah Region,Advertising and Market Research,large,3,494,381,113,669,659,10
2022,2,Makkah Region,Advertising and Market Research,micro,1266,641,257,384,2256,2124,132
2022,2,Makkah Region,Advertising and Market Research,medium,30,987,561,426,1841,1763,78
2022,2,Najran Region,Advertising and Market Research,small,11,42,18,24,150,150,0
2022,2,Najran Region,Advertising and Market Research,micro,33,10,6,4,83,83,0
2022,2,Eastern Province,Unknown,small,74,170,103,67,715,674,41
2022,2,Eastern Province,Unknown,large,1,0,0,0,328,272,56
2022,2,Eastern Province,Unknown,micro,2251,195,111,84,4038,4005,33
2022,2,Al Bahah Region,Unknown,micro,220,11,10,1,342,339,3
2022,2,Al Jawf Region,Unknown,small,6,6,5,1,37,33,4
2022,2,Al Jawf Region,Unknown,micro,827,46,31,15,1363,1350,13
2022,2,Northern Borders Region,Unknown,small,5,4,1,3,31,31,0
2022,2,Northern Borders Region,Unknown,micro,241,18,7,11,402,400,2
2022,2,Riyadh Region,Unknown,small,517,806,408,398,4550,4472,78
2022,2,Riyadh Region,Unknown,large,5,2714,1700,1014,443,421,22
2022,2,Riyadh Region,Unknown,micro,51990,3282,1715,1567,108930,108057,873
2022,2,Riyadh Region,Unknown,medium,10,275,221,54,366,365,1
2022,2,Qassim Region,Unknown,small,29,20,14,6,375,368,7
2022,2,Qassim Region,Unknown,micro,1574,101,54,47,3080,3063,17
2022,2,Qassim Region,Unknown,medium,1,0,0,0,54,53,1
2022,2,Al Madinah Region,Unknown,small,24,31,20,11,206,205,1
2022,2,Al Madinah Region,Unknown,micro,1654,111,60,51,2700,2632,68
2022,2,Al Madinah Region,Unknown,medium,1,0,0,0,54,54,0
2022,2,Tabuk Region,Unknown,small,7,9,6,3,53,53,0
2022,2,Tabuk Region,Unknown,micro,588,26,10,16,951,941,10
2022,2,Tabuk Region,Unknown,medium,1,0,0,0,61,61,0
2022,2,Jazan Region,Unknown,small,15,27,20,7,125,121,4
2022,2,Jazan Region,Unknown,micro,1348,65,39,26,2182,2155,27
2022,2,Jazan Region,Unknown,medium,1,74,68,6,130,130,0
2022,2,Hail Region,Unknown,small,14,11,5,6,140,140,0
2022,2,Hail Region,Unknown,micro,1991,101,63,38,4171,4158,13
2022,2,Hail Region,Unknown,medium,2,0,0,0,159,112,47
2022,2,Aseer Region,Unknown,small,21,47,40,7,181,175,6
2022,2,Aseer Region,Unknown,micro,1653,91,56,35,2520,2502,18
2022,2,Makkah Region,Unknown,small,127,274,124,150,1096,1047,49
2022,2,Makkah Region,Unknown,micro,5530,436,256,180,9073,8680,393
2022,2,Makkah Region,Unknown,medium,6,108,74,34,442,398,44
2022,2,Najran Region,Unknown,small,26,25,13,12,248,248,0
2022,2,Najran Region,Unknown,micro,2152,131,60,71,4540,4522,18
2022,3,Eastern Province,"Travel Agencies, Tour Operators, Reservation Services, and Related Activities",small,50,311,142,169,525,519,6
2022,3,Eastern Province,"Travel Agencies, Tour Operators, Reservation Services, and Related Activities",large,1,228,212,16,212,211,1
2022,3,Eastern Province,"Travel Agencies, Tour Operators, Reservation Services, and Related Activities",micro,186,133,65,68,265,264,1
2022,3,Eastern Province,"Travel Agencies, Tour Operators, Reservation Services, and Related Activities",medium,5,188,107,81,274,273,1
2022,3,Al Bahah Region,"Travel Agencies, Tour Operators, Reservation Services, and Related Activities",micro,4,2,1,1,9,9,0
2022,3,Al Jawf Region,"Travel Agencies, Tour Operators, Reservation Services, and Related Activities",small,2,11,7,4,18,18,0
2022,3,Al Jawf Region,"Travel Agencies, Tour Operators, Reservation Services, and Related Activities",micro,15,6,2,4,27,27,0
2022,3,Northern Borders Region,"Travel Agencies, Tour Operators, Reservation Services, and Related Activities",small,2,5,5,0,22,22,0
2022,3,Northern Borders Region,"Travel Agencies, Tour Operators, Reservation Services, and Related Activities",micro,11,3,2,1,20,19,1
2022,3,Riyadh Region,"Travel Agencies, Tour Operators, Reservation Services, and Related Activities",small,149,846,372,474,1289,1273,16
2022,3,Riyadh Region,"Travel Agencies, Tour Operators, Reservation Services, and Related Activities",large,3,512,348,164,678,654,24
2022,3,Riyadh Region,"Travel Agencies, Tour Operators, Reservation Services, and Related Activities",micro,370,215,100,115,635,618,17
2022,3,Riyadh Region,"Travel Agencies, Tour Operators, Reservation Services, and Related Activities",medium,16,708,449,259,1009,999,10
2022,3,Qassim Region,"Travel Agencies, Tour Operators, Reservation Services, and Related Activities",small,12,29,10,19,94,93,1
2022,3,Qassim Region,"Travel Agencies, Tour Operators, Reservation Services, and Related Activities",micro,79,23,8,15,189,185,4
2022,3,Al Madinah Region,"Travel Agencies, Tour Operators, Reservation Services, and Related Activities",small,28,124,71,53,307,303,4
2022,3,Al Madinah Region,"Travel Agencies, Tour Operators, Reservation Services, and Related Activities",micro,127,86,51,35,196,191,5
2022,3,Tabuk Region,"Travel Agencies, Tour Operators, Reservation Services, and Related Activities",small,8,30,16,14,66,66,0
2022,3,Tabuk Region,"Travel Agencies, Tour Operators, Reservation Services, and Related Activities",micro,35,14,5,9,52,51,1
2022,3,Jazan Region,"Travel Agencies, Tour Operators, Reservation Services, and Related Activities",small,2,7,1,6,17,17,0
2022,3,Jazan Region,"Travel Agencies, Tour Operators, Reservation Services, and Related Activities",micro,26,18,7,11,37,37,0
2022,3,Hail Region,"Travel Agencies, Tour Operators, Reservation Services, and Related Activities",small,7,31,10,21,65,63,2
2022,3,Hail Region,"Travel Agencies, Tour Operators, Reservation Services, and Related Activities",micro,22,14,8,6,39,39,0
2022,3,Aseer Region,"Travel Agencies, Tour Operators, Reservation Services, and Related Activities",small,4,15,6,9,31,31,0
2022,3,Aseer Region,"Travel Agencies, Tour Operators, Reservation Services, and Related Activities",micro,55,32,22,10,92,92,0
2022,3,Makkah Region,"Travel Agencies, Tour Operators, Reservation Services, and Related Activities",small,200,785,468,317,1538,1508,30
2022,3,Makkah Region,"Travel Agencies, Tour Operators, Reservation Services, and Related Activities",large,2,3560,3020,540,1273,1272,1
2022,3,Makkah Region,"Travel Agencies, Tour Operators, Reservation Services, and Related Activities",micro,648,482,302,180,1086,1063,23
2022,3,Makkah Region,"Travel Agencies, Tour Operators, Reservation Services, and Related Activities",medium,12,506,222,284,559,558,1
2022,3,Najran Region,"Travel Agencies, Tour Operators, Reservation Services, and Related Activities",small,4,11,3,8,31,31,0
2022,3,Najran Region,"Travel Agencies, Tour Operators, Reservation Services, and Related Activities",micro,9,5,5,0,18,18,0
2022,3,Eastern Province,Fishing and Aquaculture,small,132,93,36,57,1240,1239,1
2022,3,Eastern Province,Fishing and Aquaculture,micro,1106,129,64,65,2828,2824,4
2022,3,Al Bahah Region,Fishing and Aquaculture,small,1,0,0,0,7,7,0
2022,3,Al Bahah Region,Fishing and Aquaculture,micro,70,11,5,6,146,146,0
2022,3,Al Jawf Region,Fishing and Aquaculture,small,1,0,0,0,8,8,0
2022,3,Al Jawf Region,Fishing and Aquaculture,micro,342,20,14,6,628,627,1
2022,3,Northern Borders Region,Fishing and Aquaculture,small,1,2,2,0,16,16,0
2022,3,Northern Borders Region,Fishing and Aquaculture,micro,98,9,4,5,230,230,0
2022,3,Riyadh Region,Fishing and Aquaculture,small,261,299,138,161,1972,1970,2
2022,3,Riyadh Region,Fishing and Aquaculture,micro,43270,4705,2313,2392,111327,110719,608
2022,3,Qassim Region,Fishing and Aquaculture,small,11,4,1,3,119,119,0
2022,3,Qassim Region,Fishing and Aquaculture,micro,1374,148,87,61,3672,3666,6
2022,3,Al Madinah Region,Fishing and Aquaculture,small,22,21,14,7,212,211,1
2022,3,Al Madinah Region,Fishing and Aquaculture,micro,594,63,32,31,1305,1271,34
2022,3,Tabuk Region,Fishing and Aquaculture,small,12,4,3,1,114,114,0
2022,3,Tabuk Region,Fishing and Aquaculture,micro,262,27,14,13,530,528,2
2022,3,Jazan Region,Fishing and Aquaculture,small,50,67,37,30,593,591,2
2022,3,Jazan Region,Fishing and Aquaculture,micro,565,52,28,24,1223,1214,9
2022,3,Jazan Region,Fishing and Aquaculture,medium,4,83,70,13,340,339,1
2022,3,Hail Region,Fishing and Aquaculture,small,9,7,5,2,53,53,0
2022,3,Hail Region,Fishing and Aquaculture,micro,2276,201,108,93,5767,5747,20
2022,3,Aseer Region,Fishing and Aquaculture,small,24,27,19,8,226,226,0
2022,3,Aseer Region,Fishing and Aquaculture,micro,547,38,15,23,1079,1078,1
2022,3,Aseer Region,Fishing and Aquaculture,medium,1,6,2,4,47,47,0
2022,3,Makkah Region,Fishing and Aquaculture,small,67,49,22,27,560,560,0
2022,3,Makkah Region,Fishing and Aquaculture,large,1,267,243,24,1920,1917,3
2022,3,Makkah Region,Fishing and Aquaculture,micro,3497,350,172,178,7362,7078,284
2022,3,Makkah Region,Fishing and Aquaculture,medium,2,38,36,2,251,251,0
2022,3,Najran Region,Fishing and Aquaculture,small,6,0,0,0,49,49,0
2022,3,Najran Region,Fishing and Aquaculture,micro,1373,142,74,68,3565,3557,8
2022,3,Eastern Province,Manufacture of Shaped Metal Products (Except Machinery and Equipment),small,667,2028,1248,780,7686,7677,9
2022,3,Eastern Province,Manufacture of Shaped Metal Products (Except Machinery and Equipment),large,21,6349,6141,208,7413,7403,10
2022,3,Eastern Province,Manufacture of Shaped Metal Products (Except Machinery and Equipment),micro,1495,498,281,217,3328,3326,2
2022,3,Eastern Province,Manufacture of Shaped Metal Products (Except Machinery and Equipment),medium,106,2853,2123,730,8209,8201,8
2022,3,Al Bahah Region,Manufacture of Shaped Metal Products (Except Machinery and Equipment),small,21,23,16,7,129,129,0
2022,3,Al Bahah Region,Manufacture of Shaped Metal Products (Except Machinery and Equipment),micro,310,59,37,22,616,616,0
2022,3,Al Jawf Region,Manufacture of Shaped Metal Products (Except Machinery and Equipment),small,32,45,34,11,272,272,0
2022,3,Al Jawf Region,Manufacture of Shaped Metal Products (Except Machinery and Equipment),micro,287,35,28,7,622,621,1
2022,3,Northern Borders Region,Manufacture of Shaped Metal Products (Except Machinery and Equipment),small,21,48,26,22,246,246,0
2022,3,Northern Borders Region,Manufacture of Shaped Metal Products (Except Machinery and Equipment),micro,116,16,8,8,280,277,3
2022,3,Riyadh Region,Manufacture of Shaped Metal Products (Except Machinery and Equipment),small,995,2854,1281,1573,12402,12350,52
2022,3,Riyadh Region,Manufacture of Shaped Metal Products (Except Machinery and Equipment),large,16,2001,1293,708,5364,5358,6
2022,3,Riyadh Region,Manufacture of Shaped Metal Products (Except Machinery and Equipment),micro,2593,645,289,356,5793,5769,24
2022,3,Riyadh Region,Manufacture of Shaped Metal Products (Except Machinery and Equipment),medium,156,3283,1759,1524,11537,11515,22
2022,3,Qassim Region,Manufacture of Shaped Metal Products (Except Machinery and Equipment),small,176,314,168,146,1624,1623,1
2022,3,Qassim Region,Manufacture of Shaped Metal Products (Except Machinery and Equipment),large,1,130,108,22,377,377,0
2022,3,Qassim Region,Manufacture of Shaped Metal Products (Except Machinery and Equipment),micro,1242,193,109,84,2842,2837,5
2022,3,Qassim Region,Manufacture of Shaped Metal Products (Except Machinery and Equipment),medium,8,150,89,61,451,450,1
2022,3,Al Madinah Region,Manufacture of Shaped Metal Products (Except Machinery and Equipment),small,97,190,85,105,885,884,1
2022,3,Al Madinah Region,Manufacture of Shaped Metal Products (Except Machinery and Equipment),micro,644,119,76,43,1404,1402,2
2022,3,Al Madinah Region,Manufacture of Shaped Metal Products (Except Machinery and Equipment),medium,8,272,202,70,700,699,1
2022,3,Tabuk Region,Manufacture of Shaped Metal Products (Except Machinery and Equipment),small,34,73,44,29,392,390,2
2022,3,Tabuk Region,Manufacture of Shaped Metal Products (Except Machinery and Equipment),micro,221,46,22,24,521,521,0
2022,3,Tabuk Region,Manufacture of Shaped Metal Products (Except Machinery and Equipment),medium,1,26,19,7,79,79,0
2022,3,Jazan Region,Manufacture of Shaped Metal Products (Except Machinery and Equipment),small,54,99,62,37,440,439,1
2022,3,Jazan Region,Manufacture of Shaped Metal Products (Except Machinery and Equipment),micro,811,101,64,37,1917,1915,2
2022,3,Hail Region,Manufacture of Shaped Metal Products (Except Machinery and Equipment),small,60,163,90,73,617,617,0
2022,3,Hail Region,Manufacture of Shaped Metal Products (Except Machinery and Equipment),micro,233,50,26,24,515,512,3
2022,3,Hail Region,Manufacture of Shaped Metal Products (Except Machinery and Equipment),medium,1,11,4,7,61,61,0
2022,3,Aseer Region,Manufacture of Shaped Metal Products (Except Machinery and Equipment),small,97,194,121,73,970,970,0
2022,3,Aseer Region,Manufacture of Shaped Metal Products (Except Machinery and Equipment),micro,1066,206,120,86,2357,2357,0
2022,3,Aseer Region,Manufacture of Shaped Metal Products (Except Machinery and Equipment),medium,7,116,64,52,473,473,0
2022,3,Makkah Region,Manufacture of Shaped Metal Products (Except Machinery and Equipment),small,369,891,466,425,4111,4086,25
2022,3,Makkah Region,Manufacture of Shaped Metal Products (Except Machinery and Equipment),large,8,876,603,273,2221,2216,5
2022,3,Makkah Region,Manufacture of Shaped Metal Products (Except Machinery and Equipment),micro,2097,364,219,145,4755,4744,11
2022,3,Makkah Region,Manufacture of Shaped Metal Products (Except Machinery and Equipment),medium,82,2117,1565,552,6738,6716,22
2022,3,Najran Region,Manufacture of Shaped Metal Products (Except Machinery and Equipment),small,25,48,21,27,198,197,1
2022,3,Najran Region,Manufacture of Shaped Metal Products (Except Machinery and Equipment),micro,336,49,28,21,801,801,0
2022,3,Eastern Province,Manufacture of Other Non-Metallic Mineral Products,small,316,1133,678,455,5203,5200,3
2022,3,Eastern Province,Manufacture of Other Non-Metallic Mineral Products,large,16,2030,1723,307,5381,5378,3
2022,3,Eastern Province,Manufacture of Other Non-Metallic Mineral Products,micro,328,112,67,45,757,756,1
2022,3,Eastern Province,Manufacture of Other Non-Metallic Mineral Products,medium,125,2667,1771,896,9853,9792,61
2022,3,Al Bahah Region,Manufacture of Other Non-Metallic Mineral Products,small,29,124,92,32,539,539,0
2022,3,Al Bahah Region,Manufacture of Other Non-Metallic Mineral Products,micro,41,12,10,2,83,83,0
2022,3,Al Bahah Region,Manufacture of Other Non-Metallic Mineral Products,medium,7,120,72,48,445,441,4
2022,3,Al Jawf Region,Manufacture of Other Non-Metallic Mineral Products,small,33,111,70,41,522,520,2
2022,3,Al Jawf Region,Manufacture of Other Non-Metallic Mineral Products,micro,45,10,9,1,99,98,1
2022,3,Al Jawf Region,Manufacture of Other Non-Metallic Mineral Products,medium,13,245,176,69,1009,1007,2
2022,3,Northern Borders Region,Manufacture of Other Non-Metallic Mineral Products,small,23,67,32,35,360,360,0
2022,3,Northern Borders Region,Manufacture of Other Non-Metallic Mineral Products,large,1,226,224,2,170,170,0
2022,3,Northern Borders Region,Manufacture of Other Non-Metallic Mineral Products,micro,33,8,5,3,83,83,0
2022,3,Northern Borders Region,Manufacture of Other Non-Metallic Mineral Products,medium,3,78,51,27,226,226,0
2022,3,Riyadh Region,Manufacture of Other Non-Metallic Mineral Products,small,1312,2025,966,1059,21835,21774,61
2022,3,Riyadh Region,Manufacture of Other Non-Metallic Mineral Products,large,38,4875,3416,1459,11863,11850,13
2022,3,Riyadh Region,Manufacture of Other Non-Metallic Mineral Products,micro,1620,367,179,188,3973,3948,25
2022,3,Riyadh Region,Manufacture of Other Non-Metallic Mineral Products,medium,434,4473,2373,2100,33513,33451,62
2022,3,Qassim Region,Manufacture of Other Non-Metallic Mineral Products,small,155,370,203,167,2553,2550,3
2022,3,Qassim Region,Manufacture of Other Non-Metallic Mineral Products,large,8,764,647,117,2694,2693,1
2022,3,Qassim Region,Manufacture of Other Non-Metallic Mineral Products,micro,266,70,43,27,701,700,1
2022,3,Qassim Region,Manufacture of Other Non-Metallic Mineral Products,medium,49,817,500,317,3514,3514,0
2022,3,Al Madinah Region,Manufacture of Other Non-Metallic Mineral Products,small,103,241,155,86,1407,1404,3
2022,3,Al Madinah Region,Manufacture of Other Non-Metallic Mineral Products,large,6,910,616,294,2014,2012,2
2022,3,Al Madinah Region,Manufacture of Other Non-Metallic Mineral Products,micro,165,41,27,14,392,390,2
2022,3,Al Madinah Region,Manufacture of Other Non-Metallic Mineral Products,medium,43,1041,787,254,3778,3777,1
2022,3,Tabuk Region,Manufacture of Other Non-Metallic Mineral Products,small,27,109,68,41,363,363,0
2022,3,Tabuk Region,Manufacture of Other Non-Metallic Mineral Products,large,2,348,329,19,524,524,0
2022,3,Tabuk Region,Manufacture of Other Non-Metallic Mineral Products,micro,52,20,9,11,108,108,0
2022,3,Tabuk Region,Manufacture of Other Non-Metallic Mineral Products,medium,8,178,116,62,652,652,0
2022,3,Jazan Region,Manufacture of Other Non-Metallic Mineral Products,small,80,260,167,93,1195,1192,3
2022,3,Jazan Region,Manufacture of Other Non-Metallic Mineral Products,large,2,415,411,4,349,349,0
2022,3,Jazan Region,Manufacture of Other Non-Metallic Mineral Products,micro,128,27,20,7,318,318,0
2022,3,Jazan Region,Manufacture of Other Non-Metallic Mineral Products,medium,28,529,336,193,1788,1788,0
2022,3,Hail Region,Manufacture of Other Non-Metallic Mineral Products,small,49,62,38,24,631,631,0
2022,3,Hail Region,Manufacture of Other Non-Metallic Mineral Products,large,1,253,253,0,166,166,0
2022,3,Hail Region,Manufacture of Other Non-Metallic Mineral Products,micro,135,25,13,12,354,354,0
2022,3,Hail Region,Manufacture of Other Non-Metallic Mineral Products,medium,10,203,136,67,950,950,0
2022,3,Aseer Region,Manufacture of Other Non-Metallic Mineral Products,small,174,459,304,155,2554,2550,4
2022,3,Aseer Region,Manufacture of Other Non-Metallic Mineral Products,large,6,872,779,93,1643,1641,2
2022,3,Aseer Region,Manufacture of Other Non-Metallic Mineral Products,micro,270,84,47,37,654,650,4
2022,3,Aseer Region,Manufacture of Other Non-Metallic Mineral Products,medium,44,909,581,328,3371,3371,0
2022,3,Makkah Region,Manufacture of Other Non-Metallic Mineral Products,small,266,771,428,343,3870,3858,12
2022,3,Makkah Region,Manufacture of Other Non-Metallic Mineral Products,large,15,2860,1967,893,5963,5957,6
2022,3,Makkah Region,Manufacture of Other Non-Metallic Mineral Products,micro,470,153,90,63,1097,1090,7
2022,3,Makkah Region,Manufacture of Other Non-Metallic Mineral Products,medium,96,2022,1288,734,7447,7437,10
2022,3,Najran Region,Manufacture of Other Non-Metallic Mineral Products,small,44,130,70,60,652,652,0
2022,3,Najran Region,Manufacture of Other Non-Metallic Mineral Products,large,1,337,321,16,395,395,0
2022,3,Najran Region,Manufacture of Other Non-Metallic Mineral Products,micro,67,11,6,5,182,182,0
2022,3,Najran Region,Manufacture of Other Non-Metallic Mineral Products,medium,22,407,245,162,1730,1726,4
2022,3,Eastern Province,Manufacture of Rubber and Plastic Products,small,57,208,137,71,875,874,1
2022,3,Eastern Province,Manufacture of Rubber and Plastic Products,large,4,480,429,51,1048,1048,0
2022,3,Eastern Province,Manufacture of Rubber and Plastic Products,micro,47,28,19,9,82,82,0
2022,3,Eastern Province,Manufacture of Rubber and Plastic Products,medium,36,991,728,263,2597,2593,4
2022,3,Al Bahah Region,Manufacture of Rubber and Plastic Products,micro,1,0,0,0,1,1,0
2022,3,Al Jawf Region,Manufacture of Rubber and Plastic Products,small,2,9,7,2,32,32,0
2022,3,Al Jawf Region,Manufacture of Rubber and Plastic Products,large,1,125,90,35,363,363,0
2022,3,Al Jawf Region,Manufacture of Rubber and Plastic Products,micro,12,0,0,0,30,30,0
2022,3,Northern Borders Region,Manufacture of Rubber and Plastic Products,small,1,3,1,2,6,6,0
2022,3,Northern Borders Region,Manufacture of Rubber and Plastic Products,medium,1,22,3,19,106,106,0
2022,3,Riyadh Region,Manufacture of Rubber and Plastic Products,small,129,624,282,342,2469,2457,12
2022,3,Riyadh Region,Manufacture of Rubber and Plastic Products,large,11,1036,560,476,3343,3337,6
2022,3,Riyadh Region,Manufacture of Rubber and Plastic Products,micro,186,79,41,38,429,419,10
2022,3,Riyadh Region,Manufacture of Rubber and Plastic Products,medium,84,2103,1116,987,7117,7106,11
2022,3,Qassim Region,Manufacture of Rubber and Plastic Products,small,5,27,12,15,84,84,0
2022,3,Qassim Region,Manufacture of Rubber and Plastic Products,micro,13,7,2,5,19,19,0
2022,3,Qassim Region,Manufacture of Rubber and Plastic Products,medium,7,179,116,63,549,548,1
2022,3,Al Madinah Region,Manufacture of Rubber and Plastic Products,small,22,110,56,54,430,430,0
2022,3,Al Madinah Region,Manufacture of Rubber and Plastic Products,large,1,132,69,63,339,339,0
2022,3,Al Madinah Region,Manufacture of Rubber and Plastic Products,micro,21,16,8,8,25,25,0
2022,3,Al Madinah Region,Manufacture of Rubber and Plastic Products,medium,8,233,148,85,690,685,5
2022,3,Tabuk Region,Manufacture of Rubber and Plastic Products,small,7,21,13,8,96,96,0
2022,3,Tabuk Region,Manufacture of Rubber and Plastic Products,micro,4,2,0,2,14,14,0
2022,3,Tabuk Region,Manufacture of Rubber and Plastic Products,medium,1,18,10,8,79,79,0
2022,3,Jazan Region,Manufacture of Rubber and Plastic Products,small,2,5,4,1,15,15,0
2022,3,Jazan Region,Manufacture of Rubber and Plastic Products,micro,6,2,2,0,18,18,0
2022,3,Hail Region,Manufacture of Rubber and Plastic Products,small,3,22,8,14,77,77,0
2022,3,Hail Region,Manufacture of Rubber and Plastic Products,micro,7,1,1,0,11,11,0
2022,3,Hail Region,Manufacture of Rubber and Plastic Products,medium,2,94,76,18,149,149,0
2022,3,Aseer Region,Manufacture of Rubber and Plastic Products,small,5,10,6,4,59,59,0
2022,3,Aseer Region,Manufacture of Rubber and Plastic Products,micro,25,8,5,3,49,49,0
2022,3,Aseer Region,Manufacture of Rubber and Plastic Products,medium,4,65,38,27,238,238,0
2022,3,Makkah Region,Manufacture of Rubber and Plastic Products,small,82,397,210,187,1531,1520,11
2022,3,Makkah Region,Manufacture of Rubber and Plastic Products,large,11,1223,903,320,2971,2955,16
2022,3,Makkah Region,Manufacture of Rubber and Plastic Products,micro,67,32,24,8,138,137,1
2022,3,Makkah Region,Manufacture of Rubber and Plastic Products,medium,35,911,509,402,3127,3123,4
2022,3,Najran Region,Manufacture of Rubber and Plastic Products,small,3,20,11,9,70,70,0
2022,3,Najran Region,Manufacture of Rubber and Plastic Products,micro,10,3,0,3,25,25,0
2022,3,Najran Region,Manufacture of Rubber and Plastic Products,medium,3,60,23,37,247,247,0
2022,3,Eastern Province,Manufacture of Coke and Refined Petroleum Products,small,29,156,100,56,534,534,0
2022,3,Eastern Province,Manufacture of Coke and Refined Petroleum Products,large,7,3546,3495,51,1609,1608,1
2022,3,Eastern Province,Manufacture of Coke and Refined Petroleum Products,micro,12,13,7,6,13,13,0
2022,3,Eastern Province,Manufacture of Coke and Refined Petroleum Products,medium,8,533,516,17,644,644,0
2022,3,Al Jawf Region,Manufacture of Coke and Refined Petroleum Products,micro,1,1,0,1,2,2,0
2022,3,Riyadh Region,Manufacture of Coke and Refined Petroleum Products,small,33,173,109,64,387,384,3
2022,3,Riyadh Region,Manufacture of Coke and Refined Petroleum Products,micro,38,32,19,13,56,55,1
2022,3,Riyadh Region,Manufacture of Coke and Refined Petroleum Products,medium,6,208,147,61,426,425,1
2022,3,Qassim Region,Manufacture of Coke and Refined Petroleum Products,small,4,25,22,3,80,80,0
2022,3,Qassim Region,Manufacture of Coke and Refined Petroleum Products,micro,4,2,2,0,9,9,0
2022,3,Al Madinah Region,Manufacture of Coke and Refined Petroleum Products,small,2,11,11,0,30,30,0
2022,3,Al Madinah Region,Manufacture of Coke and Refined Petroleum Products,large,4,2032,1973,59,510,510,0
2022,3,Al Madinah Region,Manufacture of Coke and Refined Petroleum Products,micro,5,5,4,1,9,9,0
2022,3,Al Madinah Region,Manufacture of Coke and Refined Petroleum Products,medium,4,201,196,5,473,473,0
2022,3,Jazan Region,Manufacture of Coke and Refined Petroleum Products,large,1,221,216,5,46,41,5
2022,3,Jazan Region,Manufacture of Coke and Refined Petroleum Products,micro,2,0,0,0,3,3,0
2022,3,Aseer Region,Manufacture of Coke and Refined Petroleum Products,small,1,5,2,3,18,18,0
2022,3,Aseer Region,Manufacture of Coke and Refined Petroleum Products,medium,1,17,9,8,48,48,0
2022,3,Makkah Region,Manufacture of Coke and Refined Petroleum Products,small,18,81,50,31,275,273,2
2022,3,Makkah Region,Manufacture of Coke and Refined Petroleum Products,large,3,2732,2652,80,1326,1313,13
2022,3,Makkah Region,Manufacture of Coke and Refined Petroleum Products,micro,19,10,9,1,29,29,0
2022,3,Makkah Region,Manufacture of Coke and Refined Petroleum Products,medium,3,125,122,3,90,90,0
2022,3,Eastern Province,Manufacture of Paper and Paper Products,small,48,257,136,121,949,947,2
2022,3,Eastern Province,Manufacture of Paper and Paper Products,large,6,649,515,134,1559,1555,4
2022,3,Eastern Province,Manufacture of Paper and Paper Products,micro,49,28,14,14,113,112,1
2022,3,Eastern Province,Manufacture of Paper and Paper Products,medium,20,568,402,166,1586,1584,2
2022,3,Al Jawf Region,Manufacture of Paper and Paper Products,small,1,2,2,0,10,10,0
2022,3,Al Jawf Region,Manufacture of Paper and Paper Products,micro,2,0,0,0,7,7,0
2022,3,Northern Borders Region,Manufacture of Paper and Paper Products,small,2,2,1,1,17,17,0
2022,3,Northern Borders Region,Manufacture of Paper and Paper Products,micro,1,0,0,0,1,1,0
2022,3,Riyadh Region,Manufacture of Paper and Paper Products,small,101,465,170,295,1487,1480,7
2022,3,Riyadh Region,Manufacture of Paper and Paper Products,large,1,63,21,42,199,199,0
2022,3,Riyadh Region,Manufacture of Paper and Paper Products,micro,117,62,29,33,263,261,2
2022,3,Riyadh Region,Manufacture of Paper and Paper Products,medium,43,1087,606,481,3435,3423,12
2022,3,Qassim Region,Manufacture of Paper and Paper Products,small,10,21,13,8,167,166,1
2022,3,Qassim Region,Manufacture of Paper and Paper Products,micro,20,5,1,4,35,35,0
2022,3,Qassim Region,Manufacture of Paper and Paper Products,medium,5,105,75,30,417,417,0
2022,3,Al Madinah Region,Manufacture of Paper and Paper Products,small,14,49,29,20,183,181,2
2022,3,Al Madinah Region,Manufacture of Paper and Paper Products,micro,12,3,1,2,18,18,0
2022,3,Al Madinah Region,Manufacture of Paper and Paper Products,medium,2,42,27,15,110,110,0
2022,3,Tabuk Region,Manufacture of Paper and Paper Products,small,5,26,11,15,90,90,0
2022,3,Tabuk Region,Manufacture of Paper and Paper Products,micro,3,0,0,0,7,7,0
2022,3,Jazan Region,Manufacture of Paper and Paper Products,small,2,3,0,3,11,11,0
2022,3,Jazan Region,Manufacture of Paper and Paper Products,micro,6,3,2,1,15,15,0
2022,3,Jazan Region,Manufacture of Paper and Paper Products,medium,1,18,8,10,65,65,0
2022,3,Hail Region,Manufacture of Paper and Paper Products,small,5,13,7,6,66,66,0
2022,3,Hail Region,Manufacture of Paper and Paper Products,micro,4,0,0,0,12,12,0
2022,3,Aseer Region,Manufacture of Paper and Paper Products,small,11,26,16,10,116,116,0
2022,3,Aseer Region,Manufacture of Paper and Paper Products,micro,9,3,3,0,23,23,0
2022,3,Aseer Region,Manufacture of Paper and Paper Products,medium,2,40,28,12,119,119,0
2022,3,Makkah Region,Manufacture of Paper and Paper Products,small,71,268,156,112,1012,1008,4
2022,3,Makkah Region,Manufacture of Paper and Paper Products,large,5,659,498,161,1623,1614,9
2022,3,Makkah Region,Manufacture of Paper and Paper Products,micro,51,24,13,11,108,104,4
2022,3,Makkah Region,Manufacture of Paper and Paper Products,medium,27,743,378,365,1913,1900,13
2022,3,Najran Region,Manufacture of Paper and Paper Products,small,4,4,2,2,49,49,0
2022,3,Najran Region,Manufacture of Paper and Paper Products,micro,21,5,1,4,43,43,0
2022,3,Eastern Province,Manufacture of Chemicals and Chemical Products,small,180,1045,735,310,2761,2747,14
2022,3,Eastern Province,Manufacture of Chemicals and Chemical Products,large,16,11060,10935,125,2512,2512,0
2022,3,Eastern Province,Manufacture of Chemicals and Chemical Products,micro,136,103,58,45,244,244,0
2022,3,Eastern Province,Manufacture of Chemicals and Chemical Products,medium,96,3718,3195,523,6036,6027,9
2022,3,Al Bahah Region,Manufacture of Chemicals and Chemical Products,small,5,8,6,2,37,37,0
2022,3,Al Bahah Region,Manufacture of Chemicals and Chemical Products,micro,4,0,0,0,6,6,0
2022,3,Al Bahah Region,Manufacture of Chemicals and Chemical Products,medium,1,10,2,8,52,52,0
2022,3,Al Jawf Region,Manufacture of Chemicals and Chemical Products,small,1,0,0,0,6,5,1
2022,3,Al Jawf Region,Manufacture of Chemicals and Chemical Products,micro,8,3,2,1,15,15,0
2022,3,Northern Borders Region,Manufacture of Chemicals and Chemical Products,small,2,17,17,0,5,5,0
2022,3,Northern Borders Region,Manufacture of Chemicals and Chemical Products,large,1,620,612,8,224,224,0
2022,3,Northern Borders Region,Manufacture of Chemicals and Chemical Products,micro,7,1,1,0,11,11,0
2022,3,Riyadh Region,Manufacture of Chemicals and Chemical Products,small,418,1714,804,910,6451,6433,18
2022,3,Riyadh Region,Manufacture of Chemicals and Chemical Products,large,14,2692,1865,827,3697,3684,13
2022,3,Riyadh Region,Manufacture of Chemicals and Chemical Products,micro,462,207,101,106,957,944,13
2022,3,Riyadh Region,Manufacture of Chemicals and Chemical Products,medium,101,2417,1286,1131,7152,7138,14
2022,3,Qassim Region,Manufacture of Chemicals and Chemical Products,small,22,61,39,22,244,244,0
2022,3,Qassim Region,Manufacture of Chemicals and Chemical Products,large,2,457,432,25,1420,1419,1
2022,3,Qassim Region,Manufacture of Chemicals and Chemical Products,micro,27,8,5,3,52,52,0
2022,3,Qassim Region,Manufacture of Chemicals and Chemical Products,medium,8,180,107,73,592,592,0
2022,3,Al Madinah Region,Manufacture of Chemicals and Chemical Products,small,35,207,155,52,560,558,2
2022,3,Al Madinah Region,Manufacture of Chemicals and Chemical Products,large,5,2877,2858,19,667,667,0
2022,3,Al Madinah Region,Manufacture of Chemicals and Chemical Products,micro,36,19,9,10,58,57,1
2022,3,Al Madinah Region,Manufacture of Chemicals and Chemical Products,medium,10,325,296,29,589,588,1
2022,3,Tabuk Region,Manufacture of Chemicals and Chemical Products,small,11,50,34,16,189,188,1
2022,3,Tabuk Region,Manufacture of Chemicals and Chemical Products,large,1,381,226,155,520,520,0
2022,3,Tabuk Region,Manufacture of Chemicals and Chemical Products,micro,17,6,3,3,31,31,0
2022,3,Jazan Region,Manufacture of Chemicals and Chemical Products,small,10,23,10,13,105,105,0
2022,3,Jazan Region,Manufacture of Chemicals and Chemical Products,micro,19,5,5,0,46,44,2
2022,3,Jazan Region,Manufacture of Chemicals and Chemical Products,medium,1,9,9,0,70,70,0
2022,3,Hail Region,Manufacture of Chemicals and Chemical Products,small,11,15,6,9,96,96,0
2022,3,Hail Region,Manufacture of Chemicals and Chemical Products,micro,56,10,7,3,145,145,0
2022,3,Hail Region,Manufacture of Chemicals and Chemical Products,medium,1,7,4,3,44,44,0
2022,3,Aseer Region,Manufacture of Chemicals and Chemical Products,small,26,98,59,39,430,428,2
2022,3,Aseer Region,Manufacture of Chemicals and Chemical Products,large,1,618,504,114,1388,1385,3
2022,3,Aseer Region,Manufacture of Chemicals and Chemical Products,micro,36,11,6,5,70,70,0
2022,3,Aseer Region,Manufacture of Chemicals and Chemical Products,medium,5,110,71,39,334,334,0
2022,3,Makkah Region,Manufacture of Chemicals and Chemical Products,small,203,878,505,373,3024,2997,27
2022,3,Makkah Region,Manufacture of Chemicals and Chemical Products,large,4,755,558,197,1641,1637,4
2022,3,Makkah Region,Manufacture of Chemicals and Chemical Products,micro,229,113,58,55,449,436,13
2022,3,Makkah Region,Manufacture of Chemicals and Chemical Products,medium,78,2116,1331,785,5427,5391,36
2022,3,Najran Region,Manufacture of Chemicals and Chemical Products,small,4,20,13,7,93,93,0
2022,3,Najran Region,Manufacture of Chemicals and Chemical Products,micro,11,0,0,0,26,26,0
2022,3,Najran Region,Manufacture of Chemicals and Chemical Products,medium,3,39,17,22,153,153,0
2022,3,Eastern Province,Manufacture of Textiles,small,76,169,90,79,825,813,12
2022,3,Eastern Province,Manufacture of Textiles,micro,314,74,31,43,649,631,18
2022,3,Eastern Province,Manufacture of Textiles,medium,7,244,198,46,571,571,0
2022,3,Al Bahah Region,Manufacture of Textiles,small,3,5,3,2,30,30,0
2022,3,Al Bahah Region,Manufacture of Textiles,micro,20,6,3,3,46,45,1
2022,3,Al Jawf Region,Manufacture of Textiles,small,9,5,2,3,61,61,0
2022,3,Al Jawf Region,Manufacture of Textiles,micro,55,9,5,4,131,130,1
2022,3,Northern Borders Region,Manufacture of Textiles,small,2,0,0,0,15,15,0
2022,3,Northern Borders Region,Manufacture of Textiles,micro,27,6,4,2,57,57,0
2022,3,Riyadh Region,Manufacture of Textiles,small,108,215,79,136,1084,1079,5
2022,3,Riyadh Region,Manufacture of Textiles,large,6,1468,986,482,3782,3755,27
2022,3,Riyadh Region,Manufacture of Textiles,micro,495,93,42,51,1103,1095,8
2022,3,Riyadh Region,Manufacture of Textiles,medium,12,373,236,137,1041,1039,2
2022,3,Qassim Region,Manufacture of Textiles,small,15,25,23,2,123,123,0
2022,3,Qassim Region,Manufacture of Textiles,micro,89,21,11,10,206,206,0
2022,3,Qassim Region,Manufacture of Textiles,medium,1,18,8,10,52,52,0
2022,3,Al Madinah Region,Manufacture of Textiles,small,21,44,36,8,216,216,0
2022,3,Al Madinah Region,Manufacture of Textiles,micro,135,21,10,11,292,281,11
2022,3,Al Madinah Region,Manufacture of Textiles,medium,4,93,56,37,324,324,0
2022,3,Tabuk Region,Manufacture of Textiles,small,6,4,1,3,39,39,0
2022,3,Tabuk Region,Manufacture of Textiles,micro,68,14,10,4,166,164,2
2022,3,Jazan Region,Manufacture of Textiles,small,1,1,1,0,7,7,0
2022,3,Jazan Region,Manufacture of Textiles,micro,30,3,2,1,70,70,0
2022,3,Hail Region,Manufacture of Textiles,small,6,14,8,6,69,69,0
2022,3,Hail Region,Manufacture of Textiles,micro,54,4,1,3,140,138,2
2022,3,Aseer Region,Manufacture of Textiles,small,5,5,3,2,41,41,0
2022,3,Aseer Region,Manufacture of Textiles,micro,71,16,9,7,165,162,3
2022,3,Makkah Region,Manufacture of Textiles,small,55,131,53,78,656,653,3
2022,3,Makkah Region,Manufacture of Textiles,large,2,238,229,9,663,663,0
2022,3,Makkah Region,Manufacture of Textiles,micro,279,55,36,19,612,597,15
2022,3,Makkah Region,Manufacture of Textiles,medium,10,269,174,95,810,809,1
2022,3,Najran Region,Manufacture of Textiles,small,3,4,2,2,29,24,5
2022,3,Najran Region,Manufacture of Textiles,micro,52,6,3,3,121,119,2
2022,3,Eastern Province,Manufacture of Food Products,small,317,1109,559,550,4238,4229,9
2022,3,Eastern Province,Manufacture of Food Products,large,16,1564,854,710,5020,5011,9
2022,3,Eastern Province,Manufacture of Food Products,micro,736,241,117,124,1482,1478,4
2022,3,Eastern Province,Manufacture of Food Products,medium,77,1739,975,764,5342,5323,19
2022,3,Al Bahah Region,Manufacture of Food Products,small,17,44,24,20,201,200,1
2022,3,Al Bahah Region,Manufacture of Food Products,micro,97,20,12,8,200,200,0
2022,3,Al Jawf Region,Manufacture of Food Products,small,40,67,49,18,361,360,1
2022,3,Al Jawf Region,Manufacture of Food Products,micro,167,30,23,7,351,351,0
2022,3,Al Jawf Region,Manufacture of Food Products,medium,2,58,52,6,131,131,0
2022,3,Northern Borders Region,Manufacture of Food Products,small,17,24,15,9,186,186,0
2022,3,Northern Borders Region,Manufacture of Food Products,micro,99,9,3,6,212,212,0
2022,3,Northern Borders Region,Manufacture of Food Products,medium,1,10,8,2,60,60,0
2022,3,Riyadh Region,Manufacture of Food Products,small,572,1871,834,1037,8094,8050,44
2022,3,Riyadh Region,Manufacture of Food Products,large,47,7527,5361,2166,24685,24617,68
2022,3,Riyadh Region,Manufacture of Food Products,micro,1805,470,202,268,3742,3711,31
2022,3,Riyadh Region,Manufacture of Food Products,medium,155,3498,1857,1641,12465,12393,72
2022,3,Qassim Region,Manufacture of Food Products,small,123,518,298,220,1824,1820,4
2022,3,Qassim Region,Manufacture of Food Products,large,10,931,607,324,3441,3308,133
2022,3,Qassim Region,Manufacture of Food Products,micro,375,79,52,27,778,777,1
2022,3,Qassim Region,Manufacture of Food Products,medium,52,1166,652,514,4478,4473,5
2022,3,Al Madinah Region,Manufacture of Food Products,small,128,351,185,166,1609,1600,9
2022,3,Al Madinah Region,Manufacture of Food Products,large,1,130,91,39,340,340,0
2022,3,Al Madinah Region,Manufacture of Food Products,micro,499,150,78,72,1031,1015,16
2022,3,Al Madinah Region,Manufacture of Food Products,medium,15,491,335,156,1245,1244,1
2022,3,Tabuk Region,Manufacture of Food Products,small,34,81,43,38,404,403,1
2022,3,Tabuk Region,Manufacture of Food Products,large,2,212,49,163,600,599,1
2022,3,Tabuk Region,Manufacture of Food Products,micro,213,45,22,23,407,407,0
2022,3,Tabuk Region,Manufacture of Food Products,medium,7,124,39,85,535,535,0
2022,3,Jazan Region,Manufacture of Food Products,small,58,140,77,63,713,707,6
2022,3,Jazan Region,Manufacture of Food Products,micro,281,55,40,15,596,592,4
2022,3,Jazan Region,Manufacture of Food Products,medium,5,141,73,68,553,552,1
2022,3,Hail Region,Manufacture of Food Products,small,39,108,41,67,503,502,1
2022,3,Hail Region,Manufacture of Food Products,large,1,71,33,38,202,201,1
2022,3,Hail Region,Manufacture of Food Products,micro,207,38,20,18,430,429,1
2022,3,Hail Region,Manufacture of Food Products,medium,7,214,72,142,580,577,3
2022,3,Aseer Region,Manufacture of Food Products,small,85,231,112,119,1131,1130,1
2022,3,Aseer Region,Manufacture of Food Products,large,3,276,154,122,1322,1322,0
2022,3,Aseer Region,Manufacture of Food Products,micro,514,104,63,41,937,937,0
2022,3,Aseer Region,Manufacture of Food Products,medium,16,400,250,150,1271,1270,1
2022,3,Makkah Region,Manufacture of Food Products,small,404,1258,606,652,5424,5376,48
2022,3,Makkah Region,Manufacture of Food Products,large,38,6244,3388,2856,15939,15593,346
2022,3,Makkah Region,Manufacture of Food Products,micro,1422,429,217,212,2956,2933,23
2022,3,Makkah Region,Manufacture of Food Products,medium,92,2281,1133,1148,7547,7489,58
2022,3,Najran Region,Manufacture of Food Products,small,19,34,15,19,211,211,0
2022,3,Najran Region,Manufacture of Food Products,micro,170,37,17,20,375,373,2
2022,3,Eastern Province,Manufacture of Basic Pharmaceuticals and Pharmaceutical Preparations,small,9,54,28,26,123,110,13
2022,3,Eastern Province,Manufacture of Basic Pharmaceuticals and Pharmaceutical Preparations,large,1,155,96,59,390,388,2
2022,3,Eastern Province,Manufacture of Basic Pharmaceuticals and Pharmaceutical Preparations,micro,11,4,1,3,27,22,5
2022,3,Eastern Province,Manufacture of Basic Pharmaceuticals and Pharmaceutical Preparations,medium,4,182,132,50,217,216,1
2022,3,Al Jawf Region,Manufacture of Basic Pharmaceuticals and Pharmaceutical Preparations,micro,7,1,1,0,19,19,0
2022,3,Northern Borders Region,Manufacture of Basic Pharmaceuticals and Pharmaceutical Preparations,small,1,1,0,1,5,5,0
2022,3,Riyadh Region,Manufacture of Basic Pharmaceuticals and Pharmaceutical Preparations,small,28,187,88,99,363,356,7
2022,3,Riyadh Region,Manufacture of Basic Pharmaceuticals and Pharmaceutical Preparations,large,5,571,287,284,1424,1394,30
2022,3,Riyadh Region,Manufacture of Basic Pharmaceuticals and Pharmaceutical Preparations,micro,200,41,25,16,579,577,2
2022,3,Riyadh Region,Manufacture of Basic Pharmaceuticals and Pharmaceutical Preparations,medium,8,222,81,141,559,550,9
2022,3,Qassim Region,Manufacture of Basic Pharmaceuticals and Pharmaceutical Preparations,small,1,7,1,6,17,17,0
2022,3,Qassim Region,Manufacture of Basic Pharmaceuticals and Pharmaceutical Preparations,large,1,294,279,15,308,308,0
2022,3,Qassim Region,Manufacture of Basic Pharmaceuticals and Pharmaceutical Preparations,micro,12,1,0,1,27,27,0
2022,3,Qassim Region,Manufacture of Basic Pharmaceuticals and Pharmaceutical Preparations,medium,1,30,25,5,91,81,10
2022,3,Al Madinah Region,Manufacture of Basic Pharmaceuticals and Pharmaceutical Preparations,small,1,11,8,3,30,30,0
2022,3,Al Madinah Region,Manufacture of Basic Pharmaceuticals and Pharmaceutical Preparations,micro,5,1,0,1,7,7,0
2022,3,Tabuk Region,Manufacture of Basic Pharmaceuticals and Pharmaceutical Preparations,micro,2,0,0,0,5,5,0
2022,3,Jazan Region,Manufacture of Basic Pharmaceuticals and Pharmaceutical Preparations,micro,6,0,0,0,13,11,2
2022,3,Hail Region,Manufacture of Basic Pharmaceuticals and Pharmaceutical Preparations,small,1,2,0,2,6,6,0
2022,3,Hail Region,Manufacture of Basic Pharmaceuticals and Pharmaceutical Preparations,micro,5,2,2,0,13,13,0
2022,3,Hail Region,Manufacture of Basic Pharmaceuticals and Pharmaceutical Preparations,medium,1,74,47,27,58,57,1
2022,3,Aseer Region,Manufacture of Basic Pharmaceuticals and Pharmaceutical Preparations,micro,6,4,2,2,18,18,0
2022,3,Aseer Region,Manufacture of Basic Pharmaceuticals and Pharmaceutical Preparations,medium,1,17,5,12,37,32,5
2022,3,Makkah Region,Manufacture of Basic Pharmaceuticals and Pharmaceutical Preparations,small,10,63,44,19,119,114,5
2022,3,Makkah Region,Manufacture of Basic Pharmaceuticals and Pharmaceutical Preparations,large,2,590,313,277,671,650,21
2022,3,Makkah Region,Manufacture of Basic Pharmaceuticals and Pharmaceutical Preparations,micro,23,17,13,4,40,40,0
2022,3,Makkah Region,Manufacture of Basic Pharmaceuticals and Pharmaceutical Preparations,medium,8,430,214,216,600,577,23
2022,3,Najran Region,Manufacture of Basic Pharmaceuticals and Pharmaceutical Preparations,small,1,1,0,1,10,10,0
2022,3,Najran Region,Manufacture of Basic Pharmaceuticals and Pharmaceutical Preparations,micro,2,1,0,1,7,7,0
2022,3,Eastern Province,Manufacture of Leather and Leather Products,small,9,21,10,11,156,156,0
2022,3,Eastern Province,Manufacture of Leather and Leather Products,micro,15,2,2,0,33,33,0
2022,3,Eastern Province,Manufacture of Leather and Leather Products,medium,1,49,49,0,88,88,0
2022,3,Al Bahah Region,Manufacture of Leather and Leather Products,micro,1,0,0,0,2,2,0
2022,3,Al Jawf Region,Manufacture of Leather and Leather Products,micro,2,1,1,0,6,6,0
2022,3,Northern Borders Region,Manufacture of Leather and Leather Products,small,3,1,1,0,25,25,0
2022,3,Northern Borders Region,Manufacture of Leather and Leather Products,micro,4,0,0,0,13,13,0
2022,3,Riyadh Region,Manufacture of Leather and Leather Products,small,42,39,18,21,452,450,2
2022,3,Riyadh Region,Manufacture of Leather and Leather Products,large,2,154,41,113,615,614,1
2022,3,Riyadh Region,Manufacture of Leather and Leather Products,micro,67,7,3,4,172,172,0
2022,3,Riyadh Region,Manufacture of Leather and Leather Products,medium,6,146,47,99,563,562,1
2022,3,Qassim Region,Manufacture of Leather and Leather Products,micro,9,1,0,1,21,21,0
2022,3,Al Madinah Region,Manufacture of Leather and Leather Products,small,2,2,0,2,20,20,0
2022,3,Al Madinah Region,Manufacture of Leather and Leather Products,micro,10,3,3,0,25,24,1
2022,3,Al Madinah Region,Manufacture of Leather and Leather Products,medium,1,10,4,6,53,53,0
2022,3,Tabuk Region,Manufacture of Leather and Leather Products,micro,1,0,0,0,1,1,0
2022,3,Jazan Region,Manufacture of Leather and Leather Products,small,1,0,0,0,7,7,0
2022,3,Jazan Region,Manufacture of Leather and Leather Products,micro,54,4,3,1,190,190,0
2022,3,Hail Region,Manufacture of Leather and Leather Products,small,2,0,0,0,14,14,0
2022,3,Hail Region,Manufacture of Leather and Leather Products,micro,7,1,0,1,23,23,0
2022,3,Aseer Region,Manufacture of Leather and Leather Products,small,2,0,0,0,23,23,0
2022,3,Aseer Region,Manufacture of Leather and Leather Products,micro,11,3,2,1,23,23,0
2022,3,Makkah Region,Manufacture of Leather and Leather Products,small,10,34,14,20,159,158,1
2022,3,Makkah Region,Manufacture of Leather and Leather Products,micro,32,7,3,4,77,77,0
2022,3,Makkah Region,Manufacture of Leather and Leather Products,medium,1,10,7,3,42,42,0
2022,3,Najran Region,Manufacture of Leather and Leather Products,micro,3,0,0,0,4,4,0
2022,3,Eastern Province,Manufacture of Wearing Apparel,small,223,513,199,314,2079,1844,235
2022,3,Eastern Province,Manufacture of Wearing Apparel,large,1,72,4,68,191,188,3
2022,3,Eastern Province,Manufacture of Wearing Apparel,micro,2285,400,162,238,4741,4457,284
2022,3,Eastern Province,Manufacture of Wearing Apparel,medium,11,302,94,208,647,644,3
2022,3,Al Bahah Region,Manufacture of Wearing Apparel,small,11,22,11,11,107,88,19
2022,3,Al Bahah Region,Manufacture of Wearing Apparel,micro,163,31,19,12,298,256,42
2022,3,Al Jawf Region,Manufacture of Wearing Apparel,small,13,18,13,5,87,77,10
2022,3,Al Jawf Region,Manufacture of Wearing Apparel,micro,295,37,19,18,600,559,41
2022,3,Northern Borders Region,Manufacture of Wearing Apparel,small,4,8,3,5,23,15,8
2022,3,Northern Borders Region,Manufacture of Wearing Apparel,micro,283,30,16,14,679,644,35
2022,3,Riyadh Region,Manufacture of Wearing Apparel,small,421,1005,328,677,4127,3714,413
2022,3,Riyadh Region,Manufacture of Wearing Apparel,large,6,873,135,738,1525,1490,35
2022,3,Riyadh Region,Manufacture of Wearing Apparel,micro,3815,719,254,465,7869,7210,659
2022,3,Riyadh Region,Manufacture of Wearing Apparel,medium,25,533,156,377,1833,1644,189
2022,3,Qassim Region,Manufacture of Wearing Apparel,small,32,65,32,33,247,191,56
2022,3,Qassim Region,Manufacture of Wearing Apparel,micro,823,101,47,54,1701,1580,121
2022,3,Qassim Region,Manufacture of Wearing Apparel,medium,4,95,65,30,243,243,0
2022,3,Al Madinah Region,Manufacture of Wearing Apparel,small,49,80,34,46,378,319,59
2022,3,Al Madinah Region,Manufacture of Wearing Apparel,micro,1050,144,67,77,2108,1862,246
2022,3,Al Madinah Region,Manufacture of Wearing Apparel,medium,3,70,35,35,216,211,5
2022,3,Tabuk Region,Manufacture of Wearing Apparel,small,25,36,14,22,210,198,12
2022,3,Tabuk Region,Manufacture of Wearing Apparel,micro,813,80,41,39,2079,2035,44
2022,3,Tabuk Region,Manufacture of Wearing Apparel,medium,1,0,0,0,105,105,0
2022,3,Jazan Region,Manufacture of Wearing Apparel,small,24,25,16,9,153,134,19
2022,3,Jazan Region,Manufacture of Wearing Apparel,micro,635,54,26,28,1357,1244,113
2022,3,Hail Region,Manufacture of Wearing Apparel,small,23,30,4,26,180,169,11
2022,3,Hail Region,Manufacture of Wearing Apparel,micro,424,57,21,36,852,769,83
2022,3,Hail Region,Manufacture of Wearing Apparel,medium,1,49,9,40,95,95,0
2022,3,Aseer Region,Manufacture of Wearing Apparel,small,55,98,37,61,445,418,27
2022,3,Aseer Region,Manufacture of Wearing Apparel,micro,1053,144,77,67,2119,1914,205
2022,3,Aseer Region,Manufacture of Wearing Apparel,medium,2,41,24,17,132,132,0
2022,3,Makkah Region,Manufacture of Wearing Apparel,small,204,486,172,314,1934,1748,186
2022,3,Makkah Region,Manufacture of Wearing Apparel,large,1,141,32,109,406,406,0
2022,3,Makkah Region,Manufacture of Wearing Apparel,micro,2938,516,215,301,6005,5445,560
2022,3,Makkah Region,Manufacture of Wearing Apparel,medium,17,400,104,296,1094,1085,9
2022,3,Najran Region,Manufacture of Wearing Apparel,small,17,17,7,10,129,125,4
2022,3,Najran Region,Manufacture of Wearing Apparel,micro,416,37,11,26,934,863,71
2022,3,Najran Region,Manufacture of Wearing Apparel,medium,1,18,0,18,42,42,0
2022,3,Eastern Province,Manufacture of Electrical Equipment,small,56,299,215,84,844,841,3
2022,3,Eastern Province,Manufacture of Electrical Equipment,large,6,1798,1749,49,1300,1296,4
2022,3,Eastern Province,Manufacture of Electrical Equipment,micro,120,45,28,17,240,239,1
2022,3,Eastern Province,Manufacture of Electrical Equipment,medium,29,800,592,208,1944,1943,1
2022,3,Al Bahah Region,Manufacture of Electrical Equipment,micro,5,0,0,0,10,10,0
2022,3,Al Jawf Region,Manufacture of Electrical Equipment,small,1,1,1,0,5,5,0
2022,3,Al Jawf Region,Manufacture of Electrical Equipment,micro,13,2,2,0,22,22,0
2022,3,Northern Borders Region,Manufacture of Electrical Equipment,micro,17,0,0,0,35,35,0
2022,3,Riyadh Region,Manufacture of Electrical Equipment,small,99,354,172,182,1578,1572,6
2022,3,Riyadh Region,Manufacture of Electrical Equipment,large,8,750,687,63,2086,2084,2
2022,3,Riyadh Region,Manufacture of Electrical Equipment,micro,158,47,27,20,345,344,1
2022,3,Riyadh Region,Manufacture of Electrical Equipment,medium,57,1691,1069,622,4813,4802,11
2022,3,Qassim Region,Manufacture of Electrical Equipment,small,9,38,24,14,154,154,0
2022,3,Qassim Region,Manufacture of Electrical Equipment,micro,27,4,4,0,62,62,0
2022,3,Qassim Region,Manufacture of Electrical Equipment,medium,2,33,27,6,136,136,0
2022,3,Al Madinah Region,Manufacture of Electrical Equipment,small,11,54,36,18,149,149,0
2022,3,Al Madinah Region,Manufacture of Electrical Equipment,large,1,106,100,6,288,288,0
2022,3,Al Madinah Region,Manufacture of Electrical Equipment,micro,40,6,4,2,76,76,0
2022,3,Al Madinah Region,Manufacture of Electrical Equipment,medium,2,63,34,29,245,245,0
2022,3,Tabuk Region,Manufacture of Electrical Equipment,small,1,0,0,0,7,7,0
2022,3,Tabuk Region,Manufacture of Electrical Equipment,micro,11,1,0,1,20,20,0
2022,3,Jazan Region,Manufacture of Electrical Equipment,small,1,0,0,0,6,6,0
2022,3,Jazan Region,Manufacture of Electrical Equipment,micro,26,3,2,1,67,67,0
2022,3,Hail Region,Manufacture of Electrical Equipment,small,2,6,2,4,9,9,0
2022,3,Hail Region,Manufacture of Electrical Equipment,micro,13,3,1,2,40,40,0
2022,3,Hail Region,Manufacture of Electrical Equipment,medium,1,33,11,22,93,93,0
2022,3,Aseer Region,Manufacture of Electrical Equipment,small,5,14,9,5,63,63,0
2022,3,Aseer Region,Manufacture of Electrical Equipment,micro,29,7,5,2,54,54,0
2022,3,Aseer Region,Manufacture of Electrical Equipment,medium,1,12,5,7,46,45,1
2022,3,Makkah Region,Manufacture of Electrical Equipment,small,46,177,107,70,712,709,3
2022,3,Makkah Region,Manufacture of Electrical Equipment,large,2,301,281,20,848,846,2
2022,3,Makkah Region,Manufacture of Electrical Equipment,micro,138,39,25,14,281,278,3
2022,3,Makkah Region,Manufacture of Electrical Equipment,medium,9,230,153,77,787,784,3
2022,3,Najran Region,Manufacture of Electrical Equipment,small,2,8,6,2,31,31,0
2022,3,Najran Region,Manufacture of Electrical Equipment,micro,8,5,1,4,13,13,0
2022,3,Eastern Province,Manufacture of Beverages,small,20,80,39,41,323,323,0
2022,3,Eastern Province,Manufacture of Beverages,large,4,586,389,197,1500,1499,1
2022,3,Eastern Province,Manufacture of Beverages,micro,37,16,6,10,73,73,0
2022,3,Eastern Province,Manufacture of Beverages,medium,6,129,49,80,467,465,2
2022,3,Al Bahah Region,Manufacture of Beverages,small,3,9,8,1,55,55,0
2022,3,Al Bahah Region,Manufacture of Beverages,micro,3,0,0,0,5,5,0
2022,3,Al Bahah Region,Manufacture of Beverages,medium,2,54,10,44,190,190,0
2022,3,Al Jawf Region,Manufacture of Beverages,small,2,4,0,4,14,14,0
2022,3,Al Jawf Region,Manufacture of Beverages,micro,7,3,2,1,9,9,0
2022,3,Al Jawf Region,Manufacture of Beverages,medium,1,15,9,6,50,50,0
2022,3,Northern Borders Region,Manufacture of Beverages,small,1,2,2,0,12,12,0
2022,3,Northern Borders Region,Manufacture of Beverages,micro,1,1,0,1,0,0,0
2022,3,Riyadh Region,Manufacture of Beverages,small,43,241,113,128,597,597,0
2022,3,Riyadh Region,Manufacture of Beverages,large,12,1979,1440,539,4582,4572,10
2022,3,Riyadh Region,Manufacture of Beverages,micro,79,27,10,17,152,151,1
2022,3,Riyadh Region,Manufacture of Beverages,medium,33,832,340,492,2711,2709,2
2022,3,Qassim Region,Manufacture of Beverages,small,6,11,7,4,111,111,0
2022,3,Qassim Region,Manufacture of Beverages,large,2,376,169,207,740,740,0
2022,3,Qassim Region,Manufacture of Beverages,micro,18,4,3,1,27,27,0
2022,3,Qassim Region,Manufacture of Beverages,medium,4,131,47,84,383,383,0
2022,3,Al Madinah Region,Manufacture of Beverages,small,12,62,39,23,257,256,1
2022,3,Al Madinah Region,Manufacture of Beverages,micro,21,10,4,6,39,39,0
2022,3,Al Madinah Region,Manufacture of Beverages,medium,5,155,65,90,524,524,0
2022,3,Tabuk Region,Manufacture of Beverages,small,4,23,15,8,73,73,0
2022,3,Tabuk Region,Manufacture of Beverages,micro,18,5,3,2,38,38,0
2022,3,Tabuk Region,Manufacture of Beverages,medium,2,75,44,31,152,152,0
2022,3,Jazan Region,Manufacture of Beverages,small,6,20,8,12,71,71,0
2022,3,Jazan Region,Manufacture of Beverages,large,2,118,68,50,413,413,0
2022,3,Jazan Region,Manufacture of Beverages,micro,20,3,1,2,47,47,0
2022,3,Jazan Region,Manufacture of Beverages,medium,4,132,90,42,400,400,0
2022,3,Hail Region,Manufacture of Beverages,small,6,30,15,15,102,101,1
2022,3,Hail Region,Manufacture of Beverages,large,1,85,38,47,209,209,0
2022,3,Hail Region,Manufacture of Beverages,micro,5,2,2,0,6,6,0
2022,3,Aseer Region,Manufacture of Beverages,small,12,31,23,8,181,181,0
2022,3,Aseer Region,Manufacture of Beverages,large,1,131,121,10,307,307,0
2022,3,Aseer Region,Manufacture of Beverages,micro,24,4,2,2,48,48,0
2022,3,Aseer Region,Manufacture of Beverages,medium,2,54,32,22,124,124,0
2022,3,Makkah Region,Manufacture of Beverages,small,39,147,76,71,605,604,1
2022,3,Makkah Region,Manufacture of Beverages,large,7,1173,919,254,2346,2340,6
2022,3,Makkah Region,Manufacture of Beverages,micro,106,32,18,14,207,206,1
2022,3,Makkah Region,Manufacture of Beverages,medium,22,548,299,249,1659,1655,4
2022,3,Najran Region,Manufacture of Beverages,small,3,18,6,12,72,72,0
2022,3,Najran Region,Manufacture of Beverages,micro,5,2,1,1,11,11,0
2022,3,Najran Region,Manufacture of Beverages,medium,1,85,65,20,123,123,0
2022,3,Eastern Province,Manufacture of Basic Metals,small,98,488,325,163,1534,1534,0
2022,3,Eastern Province,Manufacture of Basic Metals,large,17,2562,2376,186,4517,4517,0
2022,3,Eastern Province,Manufacture of Basic Metals,micro,112,53,38,15,222,222,0
2022,3,Eastern Province,Manufacture of Basic Metals,medium,61,1974,1502,472,5043,5043,0
2022,3,Al Bahah Region,Manufacture of Basic Metals,micro,11,3,3,0,19,19,0
2022,3,Al Jawf Region,Manufacture of Basic Metals,small,2,0,0,0,12,12,0
2022,3,Al Jawf Region,Manufacture of Basic Metals,micro,15,3,3,0,35,35,0
2022,3,Northern Borders Region,Manufacture of Basic Metals,micro,11,4,4,0,28,28,0
2022,3,Riyadh Region,Manufacture of Basic Metals,small,194,669,335,334,2844,2828,16
2022,3,Riyadh Region,Manufacture of Basic Metals,large,9,767,531,236,2433,2428,5
2022,3,Riyadh Region,Manufacture of Basic Metals,micro,351,99,57,42,755,753,2
2022,3,Riyadh Region,Manufacture of Basic Metals,medium,57,1413,834,579,4778,4756,22
2022,3,Qassim Region,Manufacture of Basic Metals,small,13,30,20,10,294,294,0
2022,3,Qassim Region,Manufacture of Basic Metals,micro,75,8,4,4,168,166,2
2022,3,Qassim Region,Manufacture of Basic Metals,medium,4,47,32,15,252,252,0
2022,3,Al Madinah Region,Manufacture of Basic Metals,small,12,24,19,5,143,142,1
2022,3,Al Madinah Region,Manufacture of Basic Metals,micro,51,15,4,11,109,109,0
2022,3,Al Madinah Region,Manufacture of Basic Metals,medium,3,223,199,24,282,282,0
2022,3,Tabuk Region,Manufacture of Basic Metals,small,2,1,0,1,15,15,0
2022,3,Tabuk Region,Manufacture of Basic Metals,micro,12,3,2,1,22,22,0
2022,3,Tabuk Region,Manufacture of Basic Metals,medium,2,44,18,26,137,137,0
2022,3,Jazan Region,Manufacture of Basic Metals,small,3,9,3,6,28,28,0
2022,3,Jazan Region,Manufacture of Basic Metals,large,1,150,150,0,115,115,0
2022,3,Jazan Region,Manufacture of Basic Metals,micro,35,2,1,1,63,63,0
2022,3,Jazan Region,Manufacture of Basic Metals,medium,2,106,91,15,243,243,0
2022,3,Hail Region,Manufacture of Basic Metals,small,3,3,2,1,22,22,0
2022,3,Hail Region,Manufacture of Basic Metals,micro,35,3,2,1,82,82,0
2022,3,Hail Region,Manufacture of Basic Metals,medium,2,26,10,16,93,93,0
2022,3,Aseer Region,Manufacture of Basic Metals,small,17,45,36,9,183,183,0
2022,3,Aseer Region,Manufacture of Basic Metals,micro,68,12,8,4,139,139,0
2022,3,Aseer Region,Manufacture of Basic Metals,medium,2,43,42,1,150,150,0
2022,3,Makkah Region,Manufacture of Basic Metals,small,86,353,202,151,1217,1214,3
2022,3,Makkah Region,Manufacture of Basic Metals,large,11,1233,847,386,2879,2877,2
2022,3,Makkah Region,Manufacture of Basic Metals,micro,174,62,30,32,358,355,3
2022,3,Makkah Region,Manufacture of Basic Metals,medium,32,854,636,218,2703,2691,12
2022,3,Najran Region,Manufacture of Basic Metals,small,3,0,0,0,24,24,0
2022,3,Najran Region,Manufacture of Basic Metals,large,1,206,203,3,358,357,1
2022,3,Najran Region,Manufacture of Basic Metals,micro,43,6,5,1,84,84,0
2022,3,Najran Region,Manufacture of Basic Metals,medium,1,30,16,14,111,111,0
2022,3,Eastern Province,"Manufacture of Wood and Wood Products (Except Furniture), Manufacture of Straw and Plaiting Materials",small,174,401,209,192,1953,1949,4
2022,3,Eastern Province,"Manufacture of Wood and Wood Products (Except Furniture), Manufacture of Straw and Plaiting Materials",large,1,59,59,0,238,238,0
2022,3,Eastern Province,"Manufacture of Wood and Wood Products (Except Furniture), Manufacture of Straw and Plaiting Materials",micro,421,155,72,83,959,957,2
2022,3,Eastern Province,"Manufacture of Wood and Wood Products (Except Furniture), Manufacture of Straw and Plaiting Materials",medium,14,327,204,123,1176,1174,2
2022,3,Al Bahah Region,"Manufacture of Wood and Wood Products (Except Furniture), Manufacture of Straw and Plaiting Materials",small,16,22,16,6,99,99,0
2022,3,Al Bahah Region,"Manufacture of Wood and Wood Products (Except Furniture), Manufacture of Straw and Plaiting Materials",micro,79,16,9,7,168,167,1
2022,3,Al Jawf Region,"Manufacture of Wood and Wood Products (Except Furniture), Manufacture of Straw and Plaiting Materials",small,12,14,9,5,89,89,0
2022,3,Al Jawf Region,"Manufacture of Wood and Wood Products (Except Furniture), Manufacture of Straw and Plaiting Materials",micro,79,12,9,3,166,165,1
2022,3,Northern Borders Region,"Manufacture of Wood and Wood Products (Except Furniture), Manufacture of Straw and Plaiting Materials",small,3,4,3,1,16,16,0
2022,3,Northern Borders Region,"Manufacture of Wood and Wood Products (Except Furniture), Manufacture of Straw and Plaiting Materials",micro,53,4,2,2,104,104,0
2022,3,Riyadh Region,"Manufacture of Wood and Wood Products (Except Furniture), Manufacture of Straw and Plaiting Materials",small,292,715,288,427,3169,3151,18
2022,3,Riyadh Region,"Manufacture of Wood and Wood Products (Except Furniture), Manufacture of Straw and Plaiting Materials",micro,896,257,106,151,2064,2054,10
2022,3,Riyadh Region,"Manufacture of Wood and Wood Products (Except Furniture), Manufacture of Straw and Plaiting Materials",medium,28,619,207,412,2134,2063,71
2022,3,Qassim Region,"Manufacture of Wood and Wood Products (Except Furniture), Manufacture of Straw and Plaiting Materials",small,21,50,28,22,260,260,0
2022,3,Qassim Region,"Manufacture of Wood and Wood Products (Except Furniture), Manufacture of Straw and Plaiting Materials",large,1,66,43,23,202,202,0
2022,3,Qassim Region,"Manufacture of Wood and Wood Products (Except Furniture), Manufacture of Straw and Plaiting Materials",micro,279,56,28,28,661,661,0
2022,3,Al Madinah Region,"Manufacture of Wood and Wood Products (Except Furniture), Manufacture of Straw and Plaiting Materials",small,25,66,42,24,229,229,0
2022,3,Al Madinah Region,"Manufacture of Wood and Wood Products (Except Furniture), Manufacture of Straw and Plaiting Materials",micro,159,40,22,18,374,374,0
2022,3,Al Madinah Region,"Manufacture of Wood and Wood Products (Except Furniture), Manufacture of Straw and Plaiting Materials",medium,1,9,7,2,50,50,0
2022,3,Tabuk Region,"Manufacture of Wood and Wood Products (Except Furniture), Manufacture of Straw and Plaiting Materials",small,15,17,9,8,88,88,0
2022,3,Tabuk Region,"Manufacture of Wood and Wood Products (Except Furniture), Manufacture of Straw and Plaiting Materials",micro,85,11,4,7,194,194,0
2022,3,Jazan Region,"Manufacture of Wood and Wood Products (Except Furniture), Manufacture of Straw and Plaiting Materials",small,17,30,9,21,124,123,1
2022,3,Jazan Region,"Manufacture of Wood and Wood Products (Except Furniture), Manufacture of Straw and Plaiting Materials",micro,194,31,18,13,472,471,1
2022,3,Jazan Region,"Manufacture of Wood and Wood Products (Except Furniture), Manufacture of Straw and Plaiting Materials",medium,1,20,2,18,67,67,0
2022,3,Hail Region,"Manufacture of Wood and Wood Products (Except Furniture), Manufacture of Straw and Plaiting Materials",small,12,31,15,16,122,121,1
2022,3,Hail Region,"Manufacture of Wood and Wood Products (Except Furniture), Manufacture of Straw and Plaiting Materials",micro,52,12,6,6,111,111,0
2022,3,Aseer Region,"Manufacture of Wood and Wood Products (Except Furniture), Manufacture of Straw and Plaiting Materials",small,36,72,46,26,345,344,1
2022,3,Aseer Region,"Manufacture of Wood and Wood Products (Except Furniture), Manufacture of Straw and Plaiting Materials",micro,292,68,33,35,650,649,1
2022,3,Aseer Region,"Manufacture of Wood and Wood Products (Except Furniture), Manufacture of Straw and Plaiting Materials",medium,1,13,6,7,44,44,0
2022,3,Makkah Region,"Manufacture of Wood and Wood Products (Except Furniture), Manufacture of Straw and Plaiting Materials",small,121,289,125,164,1257,1255,2
2022,3,Makkah Region,"Manufacture of Wood and Wood Products (Except Furniture), Manufacture of Straw and Plaiting Materials",large,2,203,170,33,577,577,0
2022,3,Makkah Region,"Manufacture of Wood and Wood Products (Except Furniture), Manufacture of Straw and Plaiting Materials",micro,662,148,83,65,1482,1473,9
2022,3,Makkah Region,"Manufacture of Wood and Wood Products (Except Furniture), Manufacture of Straw and Plaiting Materials",medium,12,279,174,105,848,840,8
2022,3,Najran Region,"Manufacture of Wood and Wood Products (Except Furniture), Manufacture of Straw and Plaiting Materials",small,4,5,2,3,27,27,0
2022,3,Najran Region,"Manufacture of Wood and Wood Products (Except Furniture), Manufacture of Straw and Plaiting Materials",micro,82,10,6,4,183,183,0
2022,3,Eastern Province,"Manufacture of Computers, Electronic and Optical Products",small,20,113,88,25,274,274,0
2022,3,Eastern Province,"Manufacture of Computers, Electronic and Optical Products",micro,52,26,18,8,74,73,1
2022,3,Eastern Province,"Manufacture of Computers, Electronic and Optical Products",medium,5,173,112,61,361,359,2
2022,3,Al Bahah Region,"Manufacture of Computers, Electronic and Optical Products",micro,7,6,6,0,9,9,0
2022,3,Al Jawf Region,"Manufacture of Computers, Electronic and Optical Products",micro,4,1,0,1,13,13,0
2022,3,Northern Borders Region,"Manufacture of Computers, Electronic and Optical Products",micro,3,3,2,1,6,6,0
2022,3,Riyadh Region,"Manufacture of Computers, Electronic and Optical Products",small,25,92,59,33,329,329,0
2022,3,Riyadh Region,"Manufacture of Computers, Electronic and Optical Products",micro,62,27,17,10,107,107,0
2022,3,Riyadh Region,"Manufacture of Computers, Electronic and Optical Products",medium,2,11,3,8,132,126,6
2022,3,Qassim Region,"Manufacture of Computers, Electronic and Optical Products",micro,9,1,1,0,12,12,0
2022,3,Al Madinah Region,"Manufacture of Computers, Electronic and Optical Products",small,3,17,15,2,22,22,0
2022,3,Al Madinah Region,"Manufacture of Computers, Electronic and Optical Products",micro,16,4,3,1,34,34,0
2022,3,Tabuk Region,"Manufacture of Computers, Electronic and Optical Products",micro,11,1,0,1,16,16,0
2022,3,Jazan Region,"Manufacture of Computers, Electronic and Optical Products",small,1,0,0,0,17,17,0
2022,3,Jazan Region,"Manufacture of Computers, Electronic and Optical Products",micro,22,1,1,0,39,39,0
2022,3,Hail Region,"Manufacture of Computers, Electronic and Optical Products",micro,7,0,0,0,17,17,0
2022,3,Aseer Region,"Manufacture of Computers, Electronic and Optical Products",small,2,3,2,1,11,11,0
2022,3,Aseer Region,"Manufacture of Computers, Electronic and Optical Products",micro,43,3,1,2,89,89,0
2022,3,Makkah Region,"Manufacture of Computers, Electronic and Optical Products",small,20,33,18,15,169,167,2
2022,3,Makkah Region,"Manufacture of Computers, Electronic and Optical Products",micro,140,51,32,19,242,241,1
2022,3,Makkah Region,"Manufacture of Computers, Electronic and Optical Products",medium,3,137,116,21,253,251,2
2022,3,Najran Region,"Manufacture of Computers, Electronic and Optical Products",micro,7,1,0,1,16,16,0
2022,3,Eastern Province,Manufacture of Furniture,small,157,480,239,241,2044,2036,8
2022,3,Eastern Province,Manufacture of Furniture,large,3,150,96,54,674,672,2
2022,3,Eastern Province,Manufacture of Furniture,micro,548,138,64,74,1277,1276,1
2022,3,Eastern Province,Manufacture of Furniture,medium,32,595,356,239,2336,2332,4
2022,3,Al Bahah Region,Manufacture of Furniture,small,4,3,2,1,35,35,0
2022,3,Al Bahah Region,Manufacture of Furniture,micro,82,12,9,3,187,187,0
2022,3,Al Jawf Region,Manufacture of Furniture,small,7,11,8,3,53,53,0
2022,3,Al Jawf Region,Manufacture of Furniture,micro,121,17,8,9,268,267,1
2022,3,Northern Borders Region,Manufacture of Furniture,small,4,9,4,5,34,34,0
2022,3,Northern Borders Region,Manufacture of Furniture,micro,90,16,10,6,237,237,0
2022,3,Riyadh Region,Manufacture of Furniture,small,471,1041,426,615,6176,6160,16
2022,3,Riyadh Region,Manufacture of Furniture,large,11,871,427,444,3186,3179,7
2022,3,Riyadh Region,Manufacture of Furniture,micro,1338,244,106,138,3265,3254,11
2022,3,Riyadh Region,Manufacture of Furniture,medium,81,1754,749,1005,5937,5911,26
2022,3,Qassim Region,Manufacture of Furniture,small,56,137,99,38,657,652,5
2022,3,Qassim Region,Manufacture of Furniture,large,1,72,23,49,364,364,0
2022,3,Qassim Region,Manufacture of Furniture,micro,230,44,31,13,556,555,1
2022,3,Qassim Region,Manufacture of Furniture,medium,8,118,74,44,563,562,1
2022,3,Al Madinah Region,Manufacture of Furniture,small,39,49,30,19,407,405,2
2022,3,Al Madinah Region,Manufacture of Furniture,micro,263,50,32,18,604,602,2
2022,3,Al Madinah Region,Manufacture of Furniture,medium,1,15,9,6,41,41,0
2022,3,Tabuk Region,Manufacture of Furniture,small,21,13,4,9,180,180,0
2022,3,Tabuk Region,Manufacture of Furniture,micro,202,26,14,12,515,515,0
2022,3,Jazan Region,Manufacture of Furniture,small,22,15,9,6,176,176,0
2022,3,Jazan Region,Manufacture of Furniture,micro,353,49,22,27,938,934,4
2022,3,Hail Region,Manufacture of Furniture,small,22,40,24,16,260,259,1
2022,3,Hail Region,Manufacture of Furniture,micro,153,21,12,9,364,364,0
2022,3,Aseer Region,Manufacture of Furniture,small,73,142,94,48,786,785,1
2022,3,Aseer Region,Manufacture of Furniture,micro,555,86,54,32,1300,1297,3
2022,3,Aseer Region,Manufacture of Furniture,medium,2,13,10,3,132,132,0
2022,3,Makkah Region,Manufacture of Furniture,small,136,292,140,152,1562,1552,10
2022,3,Makkah Region,Manufacture of Furniture,large,1,81,54,27,283,282,1
2022,3,Makkah Region,Manufacture of Furniture,micro,698,138,74,64,1631,1621,10
2022,3,Makkah Region,Manufacture of Furniture,medium,26,648,277,371,2384,2376,8
2022,3,Najran Region,Manufacture of Furniture,small,16,12,6,6,169,169,0
2022,3,Najran Region,Manufacture of Furniture,micro,116,16,3,13,292,292,0
2022,3,Najran Region,Manufacture of Furniture,medium,3,68,17,51,344,344,0
2022,3,Eastern Province,Manufacture of Other Transport Equipment,small,5,39,25,14,140,140,0
2022,3,Eastern Province,Manufacture of Other Transport Equipment,large,2,2182,2147,35,670,669,1
2022,3,Eastern Province,Manufacture of Other Transport Equipment,micro,14,5,3,2,28,27,1
2022,3,Eastern Province,Manufacture of Other Transport Equipment,medium,2,79,74,5,243,243,0
2022,3,Al Bahah Region,Manufacture of Other Transport Equipment,micro,1,0,0,0,1,1,0
2022,3,Al Jawf Region,Manufacture of Other Transport Equipment,micro,2,0,0,0,4,4,0
2022,3,Northern Borders Region,Manufacture of Other Transport Equipment,micro,1,0,0,0,4,4,0
2022,3,Riyadh Region,Manufacture of Other Transport Equipment,small,17,99,77,22,241,240,1
2022,3,Riyadh Region,Manufacture of Other Transport Equipment,large,1,1302,1277,25,606,606,0
2022,3,Riyadh Region,Manufacture of Other Transport Equipment,micro,68,16,8,8,159,159,0
2022,3,Riyadh Region,Manufacture of Other Transport Equipment,medium,4,192,122,70,379,379,0
2022,3,Qassim Region,Manufacture of Other Transport Equipment,micro,1,0,0,0,1,1,0
2022,3,Al Madinah Region,Manufacture of Other Transport Equipment,small,1,0,0,0,12,12,0
2022,3,Al Madinah Region,Manufacture of Other Transport Equipment,micro,7,2,1,1,14,14,0
2022,3,Tabuk Region,Manufacture of Other Transport Equipment,micro,1,1,0,1,1,1,0
2022,3,Jazan Region,Manufacture of Other Transport Equipment,small,2,7,7,0,27,27,0
2022,3,Jazan Region,Manufacture of Other Transport Equipment,micro,4,0,0,0,12,12,0
2022,3,Hail Region,Manufacture of Other Transport Equipment,micro,1,0,0,0,3,3,0
2022,3,Aseer Region,Manufacture of Other Transport Equipment,small,1,0,0,0,10,10,0
2022,3,Aseer Region,Manufacture of Other Transport Equipment,micro,4,0,0,0,11,11,0
2022,3,Makkah Region,Manufacture of Other Transport Equipment,small,5,29,19,10,91,90,1
2022,3,Makkah Region,Manufacture of Other Transport Equipment,micro,32,9,6,3,64,63,1
2022,3,Makkah Region,Manufacture of Other Transport Equipment,medium,2,29,17,12,110,110,0
2022,3,Najran Region,Manufacture of Other Transport Equipment,small,2,0,0,0,19,19,0
2022,3,Najran Region,Manufacture of Other Transport Equipment,micro,3,1,0,1,6,6,0
2022,3,Eastern Province,"Manufacture of Motor Vehicles, Trailers, and Semi-Trailers",small,26,125,81,44,385,385,0
2022,3,Eastern Province,"Manufacture of Motor Vehicles, Trailers, and Semi-Trailers",large,2,344,332,12,832,832,0
2022,3,Eastern Province,"Manufacture of Motor Vehicles, Trailers, and Semi-Trailers",micro,27,4,3,1,61,61,0
2022,3,Eastern Province,"Manufacture of Motor Vehicles, Trailers, and Semi-Trailers",medium,10,333,253,80,966,965,1
2022,3,Al Bahah Region,"Manufacture of Motor Vehicles, Trailers, and Semi-Trailers",micro,2,0,0,0,4,4,0
2022,3,Al Jawf Region,"Manufacture of Motor Vehicles, Trailers, and Semi-Trailers",small,1,2,2,0,8,8,0
2022,3,Al Jawf Region,"Manufacture of Motor Vehicles, Trailers, and Semi-Trailers",micro,9,0,0,0,18,18,0
2022,3,Northern Borders Region,"Manufacture of Motor Vehicles, Trailers, and Semi-Trailers",micro,1,0,0,0,2,2,0
2022,3,Riyadh Region,"Manufacture of Motor Vehicles, Trailers, and Semi-Trailers",small,36,155,91,64,601,601,0
2022,3,Riyadh Region,"Manufacture of Motor Vehicles, Trailers, and Semi-Trailers",large,2,94,36,58,955,951,4
2022,3,Riyadh Region,"Manufacture of Motor Vehicles, Trailers, and Semi-Trailers",micro,53,21,12,9,107,106,1
2022,3,Riyadh Region,"Manufacture of Motor Vehicles, Trailers, and Semi-Trailers",medium,14,262,114,148,840,832,8
2022,3,Qassim Region,"Manufacture of Motor Vehicles, Trailers, and Semi-Trailers",small,8,26,11,15,102,102,0
2022,3,Qassim Region,"Manufacture of Motor Vehicles, Trailers, and Semi-Trailers",large,1,95,77,18,258,258,0
2022,3,Qassim Region,"Manufacture of Motor Vehicles, Trailers, and Semi-Trailers",micro,11,2,1,1,22,22,0
2022,3,Al Madinah Region,"Manufacture of Motor Vehicles, Trailers, and Semi-Trailers",small,1,3,3,0,15,15,0
2022,3,Al Madinah Region,"Manufacture of Motor Vehicles, Trailers, and Semi-Trailers",micro,12,3,3,0,29,29,0
2022,3,Tabuk Region,"Manufacture of Motor Vehicles, Trailers, and Semi-Trailers",micro,4,1,1,0,17,17,0
2022,3,Tabuk Region,"Manufacture of Motor Vehicles, Trailers, and Semi-Trailers",medium,1,23,11,12,49,49,0
2022,3,Jazan Region,"Manufacture of Motor Vehicles, Trailers, and Semi-Trailers",small,1,6,2,4,19,19,0
2022,3,Jazan Region,"Manufacture of Motor Vehicles, Trailers, and Semi-Trailers",micro,13,1,1,0,39,39,0
2022,3,Hail Region,"Manufacture of Motor Vehicles, Trailers, and Semi-Trailers",micro,7,1,1,0,16,16,0
2022,3,Aseer Region,"Manufacture of Motor Vehicles, Trailers, and Semi-Trailers",micro,9,1,0,1,19,19,0
2022,3,Makkah Region,"Manufacture of Motor Vehicles, Trailers, and Semi-Trailers",small,15,56,44,12,194,194,0
2022,3,Makkah Region,"Manufacture of Motor Vehicles, Trailers, and Semi-Trailers",large,1,82,63,19,211,211,0
2022,3,Makkah Region,"Manufacture of Motor Vehicles, Trailers, and Semi-Trailers",micro,36,7,5,2,86,85,1
2022,3,Makkah Region,"Manufacture of Motor Vehicles, Trailers, and Semi-Trailers",medium,9,325,204,121,758,758,0
2022,3,Najran Region,"Manufacture of Motor Vehicles, Trailers, and Semi-Trailers",micro,8,1,0,1,17,17,0
2022,3,Eastern Province,Manufacture of Other Machinery and Equipment Not Classified Elsewhere,small,70,467,342,125,1052,1051,1
2022,3,Eastern Province,Manufacture of Other Machinery and Equipment Not Classified Elsewhere,large,8,1622,1509,113,2088,2086,2
2022,3,Eastern Province,Manufacture of Other Machinery and Equipment Not Classified Elsewhere,micro,64,39,28,11,111,109,2
2022,3,Eastern Province,Manufacture of Other Machinery and Equipment Not Classified Elsewhere,medium,36,1439,1247,192,2330,2327,3
2022,3,Al Bahah Region,Manufacture of Other Machinery and Equipment Not Classified Elsewhere,small,1,1,0,1,8,8,0
2022,3,Al Bahah Region,Manufacture of Other Machinery and Equipment Not Classified Elsewhere,micro,4,1,0,1,9,9,0
2022,3,Al Jawf Region,Manufacture of Other Machinery and Equipment Not Classified Elsewhere,micro,1,0,0,0,1,1,0
2022,3,Northern Borders Region,Manufacture of Other Machinery and Equipment Not Classified Elsewhere,micro,4,0,0,0,11,11,0
2022,3,Riyadh Region,Manufacture of Other Machinery and Equipment Not Classified Elsewhere,small,82,317,187,130,1319,1314,5
2022,3,Riyadh Region,Manufacture of Other Machinery and Equipment Not Classified Elsewhere,large,2,152,58,94,474,474,0
2022,3,Riyadh Region,Manufacture of Other Machinery and Equipment Not Classified Elsewhere,micro,282,64,32,32,610,608,2
2022,3,Riyadh Region,Manufacture of Other Machinery and Equipment Not Classified Elsewhere,medium,30,870,510,360,2840,2835,5
2022,3,Qassim Region,Manufacture of Other Machinery and Equipment Not Classified Elsewhere,small,4,5,4,1,28,28,0
2022,3,Qassim Region,Manufacture of Other Machinery and Equipment Not Classified Elsewhere,micro,33,5,4,1,62,62,0
2022,3,Qassim Region,Manufacture of Other Machinery and Equipment Not Classified Elsewhere,medium,3,62,28,34,209,209,0
2022,3,Al Madinah Region,Manufacture of Other Machinery and Equipment Not Classified Elsewhere,small,5,18,12,6,74,74,0
2022,3,Al Madinah Region,Manufacture of Other Machinery and Equipment Not Classified Elsewhere,micro,22,3,2,1,49,49,0
2022,3,Al Madinah Region,Manufacture of Other Machinery and Equipment Not Classified Elsewhere,medium,4,50,37,13,239,239,0
2022,3,Tabuk Region,Manufacture of Other Machinery and Equipment Not Classified Elsewhere,micro,5,0,0,0,12,12,0
2022,3,Jazan Region,Manufacture of Other Machinery and Equipment Not Classified Elsewhere,small,4,5,3,2,31,31,0
2022,3,Jazan Region,Manufacture of Other Machinery and Equipment Not Classified Elsewhere,micro,19,2,1,1,43,43,0
2022,3,Hail Region,Manufacture of Other Machinery and Equipment Not Classified Elsewhere,small,1,18,18,0,3,3,0
2022,3,Hail Region,Manufacture of Other Machinery and Equipment Not Classified Elsewhere,micro,14,2,1,1,32,32,0
2022,3,Aseer Region,Manufacture of Other Machinery and Equipment Not Classified Elsewhere,small,4,20,19,1,65,65,0
2022,3,Aseer Region,Manufacture of Other Machinery and Equipment Not Classified Elsewhere,micro,16,1,0,1,32,32,0
2022,3,Aseer Region,Manufacture of Other Machinery and Equipment Not Classified Elsewhere,medium,2,47,47,0,121,121,0
2022,3,Makkah Region,Manufacture of Other Machinery and Equipment Not Classified Elsewhere,small,37,153,75,78,532,531,1
2022,3,Makkah Region,Manufacture of Other Machinery and Equipment Not Classified Elsewhere,large,3,686,682,4,1110,1109,1
2022,3,Makkah Region,Manufacture of Other Machinery and Equipment Not Classified Elsewhere,micro,87,22,11,11,163,163,0
2022,3,Makkah Region,Manufacture of Other Machinery and Equipment Not Classified Elsewhere,medium,14,317,234,83,998,996,2
2022,3,Najran Region,Manufacture of Other Machinery and Equipment Not Classified Elsewhere,small,1,0,0,0,6,6,0
2022,3,Najran Region,Manufacture of Other Machinery and Equipment Not Classified Elsewhere,micro,9,1,1,0,23,23,0
2022,3,Najran Region,Manufacture of Other Machinery and Equipment Not Classified Elsewhere,medium,1,0,0,0,144,144,0
2022,3,Eastern Province,"Electricity, Gas, Steam, and Air Conditioning Supply",small,55,322,229,93,659,658,1
2022,3,Eastern Province,"Electricity, Gas, Steam, and Air Conditioning Supply",large,1,6297,6287,10,455,455,0
2022,3,Eastern Province,"Electricity, Gas, Steam, and Air Conditioning Supply",micro,52,23,17,6,99,98,1
2022,3,Eastern Province,"Electricity, Gas, Steam, and Air Conditioning Supply",medium,5,211,193,18,206,206,0
2022,3,Al Bahah Region,"Electricity, Gas, Steam, and Air Conditioning Supply",micro,4,2,2,0,8,8,0
2022,3,Al Jawf Region,"Electricity, Gas, Steam, and Air Conditioning Supply",micro,5,2,1,1,11,11,0
2022,3,Northern Borders Region,"Electricity, Gas, Steam, and Air Conditioning Supply",micro,4,2,1,1,9,9,0
2022,3,Riyadh Region,"Electricity, Gas, Steam, and Air Conditioning Supply",small,62,336,185,151,695,693,2
2022,3,Riyadh Region,"Electricity, Gas, Steam, and Air Conditioning Supply",large,2,10705,10401,304,1078,1077,1
2022,3,Riyadh Region,"Electricity, Gas, Steam, and Air Conditioning Supply",micro,107,72,41,31,193,193,0
2022,3,Riyadh Region,"Electricity, Gas, Steam, and Air Conditioning Supply",medium,5,257,220,37,191,189,2
2022,3,Qassim Region,"Electricity, Gas, Steam, and Air Conditioning Supply",small,3,12,9,3,50,50,0
2022,3,Qassim Region,"Electricity, Gas, Steam, and Air Conditioning Supply",micro,13,5,4,1,33,33,0
2022,3,Qassim Region,"Electricity, Gas, Steam, and Air Conditioning Supply",medium,1,63,63,0,135,135,0
2022,3,Al Madinah Region,"Electricity, Gas, Steam, and Air Conditioning Supply",small,4,71,70,1,20,20,0
2022,3,Al Madinah Region,"Electricity, Gas, Steam, and Air Conditioning Supply",micro,18,4,2,2,33,33,0
2022,3,Tabuk Region,"Electricity, Gas, Steam, and Air Conditioning Supply",micro,15,3,0,3,27,27,0
2022,3,Jazan Region,"Electricity, Gas, Steam, and Air Conditioning Supply",small,4,20,14,6,89,89,0
2022,3,Jazan Region,"Electricity, Gas, Steam, and Air Conditioning Supply",micro,16,5,4,1,38,38,0
2022,3,Jazan Region,"Electricity, Gas, Steam, and Air Conditioning Supply",medium,1,8,8,0,55,55,0
2022,3,Hail Region,"Electricity, Gas, Steam, and Air Conditioning Supply",small,1,1,0,1,6,6,0
2022,3,Hail Region,"Electricity, Gas, Steam, and Air Conditioning Supply",micro,7,2,2,0,19,19,0
2022,3,Aseer Region,"Electricity, Gas, Steam, and Air Conditioning Supply",small,6,9,7,2,42,42,0
2022,3,Aseer Region,"Electricity, Gas, Steam, and Air Conditioning Supply",large,1,4645,4645,0,259,258,1
2022,3,Aseer Region,"Electricity, Gas, Steam, and Air Conditioning Supply",micro,19,6,3,3,37,37,0
2022,3,Aseer Region,"Electricity, Gas, Steam, and Air Conditioning Supply",medium,4,131,123,8,187,187,0
2022,3,Makkah Region,"Electricity, Gas, Steam, and Air Conditioning Supply",small,31,212,139,73,536,535,1
2022,3,Makkah Region,"Electricity, Gas, Steam, and Air Conditioning Supply",large,2,9639,9638,1,642,642,0
2022,3,Makkah Region,"Electricity, Gas, Steam, and Air Conditioning Supply",micro,63,29,21,8,115,115,0
2022,3,Makkah Region,"Electricity, Gas, Steam, and Air Conditioning Supply",medium,4,140,103,37,299,299,0
2022,3,Najran Region,"Electricity, Gas, Steam, and Air Conditioning Supply",small,1,2,2,0,6,6,0
2022,3,Najran Region,"Electricity, Gas, Steam, and Air Conditioning Supply",micro,7,1,1,0,14,14,0
2022,3,Eastern Province,"Activities of Financial Services, Except Mandatory Social Security",small,6,99,65,34,5,5,0
2022,3,Eastern Province,"Activities of Financial Services, Except Mandatory Social Security",large,1,305,241,64,59,57,2
2022,3,Eastern Province,"Activities of Financial Services, Except Mandatory Social Security",micro,3,5,2,3,3,3,0
2022,3,Eastern Province,"Activities of Financial Services, Except Mandatory Social Security",medium,6,380,228,152,274,261,13
2022,3,Al Bahah Region,"Activities of Financial Services, Except Mandatory Social Security",small,1,0,0,0,6,6,0
2022,3,Riyadh Region,"Activities of Financial Services, Except Mandatory Social Security",small,5,95,76,19,43,41,2
2022,3,Riyadh Region,"Activities of Financial Services, Except Mandatory Social Security",large,6,2838,1824,1014,727,700,27
2022,3,Riyadh Region,"Activities of Financial Services, Except Mandatory Social Security",micro,24,23,11,12,8,8,0
2022,3,Riyadh Region,"Activities of Financial Services, Except Mandatory Social Security",medium,10,1251,888,363,410,395,15
2022,3,Qassim Region,"Activities of Financial Services, Except Mandatory Social Security",micro,1,1,1,0,0,0,0
2022,3,Al Madinah Region,"Activities of Financial Services, Except Mandatory Social Security",micro,3,1,0,1,7,6,1
2022,3,Tabuk Region,"Activities of Financial Services, Except Mandatory Social Security",micro,1,1,1,0,0,0,0
2022,3,Jazan Region,"Activities of Financial Services, Except Mandatory Social Security",micro,2,0,0,0,4,4,0
2022,3,Aseer Region,"Activities of Financial Services, Except Mandatory Social Security",micro,2,1,0,1,2,2,0
2022,3,Makkah Region,"Activities of Financial Services, Except Mandatory Social Security",small,10,176,108,68,51,50,1
2022,3,Makkah Region,"Activities of Financial Services, Except Mandatory Social Security",large,1,850,445,405,384,316,68
2022,3,Makkah Region,"Activities of Financial Services, Except Mandatory Social Security",micro,9,2,2,0,11,11,0
2022,3,Makkah Region,"Activities of Financial Services, Except Mandatory Social Security",medium,5,538,307,231,151,142,9
2022,3,Najran Region,"Activities of Financial Services, Except Mandatory Social Security",micro,2,0,0,0,4,4,0
2022,3,Eastern Province,Mining of Metal Ores,small,9,12,8,4,91,91,0
2022,3,Eastern Province,Mining of Metal Ores,large,1,577,573,4,4,4,0
2022,3,Eastern Province,Mining of Metal Ores,micro,63,9,4,5,131,131,0
2022,3,Eastern Province,Mining of Metal Ores,medium,1,75,64,11,59,58,1
2022,3,Al Bahah Region,Mining of Metal Ores,micro,4,0,0,0,5,5,0
2022,3,Al Jawf Region,Mining of Metal Ores,micro,2,0,0,0,5,5,0
2022,3,Northern Borders Region,Mining of Metal Ores,micro,3,0,0,0,7,7,0
2022,3,Riyadh Region,Mining of Metal Ores,small,13,43,24,19,170,169,1
2022,3,Riyadh Region,Mining of Metal Ores,micro,32,18,11,7,46,46,0
2022,3,Riyadh Region,Mining of Metal Ores,medium,1,0,0,0,59,59,0
2022,3,Qassim Region,Mining of Metal Ores,small,1,3,3,0,7,7,0
2022,3,Qassim Region,Mining of Metal Ores,micro,12,3,2,1,26,26,0
2022,3,Qassim Region,Mining of Metal Ores,medium,1,88,88,0,14,14,0
2022,3,Al Madinah Region,Mining of Metal Ores,small,1,2,1,1,7,7,0
2022,3,Al Madinah Region,Mining of Metal Ores,micro,6,1,1,0,14,14,0
2022,3,Tabuk Region,Mining of Metal Ores,small,1,1,1,0,7,7,0
2022,3,Tabuk Region,Mining of Metal Ores,micro,1,0,0,0,1,1,0
2022,3,Jazan Region,Mining of Metal Ores,micro,7,0,0,0,21,21,0
2022,3,Hail Region,Mining of Metal Ores,micro,2,0,0,0,5,5,0
2022,3,Aseer Region,Mining of Metal Ores,small,3,3,1,2,24,24,0
2022,3,Aseer Region,Mining of Metal Ores,micro,37,6,4,2,70,70,0
2022,3,Makkah Region,Mining of Metal Ores,small,5,26,8,18,66,64,2
2022,3,Makkah Region,Mining of Metal Ores,micro,36,12,7,5,69,69,0
2022,3,Makkah Region,Mining of Metal Ores,medium,4,387,355,32,43,43,0
2022,3,Najran Region,Mining of Metal Ores,small,1,0,0,0,19,19,0
2022,3,Najran Region,Mining of Metal Ores,micro,6,0,0,0,7,7,0
2022,3,Eastern Province,Mining of Coal and Lignite,small,2,6,6,0,13,13,0
2022,3,Eastern Province,Mining of Coal and Lignite,micro,4,2,2,0,7,7,0
2022,3,Riyadh Region,Mining of Coal and Lignite,small,3,5,4,1,27,27,0
2022,3,Riyadh Region,Mining of Coal and Lignite,micro,11,4,3,1,40,40,0
2022,3,Qassim Region,Mining of Coal and Lignite,small,1,2,0,2,15,15,0
2022,3,Qassim Region,Mining of Coal and Lignite,micro,4,0,0,0,12,12,0
2022,3,Al Madinah Region,Mining of Coal and Lignite,micro,1,0,0,0,1,1,0
2022,3,Hail Region,Mining of Coal and Lignite,micro,1,0,0,0,4,4,0
2022,3,Makkah Region,Mining of Coal and Lignite,small,1,3,1,2,14,14,0
2022,3,Makkah Region,Mining of Coal and Lignite,micro,10,4,3,1,15,15,0
2022,3,Najran Region,Mining of Coal and Lignite,micro,1,0,0,0,4,4,0
2022,3,Eastern Province,Construction of Buildings,small,5082,11332,6209,5123,68070,67888,182
2022,3,Eastern Province,Construction of Buildings,large,134,24021,16808,7213,123645,122793,852
2022,3,Eastern Province,Construction of Buildings,micro,12231,3382,1751,1631,28236,28145,91
2022,3,Eastern Province,Construction of Buildings,medium,722,11378,7116,4262,60783,60691,92
2022,3,Al Bahah Region,Construction of Buildings,small,262,392,280,112,2461,2453,8
2022,3,Al Bahah Region,Construction of Buildings,micro,1217,257,152,105,2876,2873,3
2022,3,Al Bahah Region,Construction of Buildings,medium,5,66,49,17,370,370,0
2022,3,Al Jawf Region,Construction of Buildings,small,270,407,261,146,2833,2825,8
2022,3,Al Jawf Region,Construction of Buildings,large,1,260,195,65,389,315,74
2022,3,Al Jawf Region,Construction of Buildings,micro,1555,223,143,80,3830,3823,7
2022,3,Al Jawf Region,Construction of Buildings,medium,10,153,109,44,684,653,31
2022,3,Northern Borders Region,Construction of Buildings,small,196,297,167,130,2011,2005,6
2022,3,Northern Borders Region,Construction of Buildings,large,3,262,108,154,1378,1352,26
2022,3,Northern Borders Region,Construction of Buildings,micro,1581,189,106,83,4100,4094,6
2022,3,Northern Borders Region,Construction of Buildings,medium,9,93,54,39,559,559,0
2022,3,Riyadh Region,Construction of Buildings,small,7359,14688,6631,8057,92846,92183,663
2022,3,Riyadh Region,Construction of Buildings,large,334,23610,13224,10386,212425,210707,1718
2022,3,Riyadh Region,Construction of Buildings,micro,23896,5827,2776,3051,52549,52157,392
2022,3,Riyadh Region,Construction of Buildings,medium,1086,14444,7080,7364,101323,100652,671
2022,3,Qassim Region,Construction of Buildings,small,1506,2145,1297,848,17478,17398,80
2022,3,Qassim Region,Construction of Buildings,large,28,259,122,137,11886,11876,10
2022,3,Qassim Region,Construction of Buildings,micro,9573,1288,718,570,22572,22528,44
2022,3,Qassim Region,Construction of Buildings,medium,162,1245,781,464,16383,16321,62
2022,3,Al Madinah Region,Construction of Buildings,small,1358,2373,1369,1004,14973,14894,79
2022,3,Al Madinah Region,Construction of Buildings,large,10,1951,936,1015,17801,17274,527
2022,3,Al Madinah Region,Construction of Buildings,micro,5806,1133,619,514,14171,14125,46
2022,3,Al Madinah Region,Construction of Buildings,medium,81,1015,709,306,6088,6085,3
2022,3,Tabuk Region,Construction of Buildings,small,343,548,309,239,3265,3260,5
2022,3,Tabuk Region,Construction of Buildings,large,2,107,84,23,461,418,43
2022,3,Tabuk Region,Construction of Buildings,micro,2739,437,228,209,6893,6884,9
2022,3,Tabuk Region,Construction of Buildings,medium,10,109,59,50,909,905,4
2022,3,Jazan Region,Construction of Buildings,small,426,688,355,333,4077,4065,12
2022,3,Jazan Region,Construction of Buildings,micro,3962,692,384,308,9906,9883,23
2022,3,Jazan Region,Construction of Buildings,medium,15,319,165,154,1160,1140,20
2022,3,Hail Region,Construction of Buildings,small,435,595,270,325,4713,4699,14
2022,3,Hail Region,Construction of Buildings,large,1,29,14,15,331,331,0
2022,3,Hail Region,Construction of Buildings,micro,3206,460,239,221,7678,7660,18
2022,3,Hail Region,Construction of Buildings,medium,33,427,274,153,2592,2587,5
2022,3,Aseer Region,Construction of Buildings,small,1135,1831,1112,719,10928,10893,35
2022,3,Aseer Region,Construction of Buildings,large,1,70,66,4,362,362,0
2022,3,Aseer Region,Construction of Buildings,micro,8127,1404,821,583,19263,19241,22
2022,3,Aseer Region,Construction of Buildings,medium,41,739,571,168,2918,2918,0
2022,3,Makkah Region,Construction of Buildings,small,5758,10245,5087,5158,66390,65905,485
2022,3,Makkah Region,Construction of Buildings,large,90,12809,9289,3520,84011,83270,741
2022,3,Makkah Region,Construction of Buildings,micro,21178,4742,2402,2340,51165,50742,423
2022,3,Makkah Region,Construction of Buildings,medium,448,6729,3894,2835,36285,35985,300
2022,3,Najran Region,Construction of Buildings,small,423,607,310,297,4508,4497,11
2022,3,Najran Region,Construction of Buildings,large,7,744,417,327,2414,2408,6
2022,3,Najran Region,Construction of Buildings,micro,2732,373,201,172,6478,6454,24
2022,3,Najran Region,Construction of Buildings,medium,47,802,506,296,4537,4531,6
2022,3,Eastern Province,"Water Collection, Treatment, and Supply",small,38,194,139,55,435,435,0
2022,3,Eastern Province,"Water Collection, Treatment, and Supply",large,2,882,873,9,224,224,0
2022,3,Eastern Province,"Water Collection, Treatment, and Supply",micro,70,30,20,10,149,149,0
2022,3,Eastern Province,"Water Collection, Treatment, and Supply",medium,1,138,134,4,106,106,0
2022,3,Al Bahah Region,"Water Collection, Treatment, and Supply",small,2,3,3,0,13,13,0
2022,3,Al Bahah Region,"Water Collection, Treatment, and Supply",micro,27,4,1,3,48,48,0
2022,3,Al Jawf Region,"Water Collection, Treatment, and Supply",small,2,13,8,5,31,31,0
2022,3,Al Jawf Region,"Water Collection, Treatment, and Supply",micro,14,1,1,0,36,36,0
2022,3,Al Jawf Region,"Water Collection, Treatment, and Supply",medium,1,17,11,6,36,36,0
2022,3,Northern Borders Region,"Water Collection, Treatment, and Supply",small,5,5,4,1,31,31,0
2022,3,Northern Borders Region,"Water Collection, Treatment, and Supply",micro,19,3,3,0,44,44,0
2022,3,Riyadh Region,"Water Collection, Treatment, and Supply",small,57,214,120,94,600,600,0
2022,3,Riyadh Region,"Water Collection, Treatment, and Supply",large,2,232,156,76,270,267,3
2022,3,Riyadh Region,"Water Collection, Treatment, and Supply",micro,204,73,36,37,432,428,4
2022,3,Riyadh Region,"Water Collection, Treatment, and Supply",medium,11,392,276,116,774,774,0
2022,3,Qassim Region,"Water Collection, Treatment, and Supply",small,12,29,15,14,108,108,0
2022,3,Qassim Region,"Water Collection, Treatment, and Supply",micro,59,17,10,7,132,132,0
2022,3,Qassim Region,"Water Collection, Treatment, and Supply",medium,1,45,45,0,147,147,0
2022,3,Al Madinah Region,"Water Collection, Treatment, and Supply",small,7,33,27,6,86,86,0
2022,3,Al Madinah Region,"Water Collection, Treatment, and Supply",large,1,735,735,0,194,194,0
2022,3,Al Madinah Region,"Water Collection, Treatment, and Supply",micro,63,17,8,9,111,111,0
2022,3,Al Madinah Region,"Water Collection, Treatment, and Supply",medium,1,30,17,13,73,73,0
2022,3,Tabuk Region,"Water Collection, Treatment, and Supply",small,5,29,23,6,78,78,0
2022,3,Tabuk Region,"Water Collection, Treatment, and Supply",micro,52,9,3,6,108,108,0
2022,3,Jazan Region,"Water Collection, Treatment, and Supply",small,8,63,57,6,47,47,0
2022,3,Jazan Region,"Water Collection, Treatment, and Supply",micro,80,19,10,9,147,147,0
2022,3,Jazan Region,"Water Collection, Treatment, and Supply",medium,1,53,51,2,27,27,0
2022,3,Hail Region,"Water Collection, Treatment, and Supply",small,1,9,8,1,32,32,0
2022,3,Hail Region,"Water Collection, Treatment, and Supply",micro,33,4,2,2,73,73,0
2022,3,Hail Region,"Water Collection, Treatment, and Supply",medium,2,47,33,14,124,124,0
2022,3,Aseer Region,"Water Collection, Treatment, and Supply",small,16,49,23,26,174,174,0
2022,3,Aseer Region,"Water Collection, Treatment, and Supply",micro,141,24,7,17,264,264,0
2022,3,Makkah Region,"Water Collection, Treatment, and Supply",small,64,335,257,78,554,553,1
2022,3,Makkah Region,"Water Collection, Treatment, and Supply",micro,373,72,41,31,760,758,2
2022,3,Makkah Region,"Water Collection, Treatment, and Supply",medium,11,720,635,85,638,637,1
2022,3,Najran Region,"Water Collection, Treatment, and Supply",small,4,6,3,3,25,25,0
2022,3,Najran Region,"Water Collection, Treatment, and Supply",large,1,110,92,18,211,208,3
2022,3,Najran Region,"Water Collection, Treatment, and Supply",micro,25,4,2,2,52,52,0
2022,3,Najran Region,"Water Collection, Treatment, and Supply",medium,2,26,22,4,88,88,0
2022,3,Eastern Province,"Wholesale and Retail Trade, Repair of Motor Vehicles and Motorcycles",small,1917,4450,2871,1579,17321,17303,18
2022,3,Eastern Province,"Wholesale and Retail Trade, Repair of Motor Vehicles and Motorcycles",large,6,918,811,107,1424,1423,1
2022,3,Eastern Province,"Wholesale and Retail Trade, Repair of Motor Vehicles and Motorcycles",micro,7076,2372,1438,934,15783,15763,20
2022,3,Eastern Province,"Wholesale and Retail Trade, Repair of Motor Vehicles and Motorcycles",medium,60,1660,1389,271,3620,3619,1
2022,3,Al Bahah Region,"Wholesale and Retail Trade, Repair of Motor Vehicles and Motorcycles",small,71,141,105,36,486,486,0
2022,3,Al Bahah Region,"Wholesale and Retail Trade, Repair of Motor Vehicles and Motorcycles",micro,683,190,140,50,1433,1432,1
2022,3,Al Jawf Region,"Wholesale and Retail Trade, Repair of Motor Vehicles and Motorcycles",small,142,246,187,59,1069,1068,1
2022,3,Al Jawf Region,"Wholesale and Retail Trade, Repair of Motor Vehicles and Motorcycles",micro,986,199,137,62,2233,2232,1
2022,3,Northern Borders Region,"Wholesale and Retail Trade, Repair of Motor Vehicles and Motorcycles",small,76,154,87,67,569,566,3
2022,3,Northern Borders Region,"Wholesale and Retail Trade, Repair of Motor Vehicles and Motorcycles",micro,706,106,81,25,1646,1645,1
2022,3,Riyadh Region,"Wholesale and Retail Trade, Repair of Motor Vehicles and Motorcycles",small,2894,7618,3805,3813,27717,27633,84
2022,3,Riyadh Region,"Wholesale and Retail Trade, Repair of Motor Vehicles and Motorcycles",large,11,1744,1483,261,4382,4370,12
2022,3,Riyadh Region,"Wholesale and Retail Trade, Repair of Motor Vehicles and Motorcycles",micro,14338,3514,1869,1645,32534,32405,129
2022,3,Riyadh Region,"Wholesale and Retail Trade, Repair of Motor Vehicles and Motorcycles",medium,114,2744,1825,919,7669,7648,21
2022,3,Qassim Region,"Wholesale and Retail Trade, Repair of Motor Vehicles and Motorcycles",small,507,1203,845,358,4611,4610,1
2022,3,Qassim Region,"Wholesale and Retail Trade, Repair of Motor Vehicles and Motorcycles",micro,3678,715,462,253,8192,8183,9
2022,3,Qassim Region,"Wholesale and Retail Trade, Repair of Motor Vehicles and Motorcycles",medium,12,148,100,48,750,750,0
2022,3,Al Madinah Region,"Wholesale and Retail Trade, Repair of Motor Vehicles and Motorcycles",small,398,817,556,261,3053,3047,6
2022,3,Al Madinah Region,"Wholesale and Retail Trade, Repair of Motor Vehicles and Motorcycles",micro,3327,734,515,219,7537,7523,14
2022,3,Al Madinah Region,"Wholesale and Retail Trade, Repair of Motor Vehicles and Motorcycles",medium,3,62,47,15,236,236,0
2022,3,Tabuk Region,"Wholesale and Retail Trade, Repair of Motor Vehicles and Motorcycles",small,193,408,288,120,1519,1518,1
2022,3,Tabuk Region,"Wholesale and Retail Trade, Repair of Motor Vehicles and Motorcycles",micro,1682,349,237,112,3928,3922,6
2022,3,Tabuk Region,"Wholesale and Retail Trade, Repair of Motor Vehicles and Motorcycles",medium,1,36,25,11,60,60,0
2022,3,Jazan Region,"Wholesale and Retail Trade, Repair of Motor Vehicles and Motorcycles",small,194,421,293,128,1522,1517,5
2022,3,Jazan Region,"Wholesale and Retail Trade, Repair of Motor Vehicles and Motorcycles",micro,2652,471,326,145,6046,6038,8
2022,3,Jazan Region,"Wholesale and Retail Trade, Repair of Motor Vehicles and Motorcycles",medium,3,43,34,9,173,172,1
2022,3,Hail Region,"Wholesale and Retail Trade, Repair of Motor Vehicles and Motorcycles",small,222,461,267,194,1986,1985,1
2022,3,Hail Region,"Wholesale and Retail Trade, Repair of Motor Vehicles and Motorcycles",micro,1395,259,154,105,3176,3173,3
2022,3,Hail Region,"Wholesale and Retail Trade, Repair of Motor Vehicles and Motorcycles",medium,1,34,30,4,58,58,0
2022,3,Aseer Region,"Wholesale and Retail Trade, Repair of Motor Vehicles and Motorcycles",small,544,1205,790,415,4639,4637,2
2022,3,Aseer Region,"Wholesale and Retail Trade, Repair of Motor Vehicles and Motorcycles",micro,4040,838,565,273,8965,8945,20
2022,3,Aseer Region,"Wholesale and Retail Trade, Repair of Motor Vehicles and Motorcycles",medium,9,194,182,12,516,516,0
2022,3,Makkah Region,"Wholesale and Retail Trade, Repair of Motor Vehicles and Motorcycles",small,1698,4239,2669,1570,14986,14920,66
2022,3,Makkah Region,"Wholesale and Retail Trade, Repair of Motor Vehicles and Motorcycles",large,24,4275,3592,683,7802,7776,26
2022,3,Makkah Region,"Wholesale and Retail Trade, Repair of Motor Vehicles and Motorcycles",micro,11074,2624,1568,1056,25474,25359,115
2022,3,Makkah Region,"Wholesale and Retail Trade, Repair of Motor Vehicles and Motorcycles",medium,66,1927,1557,370,4109,4093,16
2022,3,Najran Region,"Wholesale and Retail Trade, Repair of Motor Vehicles and Motorcycles",small,108,234,151,83,993,992,1
2022,3,Najran Region,"Wholesale and Retail Trade, Repair of Motor Vehicles and Motorcycles",micro,910,181,92,89,2101,2097,4
2022,3,Najran Region,"Wholesale and Retail Trade, Repair of Motor Vehicles and Motorcycles",medium,4,83,52,31,215,215,0
2022,3,Eastern Province,Wholesale Trade (Except of Motor Vehicles and Motorcycles),small,2324,8889,5191,3698,21946,21850,96
2022,3,Eastern Province,Wholesale Trade (Except of Motor Vehicles and Motorcycles),large,18,3751,2424,1327,4955,4939,16
2022,3,Eastern Province,Wholesale Trade (Except of Motor Vehicles and Motorcycles),micro,6711,3780,2136,1644,12704,12631,73
2022,3,Eastern Province,Wholesale Trade (Except of Motor Vehicles and Motorcycles),medium,174,5924,3890,2034,10938,10854,84
2022,3,Al Bahah Region,Wholesale Trade (Except of Motor Vehicles and Motorcycles),small,96,284,208,76,801,799,2
2022,3,Al Bahah Region,Wholesale Trade (Except of Motor Vehicles and Motorcycles),micro,433,187,129,58,803,798,5
2022,3,Al Bahah Region,Wholesale Trade (Except of Motor Vehicles and Motorcycles),medium,2,48,32,16,87,87,0
2022,3,Al Jawf Region,Wholesale Trade (Except of Motor Vehicles and Motorcycles),small,123,316,215,101,1043,1040,3
2022,3,Al Jawf Region,Wholesale Trade (Except of Motor Vehicles and Motorcycles),micro,635,201,140,61,1269,1262,7
2022,3,Al Jawf Region,Wholesale Trade (Except of Motor Vehicles and Motorcycles),medium,2,83,31,52,160,159,1
2022,3,Northern Borders Region,Wholesale Trade (Except of Motor Vehicles and Motorcycles),small,59,137,77,60,447,447,0
2022,3,Northern Borders Region,Wholesale Trade (Except of Motor Vehicles and Motorcycles),micro,384,115,68,47,809,808,1
2022,3,Northern Borders Region,Wholesale Trade (Except of Motor Vehicles and Motorcycles),medium,1,0,0,0,108,108,0
2022,3,Riyadh Region,Wholesale Trade (Except of Motor Vehicles and Motorcycles),small,5501,21566,10050,11516,55129,54466,663
2022,3,Riyadh Region,Wholesale Trade (Except of Motor Vehicles and Motorcycles),large,51,15517,11363,4154,16693,16499,194
2022,3,Riyadh Region,Wholesale Trade (Except of Motor Vehicles and Motorcycles),micro,17267,7394,3615,3779,33901,33404,497
2022,3,Riyadh Region,Wholesale Trade (Except of Motor Vehicles and Motorcycles),medium,399,13593,7233,6360,24845,24482,363
2022,3,Qassim Region,Wholesale Trade (Except of Motor Vehicles and Motorcycles),small,457,1502,974,528,4170,4154,16
2022,3,Qassim Region,Wholesale Trade (Except of Motor Vehicles and Motorcycles),large,2,389,136,253,177,177,0
2022,3,Qassim Region,Wholesale Trade (Except of Motor Vehicles and Motorcycles),micro,2251,811,553,258,4383,4359,24
2022,3,Qassim Region,Wholesale Trade (Except of Motor Vehicles and Motorcycles),medium,24,378,243,135,1606,1601,5
2022,3,Al Madinah Region,Wholesale Trade (Except of Motor Vehicles and Motorcycles),small,663,2098,1311,787,5425,5390,35
2022,3,Al Madinah Region,Wholesale Trade (Except of Motor Vehicles and Motorcycles),micro,3104,1130,717,413,6288,6235,53
2022,3,Al Madinah Region,Wholesale Trade (Except of Motor Vehicles and Motorcycles),medium,17,429,302,127,1068,1066,2
2022,3,Tabuk Region,Wholesale Trade (Except of Motor Vehicles and Motorcycles),small,156,528,288,240,1467,1461,6
2022,3,Tabuk Region,Wholesale Trade (Except of Motor Vehicles and Motorcycles),micro,930,352,202,150,1770,1761,9
2022,3,Tabuk Region,Wholesale Trade (Except of Motor Vehicles and Motorcycles),medium,9,186,119,67,486,484,2
2022,3,Jazan Region,Wholesale Trade (Except of Motor Vehicles and Motorcycles),small,270,806,455,351,2464,2452,12
2022,3,Jazan Region,Wholesale Trade (Except of Motor Vehicles and Motorcycles),micro,1798,503,309,194,3895,3879,16
2022,3,Jazan Region,Wholesale Trade (Except of Motor Vehicles and Motorcycles),medium,5,101,76,25,403,402,1
2022,3,Hail Region,Wholesale Trade (Except of Motor Vehicles and Motorcycles),small,159,520,305,215,1463,1456,7
2022,3,Hail Region,Wholesale Trade (Except of Motor Vehicles and Motorcycles),micro,795,260,154,106,1645,1640,5
2022,3,Hail Region,Wholesale Trade (Except of Motor Vehicles and Motorcycles),medium,2,63,48,15,103,103,0
2022,3,Aseer Region,Wholesale Trade (Except of Motor Vehicles and Motorcycles),small,559,1852,1250,602,4771,4763,8
2022,3,Aseer Region,Wholesale Trade (Except of Motor Vehicles and Motorcycles),micro,2260,913,590,323,4567,4547,20
2022,3,Aseer Region,Wholesale Trade (Except of Motor Vehicles and Motorcycles),medium,22,614,381,233,1196,1191,5
2022,3,Makkah Region,Wholesale Trade (Except of Motor Vehicles and Motorcycles),small,5042,18373,9034,9339,49402,48776,626
2022,3,Makkah Region,Wholesale Trade (Except of Motor Vehicles and Motorcycles),large,39,7658,5387,2271,9926,9757,169
2022,3,Makkah Region,Wholesale Trade (Except of Motor Vehicles and Motorcycles),micro,15073,5863,2978,2885,30902,30354,548
2022,3,Makkah Region,Wholesale Trade (Except of Motor Vehicles and Motorcycles),medium,342,11657,6496,5161,20873,20613,260
2022,3,Najran Region,Wholesale Trade (Except of Motor Vehicles and Motorcycles),small,126,372,204,168,1072,1060,12
2022,3,Najran Region,Wholesale Trade (Except of Motor Vehicles and Motorcycles),micro,605,186,114,72,1336,1325,11
2022,3,Najran Region,Wholesale Trade (Except of Motor Vehicles and Motorcycles),medium,6,152,89,63,288,288,0
2022,3,Eastern Province,Retail Trade (Except of Motor Vehicles and Motorcycles),small,3444,12267,6190,6077,30231,30023,208
2022,3,Eastern Province,Retail Trade (Except of Motor Vehicles and Motorcycles),large,29,7134,3648,3486,10657,9912,745
2022,3,Eastern Province,Retail Trade (Except of Motor Vehicles and Motorcycles),micro,17106,7962,4211,3751,32687,32519,168
2022,3,Eastern Province,Retail Trade (Except of Motor Vehicles and Motorcycles),medium,216,6998,3662,3336,14431,14354,77
2022,3,Al Bahah Region,Retail Trade (Except of Motor Vehicles and Motorcycles),small,223,676,441,235,1728,1728,0
2022,3,Al Bahah Region,Retail Trade (Except of Motor Vehicles and Motorcycles),micro,1516,652,424,228,2719,2699,20
2022,3,Al Bahah Region,Retail Trade (Except of Motor Vehicles and Motorcycles),medium,3,49,46,3,142,142,0
2022,3,Al Jawf Region,Retail Trade (Except of Motor Vehicles and Motorcycles),small,307,845,520,325,2366,2333,33
2022,3,Al Jawf Region,Retail Trade (Except of Motor Vehicles and Motorcycles),micro,2513,767,515,252,4785,4768,17
2022,3,Al Jawf Region,Retail Trade (Except of Motor Vehicles and Motorcycles),medium,5,140,45,95,308,308,0
2022,3,Northern Borders Region,Retail Trade (Except of Motor Vehicles and Motorcycles),small,176,472,268,204,1427,1410,17
2022,3,Northern Borders Region,Retail Trade (Except of Motor Vehicles and Motorcycles),micro,1888,487,271,216,3864,3849,15
2022,3,Northern Borders Region,Retail Trade (Except of Motor Vehicles and Motorcycles),medium,3,46,29,17,247,239,8
2022,3,Riyadh Region,Retail Trade (Except of Motor Vehicles and Motorcycles),small,7069,26783,12012,14771,70185,69240,945
2022,3,Riyadh Region,Retail Trade (Except of Motor Vehicles and Motorcycles),large,104,37704,20036,17668,58192,57436,756
2022,3,Riyadh Region,Retail Trade (Except of Motor Vehicles and Motorcycles),micro,33170,12378,6185,6193,67097,66246,851
2022,3,Riyadh Region,Retail Trade (Except of Motor Vehicles and Motorcycles),medium,594,18812,9009,9803,39211,38609,602
2022,3,Qassim Region,Retail Trade (Except of Motor Vehicles and Motorcycles),small,1104,3648,2363,1285,10027,9985,42
2022,3,Qassim Region,Retail Trade (Except of Motor Vehicles and Motorcycles),large,4,560,193,367,1289,1284,5
2022,3,Qassim Region,Retail Trade (Except of Motor Vehicles and Motorcycles),micro,6676,2319,1484,835,13027,12962,65
2022,3,Qassim Region,Retail Trade (Except of Motor Vehicles and Motorcycles),medium,59,1184,753,431,4005,4002,3
2022,3,Al Madinah Region,Retail Trade (Except of Motor Vehicles and Motorcycles),small,1349,4106,2438,1668,10819,10743,76
2022,3,Al Madinah Region,Retail Trade (Except of Motor Vehicles and Motorcycles),large,1,85,49,36,228,228,0
2022,3,Al Madinah Region,Retail Trade (Except of Motor Vehicles and Motorcycles),micro,10075,3314,2086,1228,20163,19980,183
2022,3,Al Madinah Region,Retail Trade (Except of Motor Vehicles and Motorcycles),medium,54,1804,752,1052,2953,2905,48
2022,3,Tabuk Region,Retail Trade (Except of Motor Vehicles and Motorcycles),small,401,1213,601,612,2989,2976,13
2022,3,Tabuk Region,Retail Trade (Except of Motor Vehicles and Motorcycles),large,1,124,100,24,144,144,0
2022,3,Tabuk Region,Retail Trade (Except of Motor Vehicles and Motorcycles),micro,3859,1195,688,507,7484,7455,29
2022,3,Tabuk Region,Retail Trade (Except of Motor Vehicles and Motorcycles),medium,8,384,116,268,437,437,0
2022,3,Jazan Region,Retail Trade (Except of Motor Vehicles and Motorcycles),small,732,2172,1125,1047,5864,5847,17
2022,3,Jazan Region,Retail Trade (Except of Motor Vehicles and Motorcycles),large,1,119,108,11,241,241,0
2022,3,Jazan Region,Retail Trade (Except of Motor Vehicles and Motorcycles),micro,7061,2009,1193,816,14391,14289,102
2022,3,Jazan Region,Retail Trade (Except of Motor Vehicles and Motorcycles),medium,14,554,222,332,862,850,12
2022,3,Hail Region,Retail Trade (Except of Motor Vehicles and Motorcycles),small,418,1174,598,576,3463,3437,26
2022,3,Hail Region,Retail Trade (Except of Motor Vehicles and Motorcycles),large,1,202,89,113,176,176,0
2022,3,Hail Region,Retail Trade (Except of Motor Vehicles and Motorcycles),micro,3366,1106,595,511,6614,6579,35
2022,3,Hail Region,Retail Trade (Except of Motor Vehicles and Motorcycles),medium,14,268,93,175,685,684,1
2022,3,Aseer Region,Retail Trade (Except of Motor Vehicles and Motorcycles),small,1215,4099,2231,1868,9598,9546,52
2022,3,Aseer Region,Retail Trade (Except of Motor Vehicles and Motorcycles),large,2,401,138,263,479,476,3
2022,3,Aseer Region,Retail Trade (Except of Motor Vehicles and Motorcycles),micro,9125,3393,2149,1244,17381,17290,91
2022,3,Aseer Region,Retail Trade (Except of Motor Vehicles and Motorcycles),medium,34,842,341,501,1833,1798,35
2022,3,Makkah Region,Retail Trade (Except of Motor Vehicles and Motorcycles),small,6184,22132,10260,11872,55829,55089,740
2022,3,Makkah Region,Retail Trade (Except of Motor Vehicles and Motorcycles),large,48,12469,6406,6063,13943,13531,412
2022,3,Makkah Region,Retail Trade (Except of Motor Vehicles and Motorcycles),micro,32887,11569,6268,5301,67227,66253,974
2022,3,Makkah Region,Retail Trade (Except of Motor Vehicles and Motorcycles),medium,375,12752,6369,6383,22724,22336,388
2022,3,Najran Region,Retail Trade (Except of Motor Vehicles and Motorcycles),small,341,986,485,501,3020,2996,24
2022,3,Najran Region,Retail Trade (Except of Motor Vehicles and Motorcycles),micro,2620,664,395,269,5337,5310,27
2022,3,Najran Region,Retail Trade (Except of Motor Vehicles and Motorcycles),medium,6,213,85,128,509,506,3
2022,3,Eastern Province,"Crop and Animal Production, Hunting and Related Services",small,297,375,206,169,3290,3285,5
2022,3,Eastern Province,"Crop and Animal Production, Hunting and Related Services",large,2,506,410,96,1838,1837,1
2022,3,Eastern Province,"Crop and Animal Production, Hunting and Related Services",micro,2107,266,148,118,3162,3158,4
2022,3,Eastern Province,"Crop and Animal Production, Hunting and Related Services",medium,21,241,157,84,1656,1655,1
2022,3,Al Bahah Region,"Crop and Animal Production, Hunting and Related Services",small,6,4,4,0,48,48,0
2022,3,Al Bahah Region,"Crop and Animal Production, Hunting and Related Services",micro,185,7,4,3,228,228,0
2022,3,Al Jawf Region,"Crop and Animal Production, Hunting and Related Services",small,28,33,23,10,271,271,0
2022,3,Al Jawf Region,"Crop and Animal Production, Hunting and Related Services",large,1,131,123,8,794,791,3
2022,3,Al Jawf Region,"Crop and Animal Production, Hunting and Related Services",micro,885,46,32,14,1271,1265,6
2022,3,Al Jawf Region,"Crop and Animal Production, Hunting and Related Services",medium,1,2,1,1,75,75,0
2022,3,Northern Borders Region,"Crop and Animal Production, Hunting and Related Services",small,4,4,3,1,31,31,0
2022,3,Northern Borders Region,"Crop and Animal Production, Hunting and Related Services",micro,96,3,3,0,117,117,0
2022,3,Riyadh Region,"Crop and Animal Production, Hunting and Related Services",small,483,845,399,446,6351,6332,19
2022,3,Riyadh Region,"Crop and Animal Production, Hunting and Related Services",large,16,2088,1845,243,14220,14202,18
2022,3,Riyadh Region,"Crop and Animal Production, Hunting and Related Services",micro,7949,625,306,319,14063,13997,66
2022,3,Riyadh Region,"Crop and Animal Production, Hunting and Related Services",medium,72,825,448,377,7085,7072,13
2022,3,Qassim Region,"Crop and Animal Production, Hunting and Related Services",small,107,161,97,64,1344,1339,5
2022,3,Qassim Region,"Crop and Animal Production, Hunting and Related Services",large,4,1563,1142,421,5549,5548,1
2022,3,Qassim Region,"Crop and Animal Production, Hunting and Related Services",micro,1369,150,97,53,2077,2066,11
2022,3,Qassim Region,"Crop and Animal Production, Hunting and Related Services",medium,15,174,121,53,1298,1296,2
2022,3,Al Madinah Region,"Crop and Animal Production, Hunting and Related Services",small,53,87,48,39,556,553,3
2022,3,Al Madinah Region,"Crop and Animal Production, Hunting and Related Services",micro,1013,105,70,35,1414,1406,8
2022,3,Al Madinah Region,"Crop and Animal Production, Hunting and Related Services",medium,3,56,35,21,245,244,1
2022,3,Tabuk Region,"Crop and Animal Production, Hunting and Related Services",small,41,37,21,16,441,441,0
2022,3,Tabuk Region,"Crop and Animal Production, Hunting and Related Services",large,2,261,163,98,1234,1233,1
2022,3,Tabuk Region,"Crop and Animal Production, Hunting and Related Services",micro,1013,50,28,22,1313,1313,0
2022,3,Tabuk Region,"Crop and Animal Production, Hunting and Related Services",medium,4,1,0,1,338,336,2
2022,3,Jazan Region,"Crop and Animal Production, Hunting and Related Services",small,40,38,24,14,449,447,2
2022,3,Jazan Region,"Crop and Animal Production, Hunting and Related Services",micro,801,28,18,10,1347,1343,4
2022,3,Jazan Region,"Crop and Animal Production, Hunting and Related Services",medium,1,4,3,1,54,54,0
2022,3,Hail Region,"Crop and Animal Production, Hunting and Related Services",small,47,40,21,19,546,543,3
2022,3,Hail Region,"Crop and Animal Production, Hunting and Related Services",large,2,549,535,14,2142,2141,1
2022,3,Hail Region,"Crop and Animal Production, Hunting and Related Services",micro,1615,95,51,44,2917,2910,7
2022,3,Hail Region,"Crop and Animal Production, Hunting and Related Services",medium,7,38,22,16,572,570,2
2022,3,Aseer Region,"Crop and Animal Production, Hunting and Related Services",small,69,99,66,33,782,781,1
2022,3,Aseer Region,"Crop and Animal Production, Hunting and Related Services",micro,1260,73,48,25,1588,1584,4
2022,3,Aseer Region,"Crop and Animal Production, Hunting and Related Services",medium,5,35,23,12,414,414,0
2022,3,Makkah Region,"Crop and Animal Production, Hunting and Related Services",small,105,117,65,52,1001,997,4
2022,3,Makkah Region,"Crop and Animal Production, Hunting and Related Services",large,3,592,393,199,2697,2696,1
2022,3,Makkah Region,"Crop and Animal Production, Hunting and Related Services",micro,2351,130,62,68,3406,3395,11
2022,3,Makkah Region,"Crop and Animal Production, Hunting and Related Services",medium,8,83,39,44,651,575,76
2022,3,Najran Region,"Crop and Animal Production, Hunting and Related Services",small,26,21,9,12,258,257,1
2022,3,Najran Region,"Crop and Animal Production, Hunting and Related Services",micro,768,23,11,12,1159,1155,4
2022,3,Najran Region,"Crop and Animal Production, Hunting and Related Services",medium,3,14,11,3,271,271,0
2022,3,Eastern Province,Support Services to Mining,small,55,500,410,90,614,607,7
2022,3,Eastern Province,Support Services to Mining,large,27,25010,24158,852,10509,10495,14
2022,3,Eastern Province,Support Services to Mining,micro,72,85,61,24,100,99,1
2022,3,Eastern Province,Support Services to Mining,medium,22,1279,1131,148,1097,1091,6
2022,3,Al Bahah Region,Support Services to Mining,micro,3,0,0,0,7,7,0
2022,3,Al Jawf Region,Support Services to Mining,micro,6,0,0,0,13,13,0
2022,3,Northern Borders Region,Support Services to Mining,small,2,4,2,2,24,24,0
2022,3,Riyadh Region,Support Services to Mining,small,11,63,47,16,97,97,0
2022,3,Riyadh Region,Support Services to Mining,large,1,431,355,76,113,113,0
2022,3,Riyadh Region,Support Services to Mining,micro,41,56,44,12,29,29,0
2022,3,Riyadh Region,Support Services to Mining,medium,2,79,66,13,104,102,2
2022,3,Qassim Region,Support Services to Mining,micro,3,3,2,1,10,10,0
2022,3,Al Madinah Region,Support Services to Mining,micro,6,3,2,1,8,8,0
2022,3,Tabuk Region,Support Services to Mining,small,1,3,2,1,13,13,0
2022,3,Tabuk Region,Support Services to Mining,micro,1,0,0,0,3,3,0
2022,3,Jazan Region,Support Services to Mining,small,1,0,0,0,22,22,0
2022,3,Jazan Region,Support Services to Mining,micro,6,1,1,0,11,11,0
2022,3,Hail Region,Support Services to Mining,micro,4,0,0,0,8,8,0
2022,3,Aseer Region,Support Services to Mining,small,1,10,10,0,19,19,0
2022,3,Aseer Region,Support Services to Mining,micro,13,2,1,1,25,25,0
2022,3,Makkah Region,Support Services to Mining,small,9,35,26,9,71,70,1
2022,3,Makkah Region,Support Services to Mining,large,2,265,145,120,496,495,1
2022,3,Makkah Region,Support Services to Mining,micro,28,11,8,3,47,47,0
2022,3,Makkah Region,Support Services to Mining,medium,3,235,207,28,166,163,3
2022,3,Najran Region,Support Services to Mining,micro,1,1,1,0,0,0,0
2022,3,Eastern Province,Information Service Activities,small,16,88,50,38,122,120,2
2022,3,Eastern Province,Information Service Activities,large,1,295,209,86,20,18,2
2022,3,Eastern Province,Information Service Activities,micro,49,46,18,28,60,59,1
2022,3,Eastern Province,Information Service Activities,medium,4,283,116,167,102,100,2
2022,3,Al Jawf Region,Information Service Activities,small,1,0,0,0,6,6,0
2022,3,Al Jawf Region,Information Service Activities,micro,7,4,2,2,12,12,0
2022,3,Northern Borders Region,Information Service Activities,micro,2,1,1,0,3,3,0
2022,3,Riyadh Region,Information Service Activities,small,162,1236,645,591,1381,1325,56
2022,3,Riyadh Region,Information Service Activities,large,9,8154,5020,3134,2917,2825,92
2022,3,Riyadh Region,Information Service Activities,micro,288,284,153,131,388,368,20
2022,3,Riyadh Region,Information Service Activities,medium,38,2398,1413,985,2041,1970,71
2022,3,Qassim Region,Information Service Activities,small,2,4,3,1,22,22,0
2022,3,Qassim Region,Information Service Activities,micro,9,5,1,4,13,13,0
2022,3,Al Madinah Region,Information Service Activities,small,2,3,0,3,10,10,0
2022,3,Al Madinah Region,Information Service Activities,micro,14,8,5,3,22,21,1
2022,3,Al Madinah Region,Information Service Activities,medium,1,61,17,44,4,3,1
2022,3,Tabuk Region,Information Service Activities,micro,9,3,1,2,11,11,0
2022,3,Jazan Region,Information Service Activities,micro,4,2,0,2,10,10,0
2022,3,Hail Region,Information Service Activities,small,1,15,11,4,7,7,0
2022,3,Hail Region,Information Service Activities,micro,4,3,0,3,8,8,0
2022,3,Aseer Region,Information Service Activities,micro,7,5,3,2,8,8,0
2022,3,Makkah Region,Information Service Activities,small,46,280,117,163,405,393,12
2022,3,Makkah Region,Information Service Activities,micro,120,75,35,40,189,184,5
2022,3,Makkah Region,Information Service Activities,medium,4,244,93,151,175,156,19
2022,3,Najran Region,Information Service Activities,micro,1,0,0,0,1,1,0
2022,3,Eastern Province,Food and Beverage Service Activities,small,3683,10164,4857,5307,38225,38089,136
2022,3,Eastern Province,Food and Beverage Service Activities,large,17,2869,2079,790,6641,6573,68
2022,3,Eastern Province,Food and Beverage Service Activities,micro,9267,3521,1638,1883,20235,20152,83
2022,3,Eastern Province,Food and Beverage Service Activities,medium,191,4311,1902,2409,13495,13455,40
2022,3,Al Bahah Region,Food and Beverage Service Activities,small,216,502,361,141,1931,1928,3
2022,3,Al Bahah Region,Food and Beverage Service Activities,micro,884,329,214,115,1832,1818,14
2022,3,Al Bahah Region,Food and Beverage Service Activities,medium,1,42,19,23,162,161,1
2022,3,Al Jawf Region,Food and Beverage Service Activities,small,224,514,351,163,2209,2209,0
2022,3,Al Jawf Region,Food and Beverage Service Activities,large,1,70,27,43,181,180,1
2022,3,Al Jawf Region,Food and Beverage Service Activities,micro,1149,276,183,93,2549,2538,11
2022,3,Al Jawf Region,Food and Beverage Service Activities,medium,3,70,49,21,147,147,0
2022,3,Northern Borders Region,Food and Beverage Service Activities,small,151,322,181,141,1481,1476,5
2022,3,Northern Borders Region,Food and Beverage Service Activities,micro,1116,212,122,90,2782,2769,13
2022,3,Northern Borders Region,Food and Beverage Service Activities,medium,5,75,29,46,282,276,6
2022,3,Riyadh Region,Food and Beverage Service Activities,small,4776,15077,6239,8838,53325,52861,464
2022,3,Riyadh Region,Food and Beverage Service Activities,large,66,15535,10441,5094,34723,34058,665
2022,3,Riyadh Region,Food and Beverage Service Activities,micro,13486,4399,2014,2385,29120,28872,248
2022,3,Riyadh Region,Food and Beverage Service Activities,medium,469,10908,4492,6416,31513,31111,402
2022,3,Qassim Region,Food and Beverage Service Activities,small,974,2244,1381,863,9690,9668,22
2022,3,Qassim Region,Food and Beverage Service Activities,micro,4273,986,611,375,10584,10557,27
2022,3,Qassim Region,Food and Beverage Service Activities,medium,36,689,407,282,2405,2404,1
2022,3,Al Madinah Region,Food and Beverage Service Activities,small,1168,2925,1622,1303,11190,11147,43
2022,3,Al Madinah Region,Food and Beverage Service Activities,large,2,192,156,36,529,527,2
2022,3,Al Madinah Region,Food and Beverage Service Activities,micro,5488,1526,900,626,11879,11789,90
2022,3,Al Madinah Region,Food and Beverage Service Activities,medium,37,661,408,253,2006,2000,6
2022,3,Tabuk Region,Food and Beverage Service Activities,small,457,1044,496,548,4449,4436,13
2022,3,Tabuk Region,Food and Beverage Service Activities,large,1,113,32,81,302,259,43
2022,3,Tabuk Region,Food and Beverage Service Activities,micro,2424,531,269,262,5412,5396,16
2022,3,Tabuk Region,Food and Beverage Service Activities,medium,18,354,157,197,1137,1135,2
2022,3,Jazan Region,Food and Beverage Service Activities,small,694,1700,933,767,6586,6571,15
2022,3,Jazan Region,Food and Beverage Service Activities,micro,4487,925,517,408,9871,9835,36
2022,3,Jazan Region,Food and Beverage Service Activities,medium,12,175,95,80,624,623,1
2022,3,Hail Region,Food and Beverage Service Activities,small,342,717,411,306,3329,3315,14
2022,3,Hail Region,Food and Beverage Service Activities,large,2,176,76,100,488,483,5
2022,3,Hail Region,Food and Beverage Service Activities,micro,1942,374,209,165,4508,4487,21
2022,3,Hail Region,Food and Beverage Service Activities,medium,14,205,112,93,898,897,1
2022,3,Aseer Region,Food and Beverage Service Activities,small,1371,3297,1893,1404,13347,13315,32
2022,3,Aseer Region,Food and Beverage Service Activities,micro,6101,1647,934,713,13679,13621,58
2022,3,Aseer Region,Food and Beverage Service Activities,medium,48,833,473,360,2533,2523,10
2022,3,Makkah Region,Food and Beverage Service Activities,small,4450,12575,5981,6594,47387,46865,522
2022,3,Makkah Region,Food and Beverage Service Activities,large,26,7360,5208,2152,15652,15433,219
2022,3,Makkah Region,Food and Beverage Service Activities,micro,16911,4872,2370,2502,36073,35622,451
2022,3,Makkah Region,Food and Beverage Service Activities,medium,297,6565,3300,3265,19093,18844,249
2022,3,Najran Region,Food and Beverage Service Activities,small,249,572,252,320,2569,2564,5
2022,3,Najran Region,Food and Beverage Service Activities,large,1,160,89,71,452,450,2
2022,3,Najran Region,Food and Beverage Service Activities,micro,1602,279,131,148,3692,3675,17
2022,3,Najran Region,Food and Beverage Service Activities,medium,10,181,73,108,744,741,3
2022,3,Eastern Province,"Waste Collection, Treatment, and Disposal, Materials Recovery",small,48,151,77,74,624,622,2
2022,3,Eastern Province,"Waste Collection, Treatment, and Disposal, Materials Recovery",large,3,1315,749,566,5906,4466,1440
2022,3,Eastern Province,"Waste Collection, Treatment, and Disposal, Materials Recovery",micro,35,30,18,12,54,54,0
2022,3,Eastern Province,"Waste Collection, Treatment, and Disposal, Materials Recovery",medium,13,311,229,82,1159,1156,3
2022,3,Al Bahah Region,"Waste Collection, Treatment, and Disposal, Materials Recovery",micro,1,0,0,0,2,2,0
2022,3,Al Jawf Region,"Waste Collection, Treatment, and Disposal, Materials Recovery",small,1,3,1,2,16,16,0
2022,3,Al Jawf Region,"Waste Collection, Treatment, and Disposal, Materials Recovery",micro,3,2,0,2,2,2,0
2022,3,Riyadh Region,"Waste Collection, Treatment, and Disposal, Materials Recovery",small,48,165,84,81,654,650,4
2022,3,Riyadh Region,"Waste Collection, Treatment, and Disposal, Materials Recovery",large,11,5675,3369,2306,32003,30527,1476
2022,3,Riyadh Region,"Waste Collection, Treatment, and Disposal, Materials Recovery",micro,105,44,26,18,240,237,3
2022,3,Riyadh Region,"Waste Collection, Treatment, and Disposal, Materials Recovery",medium,13,332,248,84,1299,1298,1
2022,3,Qassim Region,"Waste Collection, Treatment, and Disposal, Materials Recovery",small,9,32,17,15,114,114,0
2022,3,Qassim Region,"Waste Collection, Treatment, and Disposal, Materials Recovery",micro,10,0,0,0,20,20,0
2022,3,Qassim Region,"Waste Collection, Treatment, and Disposal, Materials Recovery",medium,2,30,14,16,166,110,56
2022,3,Al Madinah Region,"Waste Collection, Treatment, and Disposal, Materials Recovery",small,4,10,6,4,61,61,0
2022,3,Al Madinah Region,"Waste Collection, Treatment, and Disposal, Materials Recovery",large,1,182,85,97,200,200,0
2022,3,Al Madinah Region,"Waste Collection, Treatment, and Disposal, Materials Recovery",micro,8,9,2,7,16,16,0
2022,3,Al Madinah Region,"Waste Collection, Treatment, and Disposal, Materials Recovery",medium,3,31,20,11,279,279,0
2022,3,Tabuk Region,"Waste Collection, Treatment, and Disposal, Materials Recovery",micro,3,3,2,1,5,5,0
2022,3,Jazan Region,"Waste Collection, Treatment, and Disposal, Materials Recovery",small,4,10,7,3,51,51,0
2022,3,Jazan Region,"Waste Collection, Treatment, and Disposal, Materials Recovery",micro,5,3,2,1,9,9,0
2022,3,Jazan Region,"Waste Collection, Treatment, and Disposal, Materials Recovery",medium,1,13,5,8,44,44,0
2022,3,Hail Region,"Waste Collection, Treatment, and Disposal, Materials Recovery",small,1,1,0,1,5,5,0
2022,3,Hail Region,"Waste Collection, Treatment, and Disposal, Materials Recovery",micro,7,1,1,0,14,14,0
2022,3,Aseer Region,"Waste Collection, Treatment, and Disposal, Materials Recovery",small,2,2,1,1,11,11,0
2022,3,Aseer Region,"Waste Collection, Treatment, and Disposal, Materials Recovery",large,1,143,75,68,108,108,0
2022,3,Aseer Region,"Waste Collection, Treatment, and Disposal, Materials Recovery",micro,12,0,0,0,22,22,0
2022,3,Aseer Region,"Waste Collection, Treatment, and Disposal, Materials Recovery",medium,2,67,65,2,171,171,0
2022,3,Makkah Region,"Waste Collection, Treatment, and Disposal, Materials Recovery",small,49,138,74,64,570,564,6
2022,3,Makkah Region,"Waste Collection, Treatment, and Disposal, Materials Recovery",large,4,1366,645,721,5920,5866,54
2022,3,Makkah Region,"Waste Collection, Treatment, and Disposal, Materials Recovery",micro,74,46,23,23,131,129,2
2022,3,Makkah Region,"Waste Collection, Treatment, and Disposal, Materials Recovery",medium,5,57,32,25,263,263,0
2022,3,Najran Region,"Waste Collection, Treatment, and Disposal, Materials Recovery",small,2,2,1,1,11,11,0
2022,3,Najran Region,"Waste Collection, Treatment, and Disposal, Materials Recovery",micro,10,2,0,2,28,28,0
2022,3,Eastern Province,Services to Buildings and Landscape Activities,small,517,1545,813,732,6619,6535,84
2022,3,Eastern Province,Services to Buildings and Landscape Activities,large,78,14531,10514,4017,69322,68165,1157
2022,3,Eastern Province,Services to Buildings and Landscape Activities,micro,1217,422,219,203,2508,2492,16
2022,3,Eastern Province,Services to Buildings and Landscape Activities,medium,151,3474,2234,1240,13202,12968,234
2022,3,Al Bahah Region,Services to Buildings and Landscape Activities,small,8,28,20,8,83,83,0
2022,3,Al Bahah Region,Services to Buildings and Landscape Activities,large,1,116,59,57,641,585,56
2022,3,Al Bahah Region,Services to Buildings and Landscape Activities,micro,52,17,8,9,109,109,0
2022,3,Al Bahah Region,Services to Buildings and Landscape Activities,medium,3,109,68,41,280,279,1
2022,3,Al Jawf Region,Services to Buildings and Landscape Activities,small,29,73,30,43,286,285,1
2022,3,Al Jawf Region,Services to Buildings and Landscape Activities,large,1,76,26,50,240,240,0
2022,3,Al Jawf Region,Services to Buildings and Landscape Activities,micro,191,32,17,15,431,426,5
2022,3,Al Jawf Region,Services to Buildings and Landscape Activities,medium,4,50,30,20,198,198,0
2022,3,Northern Borders Region,Services to Buildings and Landscape Activities,small,11,43,20,23,111,111,0
2022,3,Northern Borders Region,Services to Buildings and Landscape Activities,large,1,208,110,98,554,508,46
2022,3,Northern Borders Region,Services to Buildings and Landscape Activities,micro,79,13,7,6,194,193,1
2022,3,Northern Borders Region,Services to Buildings and Landscape Activities,medium,2,56,45,11,153,153,0
2022,3,Riyadh Region,Services to Buildings and Landscape Activities,small,1389,4236,2056,2180,19033,18603,430
2022,3,Riyadh Region,Services to Buildings and Landscape Activities,large,185,37525,22763,14762,150946,139953,10993
2022,3,Riyadh Region,Services to Buildings and Landscape Activities,micro,3661,1122,549,573,7558,7480,78
2022,3,Riyadh Region,Services to Buildings and Landscape Activities,medium,465,8605,4125,4480,43190,41872,1318
2022,3,Qassim Region,Services to Buildings and Landscape Activities,small,206,475,268,207,3085,3068,17
2022,3,Qassim Region,Services to Buildings and Landscape Activities,large,27,1492,678,814,11824,11544,280
2022,3,Qassim Region,Services to Buildings and Landscape Activities,micro,1058,189,110,79,2586,2573,13
2022,3,Qassim Region,Services to Buildings and Landscape Activities,medium,139,1657,930,727,16188,16051,137
2022,3,Al Madinah Region,Services to Buildings and Landscape Activities,small,155,414,242,172,1766,1745,21
2022,3,Al Madinah Region,Services to Buildings and Landscape Activities,large,5,380,147,233,1623,1568,55
2022,3,Al Madinah Region,Services to Buildings and Landscape Activities,micro,702,154,95,59,1613,1600,13
2022,3,Al Madinah Region,Services to Buildings and Landscape Activities,medium,32,711,532,179,2650,2556,94
2022,3,Tabuk Region,Services to Buildings and Landscape Activities,small,35,60,35,25,303,303,0
2022,3,Tabuk Region,Services to Buildings and Landscape Activities,micro,292,43,20,23,685,682,3
2022,3,Tabuk Region,Services to Buildings and Landscape Activities,medium,14,254,100,154,1080,1078,2
2022,3,Jazan Region,Services to Buildings and Landscape Activities,small,36,128,67,61,408,406,2
2022,3,Jazan Region,Services to Buildings and Landscape Activities,micro,305,60,32,28,785,784,1
2022,3,Jazan Region,Services to Buildings and Landscape Activities,medium,5,99,57,42,484,457,27
2022,3,Hail Region,Services to Buildings and Landscape Activities,small,42,86,42,44,509,505,4
2022,3,Hail Region,Services to Buildings and Landscape Activities,large,1,824,580,244,959,868,91
2022,3,Hail Region,Services to Buildings and Landscape Activities,micro,312,42,16,26,699,695,4
2022,3,Hail Region,Services to Buildings and Landscape Activities,medium,16,331,165,166,1121,1101,20
2022,3,Aseer Region,Services to Buildings and Landscape Activities,small,73,223,144,79,891,880,11
2022,3,Aseer Region,Services to Buildings and Landscape Activities,large,7,1580,1311,269,3702,3607,95
2022,3,Aseer Region,Services to Buildings and Landscape Activities,micro,457,108,58,50,1084,1078,6
2022,3,Aseer Region,Services to Buildings and Landscape Activities,medium,10,208,113,95,1087,1082,5
2022,3,Makkah Region,Services to Buildings and Landscape Activities,small,901,2819,1358,1461,11659,11365,294
2022,3,Makkah Region,Services to Buildings and Landscape Activities,large,55,9896,6420,3476,40765,39525,1240
2022,3,Makkah Region,Services to Buildings and Landscape Activities,micro,2766,853,442,411,6348,6242,106
2022,3,Makkah Region,Services to Buildings and Landscape Activities,medium,227,4869,2708,2161,19163,18543,620
2022,3,Najran Region,Services to Buildings and Landscape Activities,small,46,118,77,41,631,629,2
2022,3,Najran Region,Services to Buildings and Landscape Activities,large,8,1408,928,480,7456,7397,59
2022,3,Najran Region,Services to Buildings and Landscape Activities,micro,174,32,21,11,400,396,4
2022,3,Najran Region,Services to Buildings and Landscape Activities,medium,14,311,187,124,1204,1200,4
2022,3,Eastern Province,Publishing Activities,small,21,120,62,58,173,171,2
2022,3,Eastern Province,Publishing Activities,micro,63,48,21,27,121,120,1
2022,3,Eastern Province,Publishing Activities,medium,2,124,104,20,137,137,0
2022,3,Al Bahah Region,Publishing Activities,small,1,3,2,1,13,13,0
2022,3,Al Bahah Region,Publishing Activities,micro,6,2,2,0,11,11,0
2022,3,Al Jawf Region,Publishing Activities,micro,2,0,0,0,2,2,0
2022,3,Northern Borders Region,Publishing Activities,micro,2,0,0,0,3,3,0
2022,3,Riyadh Region,Publishing Activities,small,66,421,203,218,564,549,15
2022,3,Riyadh Region,Publishing Activities,large,3,1600,500,1100,1546,1430,116
2022,3,Riyadh Region,Publishing Activities,micro,179,145,66,79,239,234,5
2022,3,Riyadh Region,Publishing Activities,medium,8,423,225,198,417,402,15
2022,3,Qassim Region,Publishing Activities,small,1,2,1,1,4,4,0
2022,3,Qassim Region,Publishing Activities,micro,8,1,1,0,13,13,0
2022,3,Qassim Region,Publishing Activities,medium,1,0,0,0,61,61,0
2022,3,Al Madinah Region,Publishing Activities,small,3,10,5,5,10,10,0
2022,3,Al Madinah Region,Publishing Activities,micro,11,1,1,0,22,22,0
2022,3,Tabuk Region,Publishing Activities,micro,2,0,0,0,4,4,0
2022,3,Jazan Region,Publishing Activities,micro,5,1,0,1,8,8,0
2022,3,Hail Region,Publishing Activities,small,2,1,0,1,14,14,0
2022,3,Hail Region,Publishing Activities,micro,24,6,4,2,80,80,0
2022,3,Aseer Region,Publishing Activities,micro,12,4,4,0,28,28,0
2022,3,Aseer Region,Publishing Activities,medium,1,19,12,7,57,57,0
2022,3,Makkah Region,Publishing Activities,small,15,59,27,32,169,168,1
2022,3,Makkah Region,Publishing Activities,micro,95,47,21,26,150,148,2
2022,3,Makkah Region,Publishing Activities,medium,3,93,75,18,131,127,4
2022,3,Najran Region,Publishing Activities,small,1,2,2,0,5,5,0
2022,3,Najran Region,Publishing Activities,micro,2,0,0,0,4,4,0
2022,3,Najran Region,Publishing Activities,medium,1,0,0,0,79,79,0
2022,3,Eastern Province,Activities of Membership Organizations,small,19,147,56,91,87,87,0
2022,3,Eastern Province,Activities of Membership Organizations,micro,66,59,36,23,84,80,4
2022,3,Al Bahah Region,Activities of Membership Organizations,micro,12,15,12,3,7,7,0
2022,3,Al Jawf Region,Activities of Membership Organizations,small,3,30,25,5,10,10,0
2022,3,Al Jawf Region,Activities of Membership Organizations,micro,22,21,14,7,28,28,0
2022,3,Northern Borders Region,Activities of Membership Organizations,small,1,1,1,0,15,15,0
2022,3,Northern Borders Region,Activities of Membership Organizations,micro,5,7,6,1,3,3,0
2022,3,Riyadh Region,Activities of Membership Organizations,small,84,405,198,207,583,565,18
2022,3,Riyadh Region,Activities of Membership Organizations,micro,2241,305,164,141,4985,4920,65
2022,3,Riyadh Region,Activities of Membership Organizations,medium,1,146,49,97,71,33,38
2022,3,Qassim Region,Activities of Membership Organizations,small,9,52,23,29,36,35,1
2022,3,Qassim Region,Activities of Membership Organizations,micro,71,51,39,12,115,115,0
2022,3,Al Madinah Region,Activities of Membership Organizations,small,7,44,39,5,53,53,0
2022,3,Al Madinah Region,Activities of Membership Organizations,micro,80,31,23,8,135,131,4
2022,3,Tabuk Region,Activities of Membership Organizations,small,4,52,14,38,7,6,1
2022,3,Tabuk Region,Activities of Membership Organizations,micro,17,13,7,6,24,23,1
2022,3,Tabuk Region,Activities of Membership Organizations,medium,1,71,17,54,0,0,0
2022,3,Jazan Region,Activities of Membership Organizations,small,8,139,75,64,35,34,1
2022,3,Jazan Region,Activities of Membership Organizations,micro,121,29,18,11,228,222,6
2022,3,Jazan Region,Activities of Membership Organizations,medium,1,58,5,53,0,0,0
2022,3,Hail Region,Activities of Membership Organizations,small,5,31,20,11,16,16,0
2022,3,Hail Region,Activities of Membership Organizations,micro,23,19,6,13,36,36,0
2022,3,Aseer Region,Activities of Membership Organizations,small,3,19,3,16,13,11,2
2022,3,Aseer Region,Activities of Membership Organizations,micro,36,32,20,12,38,36,2
2022,3,Aseer Region,Activities of Membership Organizations,medium,1,49,12,37,26,25,1
2022,3,Makkah Region,Activities of Membership Organizations,small,31,205,134,71,240,238,2
2022,3,Makkah Region,Activities of Membership Organizations,large,1,445,227,218,74,74,0
2022,3,Makkah Region,Activities of Membership Organizations,micro,263,156,103,53,393,380,13
2022,3,Makkah Region,Activities of Membership Organizations,medium,3,246,145,101,54,50,4
2022,3,Najran Region,Activities of Membership Organizations,small,1,45,43,2,4,4,0
2022,3,Najran Region,Activities of Membership Organizations,micro,33,22,16,6,43,42,1
2022,3,Eastern Province,"Libraries, Archives, Museums, and Other Cultural Activities",small,5,19,13,6,58,57,1
2022,3,Eastern Province,"Libraries, Archives, Museums, and Other Cultural Activities",micro,30,14,6,8,48,48,0
2022,3,Al Bahah Region,"Libraries, Archives, Museums, and Other Cultural Activities",micro,2,1,0,1,5,5,0
2022,3,Northern Borders Region,"Libraries, Archives, Museums, and Other Cultural Activities",micro,3,0,0,0,5,5,0
2022,3,Riyadh Region,"Libraries, Archives, Museums, and Other Cultural Activities",small,4,10,7,3,22,21,1
2022,3,Riyadh Region,"Libraries, Archives, Museums, and Other Cultural Activities",micro,23,14,6,8,46,45,1
2022,3,Qassim Region,"Libraries, Archives, Museums, and Other Cultural Activities",small,2,4,4,0,10,10,0
2022,3,Qassim Region,"Libraries, Archives, Museums, and Other Cultural Activities",micro,4,4,3,1,9,9,0
2022,3,Al Madinah Region,"Libraries, Archives, Museums, and Other Cultural Activities",small,3,3,1,2,21,21,0
2022,3,Al Madinah Region,"Libraries, Archives, Museums, and Other Cultural Activities",micro,27,12,9,3,47,47,0
2022,3,Tabuk Region,"Libraries, Archives, Museums, and Other Cultural Activities",micro,6,4,4,0,10,10,0
2022,3,Jazan Region,"Libraries, Archives, Museums, and Other Cultural Activities",micro,11,0,0,0,28,28,0
2022,3,Hail Region,"Libraries, Archives, Museums, and Other Cultural Activities",micro,5,0,0,0,10,10,0
2022,3,Aseer Region,"Libraries, Archives, Museums, and Other Cultural Activities",small,1,2,1,1,4,4,0
2022,3,Aseer Region,"Libraries, Archives, Museums, and Other Cultural Activities",micro,10,4,4,0,12,12,0
2022,3,Makkah Region,"Libraries, Archives, Museums, and Other Cultural Activities",small,5,3,2,1,40,40,0
2022,3,Makkah Region,"Libraries, Archives, Museums, and Other Cultural Activities",micro,74,18,12,6,122,120,2
2022,3,Makkah Region,"Libraries, Archives, Museums, and Other Cultural Activities",medium,1,42,23,19,32,32,0
2022,3,Najran Region,"Libraries, Archives, Museums, and Other Cultural Activities",micro,6,1,1,0,13,13,0
2022,3,Eastern Province,"Head Office Activities, Management Consultancy Activities",small,39,284,175,109,329,319,10
2022,3,Eastern Province,"Head Office Activities, Management Consultancy Activities",micro,107,100,50,50,121,115,6
2022,3,Eastern Province,"Head Office Activities, Management Consultancy Activities",medium,5,154,91,63,220,218,2
2022,3,Al Bahah Region,"Head Office Activities, Management Consultancy Activities",micro,2,1,0,1,3,3,0
2022,3,Al Jawf Region,"Head Office Activities, Management Consultancy Activities",micro,1,1,1,0,1,1,0
2022,3,Al Jawf Region,"Head Office Activities, Management Consultancy Activities",medium,1,18,2,16,33,30,3
2022,3,Northern Borders Region,"Head Office Activities, Management Consultancy Activities",micro,3,1,0,1,9,9,0
2022,3,Riyadh Region,"Head Office Activities, Management Consultancy Activities",small,216,1598,861,737,1602,1457,145
2022,3,Riyadh Region,"Head Office Activities, Management Consultancy Activities",large,9,9788,5451,4337,3977,3777,200
2022,3,Riyadh Region,"Head Office Activities, Management Consultancy Activities",micro,672,643,326,317,912,864,48
2022,3,Riyadh Region,"Head Office Activities, Management Consultancy Activities",medium,31,1869,1191,678,1621,1542,79
2022,3,Qassim Region,"Head Office Activities, Management Consultancy Activities",small,1,3,1,2,4,4,0
2022,3,Qassim Region,"Head Office Activities, Management Consultancy Activities",micro,13,11,5,6,24,23,1
2022,3,Qassim Region,"Head Office Activities, Management Consultancy Activities",medium,1,88,81,7,109,109,0
2022,3,Al Madinah Region,"Head Office Activities, Management Consultancy Activities",small,5,9,6,3,25,25,0
2022,3,Al Madinah Region,"Head Office Activities, Management Consultancy Activities",micro,31,19,5,14,38,38,0
2022,3,Al Madinah Region,"Head Office Activities, Management Consultancy Activities",medium,1,109,73,36,1,1,0
2022,3,Tabuk Region,"Head Office Activities, Management Consultancy Activities",micro,2,1,1,0,1,1,0
2022,3,Jazan Region,"Head Office Activities, Management Consultancy Activities",micro,5,10,2,8,7,6,1
2022,3,Hail Region,"Head Office Activities, Management Consultancy Activities",micro,7,2,2,0,17,17,0
2022,3,Aseer Region,"Head Office Activities, Management Consultancy Activities",micro,14,13,7,6,18,17,1
2022,3,Makkah Region,"Head Office Activities, Management Consultancy Activities",small,70,391,202,189,562,530,32
2022,3,Makkah Region,"Head Office Activities, Management Consultancy Activities",micro,240,190,101,89,337,316,21
2022,3,Makkah Region,"Head Office Activities, Management Consultancy Activities",medium,2,118,90,28,103,100,3
2022,3,Najran Region,"Head Office Activities, Management Consultancy Activities",micro,4,0,0,0,11,11,0
2022,3,Eastern Province,"Architectural and Engineering Activities, Technical Testing, and Analysis",small,253,1554,977,577,2358,2330,28
2022,3,Eastern Province,"Architectural and Engineering Activities, Technical Testing, and Analysis",large,23,5379,4410,969,6903,6882,21
2022,3,Eastern Province,"Architectural and Engineering Activities, Technical Testing, and Analysis",micro,442,384,212,172,682,672,10
2022,3,Eastern Province,"Architectural and Engineering Activities, Technical Testing, and Analysis",medium,70,2862,2141,721,4092,4073,19
2022,3,Al Bahah Region,"Architectural and Engineering Activities, Technical Testing, and Analysis",small,16,51,25,26,122,122,0
2022,3,Al Bahah Region,"Architectural and Engineering Activities, Technical Testing, and Analysis",micro,99,20,11,9,214,214,0
2022,3,Al Bahah Region,"Architectural and Engineering Activities, Technical Testing, and Analysis",medium,1,22,13,9,55,55,0
2022,3,Al Jawf Region,"Architectural and Engineering Activities, Technical Testing, and Analysis",small,14,56,39,17,143,142,1
2022,3,Al Jawf Region,"Architectural and Engineering Activities, Technical Testing, and Analysis",micro,105,43,26,17,202,201,1
2022,3,Northern Borders Region,"Architectural and Engineering Activities, Technical Testing, and Analysis",small,6,29,13,16,28,28,0
2022,3,Northern Borders Region,"Architectural and Engineering Activities, Technical Testing, and Analysis",micro,56,20,13,7,118,117,1
2022,3,Riyadh Region,"Architectural and Engineering Activities, Technical Testing, and Analysis",small,492,2743,1577,1166,4423,4324,99
2022,3,Riyadh Region,"Architectural and Engineering Activities, Technical Testing, and Analysis",large,19,4464,3123,1341,6231,6150,81
2022,3,Riyadh Region,"Architectural and Engineering Activities, Technical Testing, and Analysis",micro,3319,913,497,416,6872,6812,60
2022,3,Riyadh Region,"Architectural and Engineering Activities, Technical Testing, and Analysis",medium,112,5416,3521,1895,7937,7830,107
2022,3,Qassim Region,"Architectural and Engineering Activities, Technical Testing, and Analysis",small,34,153,101,52,301,299,2
2022,3,Qassim Region,"Architectural and Engineering Activities, Technical Testing, and Analysis",micro,162,82,57,25,297,297,0
2022,3,Qassim Region,"Architectural and Engineering Activities, Technical Testing, and Analysis",medium,5,177,128,49,231,230,1
2022,3,Al Madinah Region,"Architectural and Engineering Activities, Technical Testing, and Analysis",small,74,369,205,164,709,704,5
2022,3,Al Madinah Region,"Architectural and Engineering Activities, Technical Testing, and Analysis",large,1,144,81,63,182,181,1
2022,3,Al Madinah Region,"Architectural and Engineering Activities, Technical Testing, and Analysis",micro,143,69,35,34,256,256,0
2022,3,Al Madinah Region,"Architectural and Engineering Activities, Technical Testing, and Analysis",medium,2,126,115,11,115,115,0
2022,3,Tabuk Region,"Architectural and Engineering Activities, Technical Testing, and Analysis",small,19,92,58,34,148,148,0
2022,3,Tabuk Region,"Architectural and Engineering Activities, Technical Testing, and Analysis",micro,73,42,24,18,136,132,4
2022,3,Tabuk Region,"Architectural and Engineering Activities, Technical Testing, and Analysis",medium,1,34,22,12,30,30,0
2022,3,Jazan Region,"Architectural and Engineering Activities, Technical Testing, and Analysis",small,16,85,54,31,130,129,1
2022,3,Jazan Region,"Architectural and Engineering Activities, Technical Testing, and Analysis",micro,122,66,37,29,197,193,4
2022,3,Jazan Region,"Architectural and Engineering Activities, Technical Testing, and Analysis",medium,2,51,26,25,75,75,0
2022,3,Hail Region,"Architectural and Engineering Activities, Technical Testing, and Analysis",small,18,92,43,49,198,197,1
2022,3,Hail Region,"Architectural and Engineering Activities, Technical Testing, and Analysis",micro,163,34,26,8,357,356,1
2022,3,Hail Region,"Architectural and Engineering Activities, Technical Testing, and Analysis",medium,1,52,42,10,58,58,0
2022,3,Aseer Region,"Architectural and Engineering Activities, Technical Testing, and Analysis",small,57,203,144,59,394,392,2
2022,3,Aseer Region,"Architectural and Engineering Activities, Technical Testing, and Analysis",micro,242,147,87,60,428,425,3
2022,3,Aseer Region,"Architectural and Engineering Activities, Technical Testing, and Analysis",medium,2,46,42,4,88,87,1
2022,3,Makkah Region,"Architectural and Engineering Activities, Technical Testing, and Analysis",small,373,1831,1089,742,3212,3165,47
2022,3,Makkah Region,"Architectural and Engineering Activities, Technical Testing, and Analysis",large,7,1164,708,456,1816,1809,7
2022,3,Makkah Region,"Architectural and Engineering Activities, Technical Testing, and Analysis",micro,940,596,333,263,1598,1569,29
2022,3,Makkah Region,"Architectural and Engineering Activities, Technical Testing, and Analysis",medium,27,1256,786,470,1783,1764,19
2022,3,Najran Region,"Architectural and Engineering Activities, Technical Testing, and Analysis",small,15,63,49,14,127,127,0
2022,3,Najran Region,"Architectural and Engineering Activities, Technical Testing, and Analysis",micro,149,29,18,11,334,333,1
2022,3,Najran Region,"Architectural and Engineering Activities, Technical Testing, and Analysis",medium,1,17,12,5,33,33,0
2022,3,Eastern Province,"Treatment and Disposal of Non-Hazardous Waste, Other Waste Management Services",small,4,11,4,7,62,62,0
2022,3,Eastern Province,"Treatment and Disposal of Non-Hazardous Waste, Other Waste Management Services",micro,5,2,2,0,7,7,0
2022,3,Eastern Province,"Treatment and Disposal of Non-Hazardous Waste, Other Waste Management Services",medium,1,18,17,1,58,58,0
2022,3,Riyadh Region,"Treatment and Disposal of Non-Hazardous Waste, Other Waste Management Services",small,2,28,27,1,22,22,0
2022,3,Riyadh Region,"Treatment and Disposal of Non-Hazardous Waste, Other Waste Management Services",large,1,1927,1446,481,12000,11646,354
2022,3,Riyadh Region,"Treatment and Disposal of Non-Hazardous Waste, Other Waste Management Services",micro,4,3,2,1,6,6,0
2022,3,Makkah Region,"Treatment and Disposal of Non-Hazardous Waste, Other Waste Management Services",small,2,10,8,2,39,39,0
2022,3,Makkah Region,"Treatment and Disposal of Non-Hazardous Waste, Other Waste Management Services",micro,1,1,0,1,2,2,0
2022,3,Najran Region,"Treatment and Disposal of Non-Hazardous Waste, Other Waste Management Services",micro,1,1,0,1,0,0,0
2022,3,Eastern Province,Social Work Activities Without Accommodation,small,180,1976,360,1616,447,382,65
2022,3,Eastern Province,Social Work Activities Without Accommodation,large,2,312,145,167,367,261,106
2022,3,Eastern Province,Social Work Activities Without Accommodation,micro,198,359,61,298,130,108,22
2022,3,Eastern Province,Social Work Activities Without Accommodation,medium,18,1329,343,986,412,283,129
2022,3,Al Bahah Region,Social Work Activities Without Accommodation,small,27,288,137,151,82,76,6
2022,3,Al Bahah Region,Social Work Activities Without Accommodation,micro,43,81,72,9,36,36,0
2022,3,Al Jawf Region,Social Work Activities Without Accommodation,small,22,233,125,108,108,103,5
2022,3,Al Jawf Region,Social Work Activities Without Accommodation,micro,22,43,30,13,12,12,0
2022,3,Northern Borders Region,Social Work Activities Without Accommodation,small,14,118,43,75,35,32,3
2022,3,Northern Borders Region,Social Work Activities Without Accommodation,micro,24,42,25,17,18,18,0
2022,3,Riyadh Region,Social Work Activities Without Accommodation,small,286,2960,769,2191,1478,1271,207
2022,3,Riyadh Region,Social Work Activities Without Accommodation,large,7,1536,762,774,786,744,42
2022,3,Riyadh Region,Social Work Activities Without Accommodation,micro,414,555,222,333,438,403,35
2022,3,Riyadh Region,Social Work Activities Without Accommodation,medium,29,2115,1012,1103,826,701,125
2022,3,Qassim Region,Social Work Activities Without Accommodation,small,72,745,355,390,331,309,22
2022,3,Qassim Region,Social Work Activities Without Accommodation,micro,99,143,83,60,108,103,5
2022,3,Qassim Region,Social Work Activities Without Accommodation,medium,5,363,124,239,215,163,52
2022,3,Al Madinah Region,Social Work Activities Without Accommodation,small,72,651,321,330,251,212,39
2022,3,Al Madinah Region,Social Work Activities Without Accommodation,micro,155,287,165,122,105,93,12
2022,3,Al Madinah Region,Social Work Activities Without Accommodation,medium,13,693,299,394,269,214,55
2022,3,Tabuk Region,Social Work Activities Without Accommodation,small,12,132,71,61,27,27,0
2022,3,Tabuk Region,Social Work Activities Without Accommodation,micro,41,100,59,41,17,16,1
2022,3,Tabuk Region,Social Work Activities Without Accommodation,medium,1,57,1,56,7,4,3
2022,3,Jazan Region,Social Work Activities Without Accommodation,small,29,228,136,92,115,111,4
2022,3,Jazan Region,Social Work Activities Without Accommodation,micro,67,120,85,35,50,49,1
2022,3,Jazan Region,Social Work Activities Without Accommodation,medium,2,114,35,79,15,11,4
2022,3,Hail Region,Social Work Activities Without Accommodation,small,20,267,106,161,62,57,5
2022,3,Hail Region,Social Work Activities Without Accommodation,micro,66,104,67,37,60,60,0
2022,3,Aseer Region,Social Work Activities Without Accommodation,small,65,536,281,255,309,296,13
2022,3,Aseer Region,Social Work Activities Without Accommodation,micro,111,236,177,59,63,62,1
2022,3,Aseer Region,Social Work Activities Without Accommodation,medium,4,176,45,131,87,62,25
2022,3,Makkah Region,Social Work Activities Without Accommodation,small,248,2444,757,1687,1076,838,238
2022,3,Makkah Region,Social Work Activities Without Accommodation,micro,411,648,251,397,356,306,50
2022,3,Makkah Region,Social Work Activities Without Accommodation,medium,23,1190,634,556,810,726,84
2022,3,Najran Region,Social Work Activities Without Accommodation,small,10,67,34,33,71,71,0
2022,3,Najran Region,Social Work Activities Without Accommodation,micro,33,51,27,24,40,39,1
2022,3,Eastern Province,"Financial Service Activities, Except Insurance and Pension Funding",small,73,494,304,190,681,677,4
2022,3,Eastern Province,"Financial Service Activities, Except Insurance and Pension Funding",large,2,686,391,295,149,134,15
2022,3,Eastern Province,"Financial Service Activities, Except Insurance and Pension Funding",micro,188,136,84,52,316,308,8
2022,3,Eastern Province,"Financial Service Activities, Except Insurance and Pension Funding",medium,22,1225,803,422,789,770,19
2022,3,Al Bahah Region,"Financial Service Activities, Except Insurance and Pension Funding",small,1,3,2,1,4,4,0
2022,3,Al Bahah Region,"Financial Service Activities, Except Insurance and Pension Funding",micro,5,2,2,0,6,6,0
2022,3,Al Jawf Region,"Financial Service Activities, Except Insurance and Pension Funding",small,2,16,16,0,0,0,0
2022,3,Al Jawf Region,"Financial Service Activities, Except Insurance and Pension Funding",micro,9,4,4,0,11,11,0
2022,3,Northern Borders Region,"Financial Service Activities, Except Insurance and Pension Funding",micro,6,0,0,0,16,16,0
2022,3,Northern Borders Region,"Financial Service Activities, Except Insurance and Pension Funding",medium,1,0,0,0,70,70,0
2022,3,Riyadh Region,"Financial Service Activities, Except Insurance and Pension Funding",small,181,1549,952,597,1313,1252,61
2022,3,Riyadh Region,"Financial Service Activities, Except Insurance and Pension Funding",large,11,20505,16516,3989,1093,1071,22
2022,3,Riyadh Region,"Financial Service Activities, Except Insurance and Pension Funding",micro,465,479,322,157,595,578,17
2022,3,Riyadh Region,"Financial Service Activities, Except Insurance and Pension Funding",medium,40,2684,1817,867,1780,1690,90
2022,3,Qassim Region,"Financial Service Activities, Except Insurance and Pension Funding",small,7,39,35,4,80,80,0
2022,3,Qassim Region,"Financial Service Activities, Except Insurance and Pension Funding",micro,29,13,8,5,48,48,0
2022,3,Al Madinah Region,"Financial Service Activities, Except Insurance and Pension Funding",small,3,19,18,1,21,21,0
2022,3,Al Madinah Region,"Financial Service Activities, Except Insurance and Pension Funding",micro,45,34,22,12,73,71,2
2022,3,Al Madinah Region,"Financial Service Activities, Except Insurance and Pension Funding",medium,1,101,84,17,60,60,0
2022,3,Tabuk Region,"Financial Service Activities, Except Insurance and Pension Funding",micro,15,3,2,1,29,29,0
2022,3,Jazan Region,"Financial Service Activities, Except Insurance and Pension Funding",micro,15,1,0,1,36,36,0
2022,3,Hail Region,"Financial Service Activities, Except Insurance and Pension Funding",micro,20,10,6,4,50,50,0
2022,3,Aseer Region,"Financial Service Activities, Except Insurance and Pension Funding",small,7,57,29,28,37,37,0
2022,3,Aseer Region,"Financial Service Activities, Except Insurance and Pension Funding",micro,23,9,5,4,34,34,0
2022,3,Makkah Region,"Financial Service Activities, Except Insurance and Pension Funding",small,131,784,460,324,1070,1028,42
2022,3,Makkah Region,"Financial Service Activities, Except Insurance and Pension Funding",large,3,3161,2656,505,282,281,1
2022,3,Makkah Region,"Financial Service Activities, Except Insurance and Pension Funding",micro,333,199,120,79,585,570,15
2022,3,Makkah Region,"Financial Service Activities, Except Insurance and Pension Funding",medium,19,985,694,291,640,630,10
2022,3,Najran Region,"Financial Service Activities, Except Insurance and Pension Funding",small,1,1,1,0,5,5,0
2022,3,Najran Region,"Financial Service Activities, Except Insurance and Pension Funding",micro,12,2,0,2,24,24,0
2022,3,Eastern Province,Other Personal Service Activities,small,681,1400,349,1051,5169,3441,1728
2022,3,Eastern Province,Other Personal Service Activities,large,4,252,116,136,2111,2111,0
2022,3,Eastern Province,Other Personal Service Activities,micro,6425,1447,524,923,13633,12390,1243
2022,3,Eastern Province,Other Personal Service Activities,medium,9,191,80,111,770,767,3
2022,3,Al Bahah Region,Other Personal Service Activities,small,9,7,6,1,51,51,0
2022,3,Al Bahah Region,Other Personal Service Activities,micro,473,70,44,26,914,870,44
2022,3,Al Jawf Region,Other Personal Service Activities,small,34,47,21,26,292,262,30
2022,3,Al Jawf Region,Other Personal Service Activities,micro,804,107,60,47,1603,1489,114
2022,3,Northern Borders Region,Other Personal Service Activities,small,24,31,8,23,169,112,57
2022,3,Northern Borders Region,Other Personal Service Activities,micro,589,66,35,31,1317,1236,81
2022,3,Riyadh Region,Other Personal Service Activities,small,1337,3104,680,2424,11204,7488,3716
2022,3,Riyadh Region,Other Personal Service Activities,large,3,1081,538,543,1464,1009,455
2022,3,Riyadh Region,Other Personal Service Activities,micro,10035,2320,828,1492,21062,18762,2300
2022,3,Riyadh Region,Other Personal Service Activities,medium,31,705,136,569,2033,1430,603
2022,3,Qassim Region,Other Personal Service Activities,small,112,209,49,160,982,608,374
2022,3,Qassim Region,Other Personal Service Activities,micro,2188,303,145,158,4655,4333,322
2022,3,Qassim Region,Other Personal Service Activities,medium,4,71,34,37,227,180,47
2022,3,Al Madinah Region,Other Personal Service Activities,small,139,321,85,236,1085,678,407
2022,3,Al Madinah Region,Other Personal Service Activities,micro,2825,356,159,197,5596,5219,377
2022,3,Al Madinah Region,Other Personal Service Activities,medium,1,39,4,35,64,3,61
2022,3,Tabuk Region,Other Personal Service Activities,small,48,69,17,52,395,326,69
2022,3,Tabuk Region,Other Personal Service Activities,micro,1437,177,75,102,2883,2737,146
2022,3,Tabuk Region,Other Personal Service Activities,medium,1,12,5,7,48,48,0
2022,3,Jazan Region,Other Personal Service Activities,small,39,106,11,95,290,158,132
2022,3,Jazan Region,Other Personal Service Activities,micro,2015,209,110,99,4224,4041,183
2022,3,Hail Region,Other Personal Service Activities,small,58,128,35,93,487,343,144
2022,3,Hail Region,Other Personal Service Activities,micro,1156,165,69,96,2464,2270,194
2022,3,Hail Region,Other Personal Service Activities,medium,1,43,3,40,58,8,50
2022,3,Aseer Region,Other Personal Service Activities,small,114,183,79,104,826,686,140
2022,3,Aseer Region,Other Personal Service Activities,micro,2780,428,212,216,5542,5228,314
2022,3,Makkah Region,Other Personal Service Activities,small,709,1755,430,1325,6051,3707,2344
2022,3,Makkah Region,Other Personal Service Activities,micro,9013,1759,751,1008,18560,16826,1734
2022,3,Makkah Region,Other Personal Service Activities,medium,15,359,35,324,910,253,657
2022,3,Najran Region,Other Personal Service Activities,small,32,46,13,33,207,167,40
2022,3,Najran Region,Other Personal Service Activities,micro,865,119,44,75,1796,1667,129
2022,3,Eastern Province,Specialized Construction Activities,small,1950,4917,2652,2265,23813,23744,69
2022,3,Eastern Province,Specialized Construction Activities,large,92,15575,12762,2813,62277,62142,135
2022,3,Eastern Province,Specialized Construction Activities,micro,6569,1853,893,960,15492,15460,32
2022,3,Eastern Province,Specialized Construction Activities,medium,245,4721,2995,1726,21223,21173,50
2022,3,Al Bahah Region,Specialized Construction Activities,small,53,84,59,25,461,461,0
2022,3,Al Bahah Region,Specialized Construction Activities,micro,483,86,56,30,1055,1055,0
2022,3,Al Bahah Region,Specialized Construction Activities,medium,4,77,46,31,338,338,0
2022,3,Al Jawf Region,Specialized Construction Activities,small,71,126,96,30,741,733,8
2022,3,Al Jawf Region,Specialized Construction Activities,micro,680,103,67,36,1538,1536,2
2022,3,Al Jawf Region,Specialized Construction Activities,medium,4,45,25,20,256,255,1
2022,3,Northern Borders Region,Specialized Construction Activities,small,42,71,46,25,323,323,0
2022,3,Northern Borders Region,Specialized Construction Activities,micro,454,74,40,34,1157,1156,1
2022,3,Northern Borders Region,Specialized Construction Activities,medium,2,39,38,1,260,260,0
2022,3,Riyadh Region,Specialized Construction Activities,small,3096,8541,3866,4675,39945,39659,286
2022,3,Riyadh Region,Specialized Construction Activities,large,160,29237,21713,7524,105763,104304,1459
2022,3,Riyadh Region,Specialized Construction Activities,micro,11725,3017,1369,1648,26883,26660,223
2022,3,Riyadh Region,Specialized Construction Activities,medium,503,8905,4973,3932,42137,41900,237
2022,3,Qassim Region,Specialized Construction Activities,small,395,701,398,303,4766,4758,8
2022,3,Qassim Region,Specialized Construction Activities,large,13,806,524,282,6820,6575,245
2022,3,Qassim Region,Specialized Construction Activities,micro,2787,413,240,173,6637,6619,18
2022,3,Qassim Region,Specialized Construction Activities,medium,44,278,177,101,4260,4258,2
2022,3,Al Madinah Region,Specialized Construction Activities,small,366,786,460,326,3767,3757,10
2022,3,Al Madinah Region,Specialized Construction Activities,large,8,1310,806,504,5040,4901,139
2022,3,Al Madinah Region,Specialized Construction Activities,micro,2943,560,310,250,7146,7111,35
2022,3,Al Madinah Region,Specialized Construction Activities,medium,23,316,188,128,1538,1529,9
2022,3,Tabuk Region,Specialized Construction Activities,small,81,149,77,72,796,791,5
2022,3,Tabuk Region,Specialized Construction Activities,large,1,89,80,9,578,578,0
2022,3,Tabuk Region,Specialized Construction Activities,micro,1315,203,109,94,3165,3161,4
2022,3,Tabuk Region,Specialized Construction Activities,medium,3,31,12,19,161,161,0
2022,3,Jazan Region,Specialized Construction Activities,small,97,170,79,91,802,802,0
2022,3,Jazan Region,Specialized Construction Activities,micro,2107,288,174,114,5193,5172,21
2022,3,Jazan Region,Specialized Construction Activities,medium,1,37,31,6,149,149,0
2022,3,Hail Region,Specialized Construction Activities,small,108,155,72,83,1014,1013,1
2022,3,Hail Region,Specialized Construction Activities,large,2,196,143,53,782,777,5
2022,3,Hail Region,Specialized Construction Activities,micro,1143,162,90,72,2780,2771,9
2022,3,Hail Region,Specialized Construction Activities,medium,9,128,101,27,819,806,13
2022,3,Aseer Region,Specialized Construction Activities,small,331,644,378,266,3192,3182,10
2022,3,Aseer Region,Specialized Construction Activities,large,5,622,297,325,3040,3039,1
2022,3,Aseer Region,Specialized Construction Activities,micro,2878,497,274,223,6470,6460,10
2022,3,Aseer Region,Specialized Construction Activities,medium,13,227,187,40,939,939,0
2022,3,Makkah Region,Specialized Construction Activities,small,2024,4982,2525,2457,23000,22821,179
2022,3,Makkah Region,Specialized Construction Activities,large,50,5245,3764,1481,26205,26097,108
2022,3,Makkah Region,Specialized Construction Activities,micro,10752,2490,1204,1286,24345,24108,237
2022,3,Makkah Region,Specialized Construction Activities,medium,215,4174,2622,1552,17545,17471,74
2022,3,Najran Region,Specialized Construction Activities,small,118,164,92,72,1183,1183,0
2022,3,Najran Region,Specialized Construction Activities,large,4,168,126,42,1706,1706,0
2022,3,Najran Region,Specialized Construction Activities,micro,1095,136,64,72,2336,2327,9
2022,3,Najran Region,Specialized Construction Activities,medium,10,243,146,97,949,949,0
2022,3,Eastern Province,Postal and Courier Activities,small,15,83,34,49,175,175,0
2022,3,Eastern Province,Postal and Courier Activities,large,1,345,271,74,327,326,1
2022,3,Eastern Province,Postal and Courier Activities,micro,27,21,10,11,34,34,0
2022,3,Eastern Province,Postal and Courier Activities,medium,2,40,16,24,150,150,0
2022,3,Al Jawf Region,Postal and Courier Activities,micro,1,0,0,0,4,4,0
2022,3,Northern Borders Region,Postal and Courier Activities,micro,1,0,0,0,5,5,0
2022,3,Riyadh Region,Postal and Courier Activities,small,98,446,194,252,1048,1027,21
2022,3,Riyadh Region,Postal and Courier Activities,large,6,1099,609,490,6112,6086,26
2022,3,Riyadh Region,Postal and Courier Activities,micro,262,160,95,65,502,489,13
2022,3,Riyadh Region,Postal and Courier Activities,medium,14,389,223,166,938,920,18
2022,3,Qassim Region,Postal and Courier Activities,micro,10,4,1,3,22,22,0
2022,3,Al Madinah Region,Postal and Courier Activities,small,1,2,1,1,4,4,0
2022,3,Al Madinah Region,Postal and Courier Activities,micro,15,3,2,1,34,34,0
2022,3,Al Madinah Region,Postal and Courier Activities,medium,1,81,81,0,131,131,0
2022,3,Tabuk Region,Postal and Courier Activities,micro,9,2,1,1,20,20,0
2022,3,Jazan Region,Postal and Courier Activities,small,1,7,6,1,25,25,0
2022,3,Jazan Region,Postal and Courier Activities,micro,4,0,0,0,8,8,0
2022,3,Hail Region,Postal and Courier Activities,small,1,0,0,0,6,6,0
2022,3,Hail Region,Postal and Courier Activities,micro,3,0,0,0,7,7,0
2022,3,Aseer Region,Postal and Courier Activities,small,1,4,2,2,5,5,0
2022,3,Aseer Region,Postal and Courier Activities,micro,11,3,2,1,29,29,0
2022,3,Makkah Region,Postal and Courier Activities,small,19,92,45,47,194,192,2
2022,3,Makkah Region,Postal and Courier Activities,large,2,221,212,9,699,699,0
2022,3,Makkah Region,Postal and Courier Activities,micro,87,57,27,30,130,126,4
2022,3,Makkah Region,Postal and Courier Activities,medium,4,63,24,39,180,179,1
2022,3,Najran Region,Postal and Courier Activities,micro,3,0,0,0,5,5,0
2022,3,Eastern Province,Programming and Broadcasting Activities,small,3,11,6,5,17,17,0
2022,3,Eastern Province,Programming and Broadcasting Activities,micro,13,5,2,3,27,26,1
2022,3,Al Jawf Region,Programming and Broadcasting Activities,micro,1,0,0,0,1,1,0
2022,3,Riyadh Region,Programming and Broadcasting Activities,small,13,80,47,33,79,77,2
2022,3,Riyadh Region,Programming and Broadcasting Activities,micro,61,35,17,18,109,108,1
2022,3,Riyadh Region,Programming and Broadcasting Activities,medium,3,119,64,55,105,92,13
2022,3,Qassim Region,Programming and Broadcasting Activities,micro,3,1,0,1,3,3,0
2022,3,Al Madinah Region,Programming and Broadcasting Activities,micro,4,1,0,1,9,9,0
2022,3,Tabuk Region,Programming and Broadcasting Activities,micro,3,1,1,0,6,6,0
2022,3,Jazan Region,Programming and Broadcasting Activities,micro,1,1,0,1,3,3,0
2022,3,Hail Region,Programming and Broadcasting Activities,small,1,2,1,1,5,5,0
2022,3,Aseer Region,Programming and Broadcasting Activities,micro,7,0,0,0,12,12,0
2022,3,Makkah Region,Programming and Broadcasting Activities,small,12,75,46,29,104,102,2
2022,3,Makkah Region,Programming and Broadcasting Activities,micro,22,8,5,3,47,44,3
2022,3,Makkah Region,Programming and Broadcasting Activities,medium,1,53,28,25,69,69,0
2022,3,Najran Region,Programming and Broadcasting Activities,micro,2,2,1,1,5,5,0
2022,3,Eastern Province,"Computer Programming, Consultancy, and Related Activities",small,102,681,360,321,822,807,15
2022,3,Eastern Province,"Computer Programming, Consultancy, and Related Activities",large,2,531,472,59,286,286,0
2022,3,Eastern Province,"Computer Programming, Consultancy, and Related Activities",micro,284,222,102,120,402,396,6
2022,3,Eastern Province,"Computer Programming, Consultancy, and Related Activities",medium,12,540,287,253,435,426,9
2022,3,Al Bahah Region,"Computer Programming, Consultancy, and Related Activities",micro,3,2,1,1,6,6,0
2022,3,Al Jawf Region,"Computer Programming, Consultancy, and Related Activities",micro,13,8,4,4,24,24,0
2022,3,Northern Borders Region,"Computer Programming, Consultancy, and Related Activities",micro,7,1,1,0,13,13,0
2022,3,Riyadh Region,"Computer Programming, Consultancy, and Related Activities",small,615,4342,2143,2199,5560,5332,228
2022,3,Riyadh Region,"Computer Programming, Consultancy, and Related Activities",large,25,13824,8613,5211,6212,5923,289
2022,3,Riyadh Region,"Computer Programming, Consultancy, and Related Activities",micro,1391,1085,533,552,1996,1926,70
2022,3,Riyadh Region,"Computer Programming, Consultancy, and Related Activities",medium,90,4854,2862,1992,4125,4005,120
2022,3,Qassim Region,"Computer Programming, Consultancy, and Related Activities",small,16,76,47,29,127,127,0
2022,3,Qassim Region,"Computer Programming, Consultancy, and Related Activities",micro,74,28,14,14,125,125,0
2022,3,Al Madinah Region,"Computer Programming, Consultancy, and Related Activities",small,10,40,20,20,56,56,0
2022,3,Al Madinah Region,"Computer Programming, Consultancy, and Related Activities",micro,82,42,14,28,125,120,5
2022,3,Al Madinah Region,"Computer Programming, Consultancy, and Related Activities",medium,1,38,36,2,17,17,0
2022,3,Tabuk Region,"Computer Programming, Consultancy, and Related Activities",micro,21,6,1,5,44,43,1
2022,3,Jazan Region,"Computer Programming, Consultancy, and Related Activities",small,2,10,7,3,7,7,0
2022,3,Jazan Region,"Computer Programming, Consultancy, and Related Activities",micro,29,8,4,4,57,57,0
2022,3,Hail Region,"Computer Programming, Consultancy, and Related Activities",small,2,4,1,3,20,20,0
2022,3,Hail Region,"Computer Programming, Consultancy, and Related Activities",micro,13,6,2,4,27,27,0
2022,3,Aseer Region,"Computer Programming, Consultancy, and Related Activities",small,9,35,19,16,70,69,1
2022,3,Aseer Region,"Computer Programming, Consultancy, and Related Activities",micro,57,24,16,8,109,108,1
2022,3,Makkah Region,"Computer Programming, Consultancy, and Related Activities",small,142,649,305,344,1170,1116,54
2022,3,Makkah Region,"Computer Programming, Consultancy, and Related Activities",large,1,860,841,19,50,47,3
2022,3,Makkah Region,"Computer Programming, Consultancy, and Related Activities",micro,580,358,167,191,892,854,38
2022,3,Makkah Region,"Computer Programming, Consultancy, and Related Activities",medium,12,499,272,227,552,533,19
2022,3,Najran Region,"Computer Programming, Consultancy, and Related Activities",micro,11,2,2,0,26,26,0
2022,3,Eastern Province,Public Order and Safety Activities,small,28,474,416,58,90,86,4
2022,3,Eastern Province,Public Order and Safety Activities,large,7,3884,3549,335,0,0,0
2022,3,Eastern Province,Public Order and Safety Activities,micro,50,68,58,10,48,48,0
2022,3,Eastern Province,Public Order and Safety Activities,medium,15,1439,1364,75,8,8,0
2022,3,Al Jawf Region,Public Order and Safety Activities,small,2,54,39,15,0,0,0
2022,3,Al Jawf Region,Public Order and Safety Activities,micro,5,11,10,1,1,1,0
2022,3,Northern Borders Region,Public Order and Safety Activities,small,1,13,9,4,0,0,0
2022,3,Northern Borders Region,Public Order and Safety Activities,large,1,0,0,0,333,333,0
2022,3,Northern Borders Region,Public Order and Safety Activities,micro,3,4,4,0,2,1,1
2022,3,Riyadh Region,Public Order and Safety Activities,small,52,673,575,98,177,176,1
2022,3,Riyadh Region,Public Order and Safety Activities,large,18,17374,15667,1707,221,219,2
2022,3,Riyadh Region,Public Order and Safety Activities,micro,114,138,97,41,127,126,1
2022,3,Riyadh Region,Public Order and Safety Activities,medium,18,2366,2132,234,106,103,3
2022,3,Qassim Region,Public Order and Safety Activities,small,3,88,82,6,1,1,0
2022,3,Qassim Region,Public Order and Safety Activities,micro,11,6,6,0,16,16,0
2022,3,Qassim Region,Public Order and Safety Activities,medium,1,95,78,17,34,8,26
2022,3,Al Madinah Region,Public Order and Safety Activities,small,3,35,32,3,7,7,0
2022,3,Al Madinah Region,Public Order and Safety Activities,micro,15,14,13,1,15,15,0
2022,3,Al Madinah Region,Public Order and Safety Activities,medium,1,123,122,1,0,0,0
2022,3,Tabuk Region,Public Order and Safety Activities,micro,8,6,6,0,7,7,0
2022,3,Jazan Region,Public Order and Safety Activities,small,3,35,33,2,13,13,0
2022,3,Jazan Region,Public Order and Safety Activities,micro,8,4,4,0,12,12,0
2022,3,Jazan Region,Public Order and Safety Activities,medium,1,166,166,0,0,0,0
2022,3,Hail Region,Public Order and Safety Activities,small,2,11,10,1,4,4,0
2022,3,Hail Region,Public Order and Safety Activities,micro,3,2,1,1,7,7,0
2022,3,Hail Region,Public Order and Safety Activities,medium,1,74,71,3,0,0,0
2022,3,Aseer Region,Public Order and Safety Activities,small,5,97,94,3,5,5,0
2022,3,Aseer Region,Public Order and Safety Activities,large,2,1313,1285,28,0,0,0
2022,3,Aseer Region,Public Order and Safety Activities,micro,5,8,6,2,2,2,0
2022,3,Makkah Region,Public Order and Safety Activities,small,32,500,426,74,71,69,2
2022,3,Makkah Region,Public Order and Safety Activities,large,5,2252,2110,142,0,0,0
2022,3,Makkah Region,Public Order and Safety Activities,micro,72,87,67,20,75,72,3
2022,3,Makkah Region,Public Order and Safety Activities,medium,8,1078,934,144,1,1,0
2022,3,Najran Region,Public Order and Safety Activities,large,1,303,274,29,0,0,0
2022,3,Najran Region,Public Order and Safety Activities,micro,1,0,0,0,2,2,0
2022,3,Eastern Province,Activities of Households as Employers of Domestic Personnel,small,1,1,0,1,5,5,0
2022,3,Eastern Province,Activities of Households as Employers of Domestic Personnel,micro,9,1,1,0,12,11,1
2022,3,Al Bahah Region,Activities of Households as Employers of Domestic Personnel,micro,1,0,0,0,1,1,0
2022,3,Riyadh Region,Activities of Households as Employers of Domestic Personnel,micro,11,2,2,0,13,12,1
2022,3,Qassim Region,Activities of Households as Employers of Domestic Personnel,small,1,0,0,0,7,7,0
2022,3,Qassim Region,Activities of Households as Employers of Domestic Personnel,micro,4,1,1,0,8,8,0
2022,3,Al Madinah Region,Activities of Households as Employers of Domestic Personnel,micro,1,0,0,0,2,2,0
2022,3,Jazan Region,Activities of Households as Employers of Domestic Personnel,micro,1,1,0,1,1,0,1
2022,3,Hail Region,Activities of Households as Employers of Domestic Personnel,micro,6,0,0,0,9,9,0
2022,3,Aseer Region,Activities of Households as Employers of Domestic Personnel,small,1,0,0,0,7,7,0
2022,3,Makkah Region,Activities of Households as Employers of Domestic Personnel,micro,1,0,0,0,1,1,0
2022,3,Najran Region,Activities of Households as Employers of Domestic Personnel,micro,1,0,0,0,1,1,0
2022,3,Eastern Province,Extraction of Natural Gas,small,48,250,131,119,308,265,43
2022,3,Eastern Province,Extraction of Natural Gas,large,21,85,61,24,47235,35963,11272
2022,3,Eastern Province,Extraction of Natural Gas,micro,302,330,179,151,382,347,35
2022,3,Eastern Province,Extraction of Natural Gas,medium,8,480,351,129,583,498,85
2022,3,Al Bahah Region,Extraction of Natural Gas,small,1,3,2,1,3,3,0
2022,3,Al Bahah Region,Extraction of Natural Gas,micro,13,7,3,4,11,11,0
2022,3,Al Jawf Region,Extraction of Natural Gas,small,1,6,6,0,4,4,0
2022,3,Al Jawf Region,Extraction of Natural Gas,micro,29,36,11,25,32,32,0
2022,3,Northern Borders Region,Extraction of Natural Gas,small,4,10,3,7,39,10,29
2022,3,Northern Borders Region,Extraction of Natural Gas,micro,17,12,5,7,24,24,0
2022,3,Riyadh Region,Extraction of Natural Gas,small,169,1166,423,743,888,821,67
2022,3,Riyadh Region,Extraction of Natural Gas,large,51,11522,3209,8313,190499,109505,80994
2022,3,Riyadh Region,Extraction of Natural Gas,micro,769,698,363,335,1091,1054,37
2022,3,Riyadh Region,Extraction of Natural Gas,medium,19,1329,735,594,905,693,212
2022,3,Qassim Region,Extraction of Natural Gas,small,20,107,43,64,187,167,20
2022,3,Qassim Region,Extraction of Natural Gas,micro,86,74,43,31,117,112,5
2022,3,Qassim Region,Extraction of Natural Gas,medium,1,9,9,0,44,44,0
2022,3,Al Madinah Region,Extraction of Natural Gas,small,7,45,23,22,21,20,1
2022,3,Al Madinah Region,Extraction of Natural Gas,micro,101,90,63,27,148,140,8
2022,3,Tabuk Region,Extraction of Natural Gas,small,3,10,5,5,12,12,0
2022,3,Tabuk Region,Extraction of Natural Gas,micro,53,34,17,17,80,76,4
2022,3,Jazan Region,Extraction of Natural Gas,small,1,0,0,0,28,28,0
2022,3,Jazan Region,Extraction of Natural Gas,micro,36,15,11,4,60,60,0
2022,3,Hail Region,Extraction of Natural Gas,small,8,42,18,24,67,29,38
2022,3,Hail Region,Extraction of Natural Gas,micro,50,39,24,15,69,66,3
2022,3,Aseer Region,Extraction of Natural Gas,small,10,18,7,11,58,19,39
2022,3,Aseer Region,Extraction of Natural Gas,large,2,0,0,0,15096,10437,4659
2022,3,Aseer Region,Extraction of Natural Gas,micro,116,88,58,30,170,164,6
2022,3,Aseer Region,Extraction of Natural Gas,medium,1,129,48,81,33,29,4
2022,3,Makkah Region,Extraction of Natural Gas,small,39,222,102,120,239,226,13
2022,3,Makkah Region,Extraction of Natural Gas,large,7,16,6,10,15518,12470,3048
2022,3,Makkah Region,Extraction of Natural Gas,micro,379,296,183,113,548,531,17
2022,3,Makkah Region,Extraction of Natural Gas,medium,4,142,21,121,397,211,186
2022,3,Najran Region,Extraction of Natural Gas,small,8,11,7,4,62,54,8
2022,3,Najran Region,Extraction of Natural Gas,micro,54,35,15,20,78,61,17
2022,3,Eastern Province,Civil Engineering,small,419,1477,817,660,6085,6069,16
2022,3,Eastern Province,Civil Engineering,large,97,25621,21225,4396,104828,104732,96
2022,3,Eastern Province,Civil Engineering,micro,530,310,168,142,1063,1057,6
2022,3,Eastern Province,Civil Engineering,medium,164,3798,2789,1009,15210,15195,15
2022,3,Al Bahah Region,Civil Engineering,small,7,15,14,1,63,63,0
2022,3,Al Bahah Region,Civil Engineering,large,1,51,45,6,267,267,0
2022,3,Al Bahah Region,Civil Engineering,micro,25,5,2,3,54,53,1
2022,3,Al Bahah Region,Civil Engineering,medium,2,51,43,8,97,97,0
2022,3,Al Jawf Region,Civil Engineering,small,19,57,38,19,234,233,1
2022,3,Al Jawf Region,Civil Engineering,large,1,121,80,41,296,272,24
2022,3,Al Jawf Region,Civil Engineering,micro,44,13,11,2,98,98,0
2022,3,Al Jawf Region,Civil Engineering,medium,5,134,99,35,405,405,0
2022,3,Northern Borders Region,Civil Engineering,small,7,29,20,9,129,129,0
2022,3,Northern Borders Region,Civil Engineering,micro,37,8,5,3,85,85,0
2022,3,Northern Borders Region,Civil Engineering,medium,1,41,22,19,141,141,0
2022,3,Riyadh Region,Civil Engineering,small,668,2240,1104,1136,9264,9212,52
2022,3,Riyadh Region,Civil Engineering,large,131,26252,18637,7615,128177,127811,366
2022,3,Riyadh Region,Civil Engineering,micro,1215,509,227,282,2615,2591,24
2022,3,Riyadh Region,Civil Engineering,medium,223,4522,2770,1752,20858,20798,60
2022,3,Qassim Region,Civil Engineering,small,70,227,135,92,1008,1006,2
2022,3,Qassim Region,Civil Engineering,large,9,1388,940,448,8049,8047,2
2022,3,Qassim Region,Civil Engineering,micro,150,56,42,14,360,358,2
2022,3,Qassim Region,Civil Engineering,medium,26,542,410,132,2299,2295,4
2022,3,Al Madinah Region,Civil Engineering,small,72,244,148,96,1023,1021,2
2022,3,Al Madinah Region,Civil Engineering,large,9,893,663,230,3594,3586,8
2022,3,Al Madinah Region,Civil Engineering,micro,177,59,38,21,403,401,2
2022,3,Al Madinah Region,Civil Engineering,medium,21,461,331,130,1612,1611,1
2022,3,Tabuk Region,Civil Engineering,small,20,86,40,46,234,234,0
2022,3,Tabuk Region,Civil Engineering,large,1,66,45,21,284,284,0
2022,3,Tabuk Region,Civil Engineering,micro,61,17,8,9,136,135,1
2022,3,Tabuk Region,Civil Engineering,medium,4,88,65,23,319,319,0
2022,3,Jazan Region,Civil Engineering,small,24,68,35,33,333,328,5
2022,3,Jazan Region,Civil Engineering,large,1,69,53,16,425,425,0
2022,3,Jazan Region,Civil Engineering,micro,99,22,12,10,237,237,0
2022,3,Jazan Region,Civil Engineering,medium,6,184,120,64,695,695,0
2022,3,Hail Region,Civil Engineering,small,28,81,39,42,329,329,0
2022,3,Hail Region,Civil Engineering,large,1,113,88,25,652,652,0
2022,3,Hail Region,Civil Engineering,micro,61,12,6,6,140,139,1
2022,3,Hail Region,Civil Engineering,medium,6,132,106,26,509,506,3
2022,3,Aseer Region,Civil Engineering,small,55,212,143,69,693,692,1
2022,3,Aseer Region,Civil Engineering,large,9,780,666,114,3661,3661,0
2022,3,Aseer Region,Civil Engineering,micro,139,46,28,18,339,338,1
2022,3,Aseer Region,Civil Engineering,medium,22,468,345,123,1906,1906,0
2022,3,Makkah Region,Civil Engineering,small,356,1196,662,534,4878,4849,29
2022,3,Makkah Region,Civil Engineering,large,37,7192,5300,1892,34770,34721,49
2022,3,Makkah Region,Civil Engineering,micro,634,242,128,114,1414,1394,20
2022,3,Makkah Region,Civil Engineering,medium,98,1999,1337,662,8749,8719,30
2022,3,Najran Region,Civil Engineering,small,22,105,60,45,342,342,0
2022,3,Najran Region,Civil Engineering,large,6,726,535,191,3086,3086,0
2022,3,Najran Region,Civil Engineering,micro,64,24,13,11,149,148,1
2022,3,Najran Region,Civil Engineering,medium,7,138,84,54,608,606,2
2022,3,Eastern Province,Water Transport,small,25,175,128,47,190,186,4
2022,3,Eastern Province,Water Transport,micro,46,30,28,2,74,74,0
2022,3,Eastern Province,Water Transport,medium,13,756,610,146,314,307,7
2022,3,Al Bahah Region,Water Transport,micro,1,0,0,0,2,2,0
2022,3,Northern Borders Region,Water Transport,micro,1,0,0,0,1,1,0
2022,3,Riyadh Region,Water Transport,small,18,121,63,58,165,165,0
2022,3,Riyadh Region,Water Transport,micro,114,32,17,15,283,277,6
2022,3,Riyadh Region,Water Transport,medium,3,150,115,35,80,79,1
2022,3,Qassim Region,Water Transport,small,1,0,0,0,8,8,0
2022,3,Qassim Region,Water Transport,micro,4,0,0,0,10,10,0
2022,3,Al Madinah Region,Water Transport,small,5,41,33,8,48,48,0
2022,3,Al Madinah Region,Water Transport,micro,22,13,8,5,35,35,0
2022,3,Al Madinah Region,Water Transport,medium,2,52,44,8,65,64,1
2022,3,Tabuk Region,Water Transport,small,3,33,23,10,39,27,12
2022,3,Tabuk Region,Water Transport,micro,12,8,3,5,18,18,0
2022,3,Jazan Region,Water Transport,small,4,58,38,20,30,30,0
2022,3,Jazan Region,Water Transport,micro,9,4,3,1,18,18,0
2022,3,Hail Region,Water Transport,micro,1,0,0,0,1,1,0
2022,3,Aseer Region,Water Transport,micro,14,2,2,0,32,32,0
2022,3,Makkah Region,Water Transport,small,36,210,143,67,289,283,6
2022,3,Makkah Region,Water Transport,micro,129,54,32,22,213,211,2
2022,3,Makkah Region,Water Transport,medium,5,208,133,75,250,249,1
2022,3,Najran Region,Water Transport,small,1,0,0,0,6,6,0
2022,3,Najran Region,Water Transport,micro,6,0,0,0,14,14,0
2022,3,Eastern Province,Air Transport,small,13,92,66,26,116,115,1
2022,3,Eastern Province,Air Transport,micro,67,33,22,11,127,127,0
2022,3,Al Bahah Region,Air Transport,micro,1,1,1,0,0,0,0
2022,3,Al Jawf Region,Air Transport,small,1,0,0,0,23,23,0
2022,3,Al Jawf Region,Air Transport,micro,7,1,1,0,17,17,0
2022,3,Northern Borders Region,Air Transport,small,2,11,10,1,25,25,0
2022,3,Riyadh Region,Air Transport,small,24,94,58,36,275,275,0
2022,3,Riyadh Region,Air Transport,large,4,2269,2067,202,1641,1091,550
2022,3,Riyadh Region,Air Transport,micro,232,57,26,31,581,576,5
2022,3,Riyadh Region,Air Transport,medium,6,214,160,54,213,211,2
2022,3,Qassim Region,Air Transport,micro,9,3,1,2,24,24,0
2022,3,Al Madinah Region,Air Transport,small,3,7,3,4,12,12,0
2022,3,Al Madinah Region,Air Transport,micro,9,2,2,0,14,14,0
2022,3,Tabuk Region,Air Transport,small,2,14,11,3,31,31,0
2022,3,Tabuk Region,Air Transport,micro,7,2,1,1,12,12,0
2022,3,Jazan Region,Air Transport,micro,11,3,3,0,26,26,0
2022,3,Hail Region,Air Transport,small,1,8,8,0,15,15,0
2022,3,Hail Region,Air Transport,micro,16,4,3,1,49,49,0
2022,3,Aseer Region,Air Transport,small,1,0,0,0,7,7,0
2022,3,Aseer Region,Air Transport,micro,15,6,4,2,29,29,0
2022,3,Makkah Region,Air Transport,small,26,140,97,43,247,243,4
2022,3,Makkah Region,Air Transport,large,2,5727,5132,595,249,131,118
2022,3,Makkah Region,Air Transport,micro,88,57,36,21,165,164,1
2022,3,Makkah Region,Air Transport,medium,3,115,94,21,96,96,0
2022,3,Najran Region,Air Transport,small,1,1,1,0,5,5,0
2022,3,Najran Region,Air Transport,micro,1,0,0,0,3,3,0
2022,3,Eastern Province,Land Transport and Transport Via Pipelines,small,804,2805,1613,1192,12043,12036,7
2022,3,Eastern Province,Land Transport and Transport Via Pipelines,large,49,8685,7173,1512,21975,21967,8
2022,3,Eastern Province,Land Transport and Transport Via Pipelines,micro,1988,559,282,277,3933,3921,12
2022,3,Eastern Province,Land Transport and Transport Via Pipelines,medium,199,4536,3026,1510,15062,15042,20
2022,3,Al Bahah Region,Land Transport and Transport Via Pipelines,small,11,29,17,12,133,133,0
2022,3,Al Bahah Region,Land Transport and Transport Via Pipelines,micro,191,36,24,12,387,386,1
2022,3,Al Jawf Region,Land Transport and Transport Via Pipelines,small,89,212,131,81,1084,1084,0
2022,3,Al Jawf Region,Land Transport and Transport Via Pipelines,micro,581,60,37,23,1254,1251,3
2022,3,Al Jawf Region,Land Transport and Transport Via Pipelines,medium,6,91,48,43,378,378,0
2022,3,Northern Borders Region,Land Transport and Transport Via Pipelines,small,61,122,59,63,690,690,0
2022,3,Northern Borders Region,Land Transport and Transport Via Pipelines,micro,324,42,27,15,636,636,0
2022,3,Northern Borders Region,Land Transport and Transport Via Pipelines,medium,1,45,33,12,149,149,0
2022,3,Riyadh Region,Land Transport and Transport Via Pipelines,small,1261,3596,1556,2040,15599,15546,53
2022,3,Riyadh Region,Land Transport and Transport Via Pipelines,large,55,17241,14638,2603,30628,30600,28
2022,3,Riyadh Region,Land Transport and Transport Via Pipelines,micro,13345,1780,834,946,35774,35602,172
2022,3,Riyadh Region,Land Transport and Transport Via Pipelines,medium,223,5126,2725,2401,18265,18248,17
2022,3,Qassim Region,Land Transport and Transport Via Pipelines,small,260,665,374,291,3149,3149,0
2022,3,Qassim Region,Land Transport and Transport Via Pipelines,large,6,578,503,75,2045,2045,0
2022,3,Qassim Region,Land Transport and Transport Via Pipelines,micro,1138,203,112,91,2544,2542,2
2022,3,Qassim Region,Land Transport and Transport Via Pipelines,medium,28,595,404,191,2239,2230,9
2022,3,Al Madinah Region,Land Transport and Transport Via Pipelines,small,156,478,277,201,1985,1984,1
2022,3,Al Madinah Region,Land Transport and Transport Via Pipelines,large,1,95,39,56,309,308,1
2022,3,Al Madinah Region,Land Transport and Transport Via Pipelines,micro,1026,161,82,79,2043,2041,2
2022,3,Al Madinah Region,Land Transport and Transport Via Pipelines,medium,20,366,260,106,1318,1318,0
2022,3,Tabuk Region,Land Transport and Transport Via Pipelines,small,70,185,96,89,695,695,0
2022,3,Tabuk Region,Land Transport and Transport Via Pipelines,micro,594,104,59,45,1167,1164,3
2022,3,Tabuk Region,Land Transport and Transport Via Pipelines,medium,6,149,128,21,358,358,0
2022,3,Jazan Region,Land Transport and Transport Via Pipelines,small,35,79,40,39,434,434,0
2022,3,Jazan Region,Land Transport and Transport Via Pipelines,large,1,788,605,183,302,290,12
2022,3,Jazan Region,Land Transport and Transport Via Pipelines,micro,583,82,50,32,1283,1277,6
2022,3,Jazan Region,Land Transport and Transport Via Pipelines,medium,5,151,88,63,363,363,0
2022,3,Hail Region,Land Transport and Transport Via Pipelines,small,64,112,52,60,613,613,0
2022,3,Hail Region,Land Transport and Transport Via Pipelines,micro,636,72,39,33,1561,1557,4
2022,3,Hail Region,Land Transport and Transport Via Pipelines,medium,4,41,23,18,169,169,0
2022,3,Aseer Region,Land Transport and Transport Via Pipelines,small,297,670,412,258,3104,3094,10
2022,3,Aseer Region,Land Transport and Transport Via Pipelines,large,2,133,104,29,428,428,0
2022,3,Aseer Region,Land Transport and Transport Via Pipelines,micro,1828,281,158,123,3589,3584,5
2022,3,Aseer Region,Land Transport and Transport Via Pipelines,medium,15,388,253,135,1178,1178,0
2022,3,Makkah Region,Land Transport and Transport Via Pipelines,small,952,2984,1520,1464,12190,12144,46
2022,3,Makkah Region,Land Transport and Transport Via Pipelines,large,23,3412,2548,864,11241,11193,48
2022,3,Makkah Region,Land Transport and Transport Via Pipelines,micro,3726,804,421,383,7776,7689,87
2022,3,Makkah Region,Land Transport and Transport Via Pipelines,medium,138,2841,1716,1125,9872,9824,48
2022,3,Najran Region,Land Transport and Transport Via Pipelines,small,97,217,113,104,1158,1155,3
2022,3,Najran Region,Land Transport and Transport Via Pipelines,micro,1009,135,73,62,2467,2460,7
2022,3,Najran Region,Land Transport and Transport Via Pipelines,medium,4,71,53,18,267,267,0
2022,3,Eastern Province,Printing and Reproduction of Recorded Media,small,53,243,111,132,515,514,1
2022,3,Eastern Province,Printing and Reproduction of Recorded Media,large,1,518,363,155,339,333,6
2022,3,Eastern Province,Printing and Reproduction of Recorded Media,micro,87,62,21,41,140,139,1
2022,3,Eastern Province,Printing and Reproduction of Recorded Media,medium,4,116,67,49,232,232,0
2022,3,Al Bahah Region,Printing and Reproduction of Recorded Media,small,3,9,2,7,14,14,0
2022,3,Al Bahah Region,Printing and Reproduction of Recorded Media,micro,6,7,3,4,18,18,0
2022,3,Al Jawf Region,Printing and Reproduction of Recorded Media,micro,9,4,3,1,21,21,0
2022,3,Northern Borders Region,Printing and Reproduction of Recorded Media,small,3,8,2,6,15,15,0
2022,3,Northern Borders Region,Printing and Reproduction of Recorded Media,micro,5,0,0,0,8,8,0
2022,3,Riyadh Region,Printing and Reproduction of Recorded Media,small,161,915,363,552,1748,1738,10
2022,3,Riyadh Region,Printing and Reproduction of Recorded Media,micro,263,153,66,87,465,460,5
2022,3,Riyadh Region,Printing and Reproduction of Recorded Media,medium,13,420,223,197,816,811,5
2022,3,Qassim Region,Printing and Reproduction of Recorded Media,small,11,81,36,45,135,135,0
2022,3,Qassim Region,Printing and Reproduction of Recorded Media,micro,27,14,9,5,47,47,0
2022,3,Qassim Region,Printing and Reproduction of Recorded Media,medium,1,25,9,16,48,48,0
2022,3,Al Madinah Region,Printing and Reproduction of Recorded Media,small,13,32,12,20,93,93,0
2022,3,Al Madinah Region,Printing and Reproduction of Recorded Media,micro,43,15,11,4,89,88,1
2022,3,Tabuk Region,Printing and Reproduction of Recorded Media,small,4,18,10,8,45,45,0
2022,3,Tabuk Region,Printing and Reproduction of Recorded Media,micro,19,9,3,6,34,33,1
2022,3,Jazan Region,Printing and Reproduction of Recorded Media,small,2,7,3,4,13,13,0
2022,3,Jazan Region,Printing and Reproduction of Recorded Media,micro,14,4,2,2,34,34,0
2022,3,Hail Region,Printing and Reproduction of Recorded Media,small,4,7,6,1,26,26,0
2022,3,Hail Region,Printing and Reproduction of Recorded Media,micro,21,10,5,5,37,37,0
2022,3,Aseer Region,Printing and Reproduction of Recorded Media,small,10,46,20,26,89,88,1
2022,3,Aseer Region,Printing and Reproduction of Recorded Media,micro,28,13,8,5,56,55,1
2022,3,Makkah Region,Printing and Reproduction of Recorded Media,small,79,433,185,248,872,864,8
2022,3,Makkah Region,Printing and Reproduction of Recorded Media,micro,214,76,40,36,416,407,9
2022,3,Makkah Region,Printing and Reproduction of Recorded Media,medium,7,197,78,119,335,330,5
2022,3,Najran Region,Printing and Reproduction of Recorded Media,small,1,5,2,3,15,15,0
2022,3,Najran Region,Printing and Reproduction of Recorded Media,micro,9,3,1,2,22,22,0
2022,3,Eastern Province,Other Manufacturing,small,83,415,303,112,1166,1161,5
2022,3,Eastern Province,Other Manufacturing,large,5,921,873,48,1305,1301,4
2022,3,Eastern Province,Other Manufacturing,micro,104,70,53,17,194,190,4
2022,3,Eastern Province,Other Manufacturing,medium,23,553,356,197,1397,1394,3
2022,3,Al Bahah Region,Other Manufacturing,micro,8,4,3,1,17,16,1
2022,3,Al Jawf Region,Other Manufacturing,small,1,0,0,0,8,8,0
2022,3,Al Jawf Region,Other Manufacturing,micro,7,5,2,3,9,9,0
2022,3,Northern Borders Region,Other Manufacturing,micro,4,1,1,0,8,8,0
2022,3,Riyadh Region,Other Manufacturing,small,176,735,321,414,2796,2645,151
2022,3,Riyadh Region,Other Manufacturing,large,5,611,230,381,2088,2066,22
2022,3,Riyadh Region,Other Manufacturing,micro,198,97,52,45,448,436,12
2022,3,Riyadh Region,Other Manufacturing,medium,56,1288,767,521,4331,4272,59
2022,3,Qassim Region,Other Manufacturing,small,8,35,27,8,120,120,0
2022,3,Qassim Region,Other Manufacturing,micro,20,17,14,3,33,33,0
2022,3,Qassim Region,Other Manufacturing,medium,4,102,29,73,347,347,0
2022,3,Al Madinah Region,Other Manufacturing,small,7,30,21,9,99,98,1
2022,3,Al Madinah Region,Other Manufacturing,micro,35,15,11,4,60,59,1
2022,3,Tabuk Region,Other Manufacturing,small,2,5,4,1,15,15,0
2022,3,Tabuk Region,Other Manufacturing,micro,11,4,3,1,23,21,2
2022,3,Jazan Region,Other Manufacturing,small,2,3,3,0,17,17,0
2022,3,Jazan Region,Other Manufacturing,micro,18,3,3,0,43,42,1
2022,3,Hail Region,Other Manufacturing,small,2,4,4,0,8,8,0
2022,3,Hail Region,Other Manufacturing,micro,15,5,3,2,33,32,1
2022,3,Aseer Region,Other Manufacturing,small,16,43,25,18,171,166,5
2022,3,Aseer Region,Other Manufacturing,micro,31,17,9,8,67,64,3
2022,3,Makkah Region,Other Manufacturing,small,113,474,217,257,1620,1597,23
2022,3,Makkah Region,Other Manufacturing,large,6,751,527,224,2445,2432,13
2022,3,Makkah Region,Other Manufacturing,micro,165,90,47,43,301,288,13
2022,3,Makkah Region,Other Manufacturing,medium,23,600,369,231,1826,1823,3
2022,3,Najran Region,Other Manufacturing,small,2,10,4,6,21,14,7
2022,3,Najran Region,Other Manufacturing,micro,5,5,4,1,10,10,0
2022,3,Najran Region,Other Manufacturing,medium,1,31,31,0,121,121,0
2022,3,Eastern Province,Sewerage,small,22,79,34,45,277,276,1
2022,3,Eastern Province,Sewerage,large,2,263,222,41,1658,1658,0
2022,3,Eastern Province,Sewerage,micro,30,13,6,7,68,67,1
2022,3,Eastern Province,Sewerage,medium,1,10,5,5,49,49,0
2022,3,Al Bahah Region,Sewerage,micro,4,0,0,0,14,14,0
2022,3,Al Jawf Region,Sewerage,micro,6,0,0,0,8,8,0
2022,3,Northern Borders Region,Sewerage,micro,3,1,1,0,9,9,0
2022,3,Riyadh Region,Sewerage,small,27,55,30,25,361,359,2
2022,3,Riyadh Region,Sewerage,large,2,773,503,270,6585,6570,15
2022,3,Riyadh Region,Sewerage,micro,113,16,7,9,251,250,1
2022,3,Riyadh Region,Sewerage,medium,4,77,65,12,386,386,0
2022,3,Qassim Region,Sewerage,small,4,11,6,5,47,46,1
2022,3,Qassim Region,Sewerage,micro,24,7,6,1,67,67,0
2022,3,Al Madinah Region,Sewerage,small,13,47,37,10,143,143,0
2022,3,Al Madinah Region,Sewerage,micro,11,1,1,0,23,23,0
2022,3,Tabuk Region,Sewerage,small,1,1,0,1,8,8,0
2022,3,Tabuk Region,Sewerage,micro,7,1,1,0,15,14,1
2022,3,Jazan Region,Sewerage,small,1,2,1,1,5,5,0
2022,3,Jazan Region,Sewerage,micro,23,5,4,1,53,53,0
2022,3,Hail Region,Sewerage,small,3,18,15,3,57,57,0
2022,3,Hail Region,Sewerage,micro,13,5,4,1,35,34,1
2022,3,Hail Region,Sewerage,medium,1,12,9,3,50,50,0
2022,3,Aseer Region,Sewerage,small,2,3,3,0,44,44,0
2022,3,Aseer Region,Sewerage,micro,10,2,1,1,21,21,0
2022,3,Aseer Region,Sewerage,medium,1,24,18,6,74,74,0
2022,3,Makkah Region,Sewerage,small,28,65,43,22,366,365,1
2022,3,Makkah Region,Sewerage,large,1,229,203,26,1192,1192,0
2022,3,Makkah Region,Sewerage,micro,68,22,12,10,150,148,2
2022,3,Makkah Region,Sewerage,medium,2,17,14,3,111,111,0
2022,3,Najran Region,Sewerage,micro,3,0,0,0,4,4,0
2022,3,Eastern Province,Human Health Activities,small,334,2474,549,1925,4339,2112,2227
2022,3,Eastern Province,Human Health Activities,large,31,9347,3365,5982,14523,6634,7889
2022,3,Eastern Province,Human Health Activities,micro,196,214,59,155,319,234,85
2022,3,Eastern Province,Human Health Activities,medium,109,4070,978,3092,7358,4079,3279
2022,3,Al Bahah Region,Human Health Activities,small,29,203,71,132,374,145,229
2022,3,Al Bahah Region,Human Health Activities,micro,22,26,8,18,46,33,13
2022,3,Al Bahah Region,Human Health Activities,medium,2,33,16,17,70,29,41
2022,3,Al Jawf Region,Human Health Activities,small,45,279,88,191,484,263,221
2022,3,Al Jawf Region,Human Health Activities,micro,21,12,4,8,31,20,11
2022,3,Al Jawf Region,Human Health Activities,medium,7,176,44,132,314,176,138
2022,3,Northern Borders Region,Human Health Activities,small,32,160,30,130,403,226,177
2022,3,Northern Borders Region,Human Health Activities,micro,19,22,8,14,35,24,11
2022,3,Northern Borders Region,Human Health Activities,medium,5,113,33,80,218,109,109
2022,3,Riyadh Region,Human Health Activities,small,908,6397,1807,4590,12408,5796,6612
2022,3,Riyadh Region,Human Health Activities,large,75,12149,4697,7452,51543,38988,12555
2022,3,Riyadh Region,Human Health Activities,micro,658,513,196,317,1080,738,342
2022,3,Riyadh Region,Human Health Activities,medium,280,8164,2425,5739,18166,10037,8129
2022,3,Qassim Region,Human Health Activities,small,112,829,267,562,1453,603,850
2022,3,Qassim Region,Human Health Activities,large,5,680,335,345,2411,1522,889
2022,3,Qassim Region,Human Health Activities,micro,66,45,28,17,120,90,30
2022,3,Qassim Region,Human Health Activities,medium,32,815,329,486,1936,1004,932
2022,3,Al Madinah Region,Human Health Activities,small,167,1188,361,827,2181,965,1216
2022,3,Al Madinah Region,Human Health Activities,large,10,1491,604,887,2868,1543,1325
2022,3,Al Madinah Region,Human Health Activities,micro,76,60,29,31,132,81,51
2022,3,Al Madinah Region,Human Health Activities,medium,29,646,212,434,1406,626,780
2022,3,Tabuk Region,Human Health Activities,small,63,386,98,288,712,362,350
2022,3,Tabuk Region,Human Health Activities,large,1,115,59,56,228,136,92
2022,3,Tabuk Region,Human Health Activities,micro,35,28,9,19,59,44,15
2022,3,Tabuk Region,Human Health Activities,medium,13,407,93,314,644,345,299
2022,3,Jazan Region,Human Health Activities,small,99,834,188,646,1187,568,619
2022,3,Jazan Region,Human Health Activities,large,2,343,147,196,755,259,496
2022,3,Jazan Region,Human Health Activities,micro,73,49,12,37,133,112,21
2022,3,Jazan Region,Human Health Activities,medium,18,580,157,423,969,488,481
2022,3,Hail Region,Human Health Activities,small,61,383,107,276,726,365,361
2022,3,Hail Region,Human Health Activities,large,2,302,106,196,584,246,338
2022,3,Hail Region,Human Health Activities,micro,50,31,12,19,97,83,14
2022,3,Hail Region,Human Health Activities,medium,15,556,177,379,1023,505,518
2022,3,Aseer Region,Human Health Activities,small,195,1454,396,1058,2416,1058,1358
2022,3,Aseer Region,Human Health Activities,large,6,1173,515,658,3280,2133,1147
2022,3,Aseer Region,Human Health Activities,micro,100,92,32,60,165,126,39
2022,3,Aseer Region,Human Health Activities,medium,40,1280,339,941,2414,1098,1316
2022,3,Makkah Region,Human Health Activities,small,723,5450,1400,4050,8879,4235,4644
2022,3,Makkah Region,Human Health Activities,large,29,6660,2579,4081,13054,6621,6433
2022,3,Makkah Region,Human Health Activities,micro,448,391,156,235,686,500,186
2022,3,Makkah Region,Human Health Activities,medium,176,6292,1808,4484,11518,5813,5705
2022,3,Najran Region,Human Health Activities,small,61,351,156,195,701,350,351
2022,3,Najran Region,Human Health Activities,large,2,95,76,19,534,453,81
2022,3,Najran Region,Human Health Activities,micro,35,31,19,12,65,45,20
2022,3,Najran Region,Human Health Activities,medium,10,338,162,176,687,353,334
2022,3,Eastern Province,Residential Care Activities,small,13,187,10,177,67,30,37
2022,3,Eastern Province,Residential Care Activities,micro,2,2,1,1,2,2,0
2022,3,Eastern Province,Residential Care Activities,medium,1,61,17,44,68,51,17
2022,3,Al Jawf Region,Residential Care Activities,small,1,32,0,32,0,0,0
2022,3,Al Jawf Region,Residential Care Activities,micro,3,2,1,1,1,1,0
2022,3,Riyadh Region,Residential Care Activities,small,28,577,50,527,125,59,66
2022,3,Riyadh Region,Residential Care Activities,micro,19,24,8,16,23,20,3
2022,3,Riyadh Region,Residential Care Activities,medium,4,281,62,219,172,113,59
2022,3,Qassim Region,Residential Care Activities,small,2,20,0,20,6,3,3
2022,3,Qassim Region,Residential Care Activities,micro,2,3,0,3,0,0,0
2022,3,Qassim Region,Residential Care Activities,medium,3,104,46,58,68,50,18
2022,3,Al Madinah Region,Residential Care Activities,small,5,91,29,62,34,25,9
2022,3,Al Madinah Region,Residential Care Activities,micro,5,11,10,1,4,3,1
2022,3,Tabuk Region,Residential Care Activities,small,3,88,1,87,13,7,6
2022,3,Tabuk Region,Residential Care Activities,micro,1,3,1,2,1,1,0
2022,3,Jazan Region,Residential Care Activities,small,3,48,5,43,5,1,4
2022,3,Jazan Region,Residential Care Activities,micro,1,1,1,0,0,0,0
2022,3,Jazan Region,Residential Care Activities,medium,1,54,1,53,12,6,6
2022,3,Hail Region,Residential Care Activities,small,2,26,8,18,3,1,2
2022,3,Hail Region,Residential Care Activities,micro,1,1,0,1,0,0,0
2022,3,Aseer Region,Residential Care Activities,small,3,52,11,41,25,13,12
2022,3,Aseer Region,Residential Care Activities,micro,3,4,1,3,2,2,0
2022,3,Aseer Region,Residential Care Activities,medium,2,109,2,107,7,0,7
2022,3,Makkah Region,Residential Care Activities,small,22,387,60,327,140,92,48
2022,3,Makkah Region,Residential Care Activities,micro,10,17,3,14,8,7,1
2022,3,Makkah Region,Residential Care Activities,medium,3,152,6,146,52,23,29
2022,3,Najran Region,Residential Care Activities,small,1,6,0,6,4,0,4
2022,3,Eastern Province,Forestry and Logging,micro,2,0,0,0,5,5,0
2022,3,Al Jawf Region,Forestry and Logging,micro,1,0,0,0,1,1,0
2022,3,Riyadh Region,Forestry and Logging,small,1,4,2,2,8,8,0
2022,3,Riyadh Region,Forestry and Logging,micro,5,1,1,0,7,7,0
2022,3,Qassim Region,Forestry and Logging,micro,1,0,0,0,1,1,0
2022,3,Jazan Region,Forestry and Logging,micro,1,1,0,1,0,0,0
2022,3,Hail Region,Forestry and Logging,micro,1,0,0,0,2,2,0
2022,3,Makkah Region,Forestry and Logging,micro,2,0,0,0,6,6,0
2022,3,Eastern Province,Education,small,296,3620,1036,2584,2065,1805,260
2022,3,Eastern Province,Education,large,12,3946,1781,2165,1016,859,157
2022,3,Eastern Province,Education,micro,361,396,151,245,467,417,50
2022,3,Eastern Province,Education,medium,93,5697,1712,3985,4357,3660,697
2022,3,Al Bahah Region,Education,small,8,96,46,50,83,77,6
2022,3,Al Bahah Region,Education,micro,16,15,6,9,25,21,4
2022,3,Al Jawf Region,Education,small,34,504,220,284,282,250,32
2022,3,Al Jawf Region,Education,micro,57,47,16,31,89,79,10
2022,3,Al Jawf Region,Education,medium,7,359,142,217,264,256,8
2022,3,Northern Borders Region,Education,small,17,189,142,47,150,149,1
2022,3,Northern Borders Region,Education,micro,21,21,2,19,35,34,1
2022,3,Northern Borders Region,Education,medium,3,193,56,137,77,62,15
2022,3,Riyadh Region,Education,small,668,6206,1434,4772,5035,4240,795
2022,3,Riyadh Region,Education,large,47,16308,7785,8523,9532,7800,1732
2022,3,Riyadh Region,Education,micro,5726,1144,457,687,12806,12610,196
2022,3,Riyadh Region,Education,medium,202,12538,3791,8747,9410,8023,1387
2022,3,Qassim Region,Education,small,64,787,185,602,408,360,48
2022,3,Qassim Region,Education,large,2,356,120,236,271,192,79
2022,3,Qassim Region,Education,micro,119,71,21,50,231,221,10
2022,3,Qassim Region,Education,medium,17,823,421,402,669,495,174
2022,3,Al Madinah Region,Education,small,117,1482,321,1161,651,568,83
2022,3,Al Madinah Region,Education,large,1,187,78,109,123,85,38
2022,3,Al Madinah Region,Education,micro,147,113,35,78,208,194,14
2022,3,Al Madinah Region,Education,medium,36,2344,727,1617,1314,1032,282
2022,3,Tabuk Region,Education,small,57,754,278,476,447,405,42
2022,3,Tabuk Region,Education,micro,36,44,8,36,36,33,3
2022,3,Tabuk Region,Education,medium,18,1042,491,551,713,667,46
2022,3,Jazan Region,Education,small,51,323,101,222,326,298,28
2022,3,Jazan Region,Education,micro,100,69,16,53,161,153,8
2022,3,Jazan Region,Education,medium,5,230,98,132,142,90,52
2022,3,Hail Region,Education,small,26,232,39,193,106,90,16
2022,3,Hail Region,Education,micro,115,43,18,25,238,237,1
2022,3,Hail Region,Education,medium,5,336,223,113,227,225,2
2022,3,Aseer Region,Education,small,74,987,270,717,513,454,59
2022,3,Aseer Region,Education,micro,107,75,18,57,153,144,9
2022,3,Aseer Region,Education,medium,15,843,446,397,549,491,58
2022,3,Makkah Region,Education,small,393,4827,997,3830,2552,1905,647
2022,3,Makkah Region,Education,large,16,4434,1854,2580,1979,1231,748
2022,3,Makkah Region,Education,micro,618,445,130,315,940,825,115
2022,3,Makkah Region,Education,medium,142,8344,3467,4877,6338,5195,1143
2022,3,Najran Region,Education,small,20,218,50,168,129,121,8
2022,3,Najran Region,Education,micro,81,24,7,17,160,158,2
2022,3,Najran Region,Education,medium,5,283,159,124,139,136,3
2022,3,Eastern Province,Warehousing and Support Activities for Transportation,small,308,1593,1140,453,3300,3287,13
2022,3,Eastern Province,Warehousing and Support Activities for Transportation,large,13,3922,3327,595,6201,6153,48
2022,3,Eastern Province,Warehousing and Support Activities for Transportation,micro,715,523,400,123,1227,1222,5
2022,3,Eastern Province,Warehousing and Support Activities for Transportation,medium,55,1940,1509,431,3054,3039,15
2022,3,Al Bahah Region,Warehousing and Support Activities for Transportation,small,2,1,0,1,14,14,0
2022,3,Al Bahah Region,Warehousing and Support Activities for Transportation,micro,27,11,6,5,52,52,0
2022,3,Al Jawf Region,Warehousing and Support Activities for Transportation,small,24,94,79,15,228,227,1
2022,3,Al Jawf Region,Warehousing and Support Activities for Transportation,micro,106,39,32,7,190,190,0
2022,3,Northern Borders Region,Warehousing and Support Activities for Transportation,small,4,7,5,2,24,24,0
2022,3,Northern Borders Region,Warehousing and Support Activities for Transportation,micro,30,6,4,2,56,56,0
2022,3,Northern Borders Region,Warehousing and Support Activities for Transportation,medium,1,33,32,1,31,31,0
2022,3,Riyadh Region,Warehousing and Support Activities for Transportation,small,456,2182,1172,1010,5736,5700,36
2022,3,Riyadh Region,Warehousing and Support Activities for Transportation,large,24,10139,7442,2697,7884,7811,73
2022,3,Riyadh Region,Warehousing and Support Activities for Transportation,micro,1606,605,347,258,3603,3585,18
2022,3,Riyadh Region,Warehousing and Support Activities for Transportation,medium,110,3264,1771,1493,8232,8179,53
2022,3,Qassim Region,Warehousing and Support Activities for Transportation,small,33,96,65,31,394,394,0
2022,3,Qassim Region,Warehousing and Support Activities for Transportation,large,1,9,8,1,260,260,0
2022,3,Qassim Region,Warehousing and Support Activities for Transportation,micro,147,38,20,18,294,292,2
2022,3,Qassim Region,Warehousing and Support Activities for Transportation,medium,6,108,75,33,428,428,0
2022,3,Al Madinah Region,Warehousing and Support Activities for Transportation,small,37,218,171,47,382,381,1
2022,3,Al Madinah Region,Warehousing and Support Activities for Transportation,large,2,952,908,44,318,318,0
2022,3,Al Madinah Region,Warehousing and Support Activities for Transportation,micro,212,68,50,18,390,389,1
2022,3,Al Madinah Region,Warehousing and Support Activities for Transportation,medium,5,169,157,12,254,254,0
2022,3,Tabuk Region,Warehousing and Support Activities for Transportation,small,21,58,40,18,205,205,0
2022,3,Tabuk Region,Warehousing and Support Activities for Transportation,micro,86,36,27,9,155,155,0
2022,3,Tabuk Region,Warehousing and Support Activities for Transportation,medium,2,80,42,38,214,214,0
2022,3,Jazan Region,Warehousing and Support Activities for Transportation,small,16,58,50,8,167,166,1
2022,3,Jazan Region,Warehousing and Support Activities for Transportation,micro,82,22,15,7,179,179,0
2022,3,Jazan Region,Warehousing and Support Activities for Transportation,medium,2,53,34,19,131,131,0
2022,3,Hail Region,Warehousing and Support Activities for Transportation,small,11,17,12,5,82,82,0
2022,3,Hail Region,Warehousing and Support Activities for Transportation,micro,67,23,12,11,147,147,0
2022,3,Aseer Region,Warehousing and Support Activities for Transportation,small,42,178,141,37,524,523,1
2022,3,Aseer Region,Warehousing and Support Activities for Transportation,large,1,69,42,27,312,312,0
2022,3,Aseer Region,Warehousing and Support Activities for Transportation,micro,125,43,29,14,271,271,0
2022,3,Aseer Region,Warehousing and Support Activities for Transportation,medium,3,54,53,1,162,162,0
2022,3,Makkah Region,Warehousing and Support Activities for Transportation,small,458,2130,1386,744,5199,5144,55
2022,3,Makkah Region,Warehousing and Support Activities for Transportation,large,20,6178,5378,800,9375,9354,21
2022,3,Makkah Region,Warehousing and Support Activities for Transportation,micro,901,528,341,187,1577,1549,28
2022,3,Makkah Region,Warehousing and Support Activities for Transportation,medium,87,3281,2440,841,6064,6018,46
2022,3,Najran Region,Warehousing and Support Activities for Transportation,small,78,42,16,26,687,687,0
2022,3,Najran Region,Warehousing and Support Activities for Transportation,micro,489,57,35,22,1349,1344,5
2022,3,Najran Region,Warehousing and Support Activities for Transportation,medium,1,10,9,1,40,40,0
2022,3,Eastern Province,"Research and Development in the Physical, Engineering, and Life Sciences",small,10,56,30,26,38,35,3
2022,3,Eastern Province,"Research and Development in the Physical, Engineering, and Life Sciences",micro,18,20,9,11,15,15,0
2022,3,Eastern Province,"Research and Development in the Physical, Engineering, and Life Sciences",medium,2,131,77,54,121,118,3
2022,3,Northern Borders Region,"Research and Development in the Physical, Engineering, and Life Sciences",micro,1,1,1,0,0,0,0
2022,3,Riyadh Region,"Research and Development in the Physical, Engineering, and Life Sciences",small,35,294,165,129,228,206,22
2022,3,Riyadh Region,"Research and Development in the Physical, Engineering, and Life Sciences",micro,76,72,45,27,85,79,6
2022,3,Riyadh Region,"Research and Development in the Physical, Engineering, and Life Sciences",medium,4,195,96,99,204,193,11
2022,3,Qassim Region,"Research and Development in the Physical, Engineering, and Life Sciences",micro,3,1,1,0,5,5,0
2022,3,Al Madinah Region,"Research and Development in the Physical, Engineering, and Life Sciences",small,1,4,4,0,3,3,0
2022,3,Al Madinah Region,"Research and Development in the Physical, Engineering, and Life Sciences",micro,11,10,6,4,14,13,1
2022,3,Tabuk Region,"Research and Development in the Physical, Engineering, and Life Sciences",micro,1,0,0,0,1,1,0
2022,3,Jazan Region,"Research and Development in the Physical, Engineering, and Life Sciences",small,1,8,6,2,1,1,0
2022,3,Jazan Region,"Research and Development in the Physical, Engineering, and Life Sciences",micro,1,0,0,0,1,1,0
2022,3,Hail Region,"Research and Development in the Physical, Engineering, and Life Sciences",micro,1,3,0,3,0,0,0
2022,3,Aseer Region,"Research and Development in the Physical, Engineering, and Life Sciences",small,2,21,3,18,2,2,0
2022,3,Aseer Region,"Research and Development in the Physical, Engineering, and Life Sciences",micro,3,3,0,3,5,4,1
2022,3,Makkah Region,"Research and Development in the Physical, Engineering, and Life Sciences",small,11,60,30,30,97,95,2
2022,3,Makkah Region,"Research and Development in the Physical, Engineering, and Life Sciences",large,1,867,865,2,44,44,0
2022,3,Makkah Region,"Research and Development in the Physical, Engineering, and Life Sciences",micro,44,43,13,30,64,59,5
2022,3,Makkah Region,"Research and Development in the Physical, Engineering, and Life Sciences",medium,3,130,121,9,162,157,5
2022,3,Eastern Province,Undifferentiated Goods-Producing Activities of Private Households for Own Use,small,1,0,0,0,12,12,0
2022,3,Eastern Province,Undifferentiated Goods-Producing Activities of Private Households for Own Use,micro,2,0,0,0,2,2,0
2022,3,Riyadh Region,Undifferentiated Goods-Producing Activities of Private Households for Own Use,small,1,1,0,1,6,6,0
2022,3,Riyadh Region,Undifferentiated Goods-Producing Activities of Private Households for Own Use,micro,1,0,0,0,1,1,0
2022,3,Qassim Region,Undifferentiated Goods-Producing Activities of Private Households for Own Use,micro,1,0,0,0,1,1,0
2022,3,Makkah Region,Undifferentiated Goods-Producing Activities of Private Households for Own Use,micro,2,0,0,0,2,0,2
2022,3,Eastern Province,"Other Professional, Scientific, and Technical Activities",small,29,145,61,84,209,187,22
2022,3,Eastern Province,"Other Professional, Scientific, and Technical Activities",large,1,272,232,40,342,340,2
2022,3,Eastern Province,"Other Professional, Scientific, and Technical Activities",micro,218,165,69,96,305,264,41
2022,3,Al Bahah Region,"Other Professional, Scientific, and Technical Activities",small,1,3,3,0,3,3,0
2022,3,Al Bahah Region,"Other Professional, Scientific, and Technical Activities",micro,12,3,0,3,22,19,3
2022,3,Al Jawf Region,"Other Professional, Scientific, and Technical Activities",small,1,1,0,1,5,5,0
2022,3,Al Jawf Region,"Other Professional, Scientific, and Technical Activities",micro,20,4,3,1,42,32,10
2022,3,Northern Borders Region,"Other Professional, Scientific, and Technical Activities",micro,11,1,0,1,22,19,3
2022,3,Riyadh Region,"Other Professional, Scientific, and Technical Activities",small,138,806,360,446,1109,960,149
2022,3,Riyadh Region,"Other Professional, Scientific, and Technical Activities",large,2,229,172,57,333,332,1
2022,3,Riyadh Region,"Other Professional, Scientific, and Technical Activities",micro,564,349,123,226,915,778,137
2022,3,Riyadh Region,"Other Professional, Scientific, and Technical Activities",medium,8,536,300,236,365,345,20
2022,3,Qassim Region,"Other Professional, Scientific, and Technical Activities",small,10,53,40,13,134,134,0
2022,3,Qassim Region,"Other Professional, Scientific, and Technical Activities",micro,37,20,10,10,63,56,7
2022,3,Qassim Region,"Other Professional, Scientific, and Technical Activities",medium,1,35,21,14,33,32,1
2022,3,Al Madinah Region,"Other Professional, Scientific, and Technical Activities",small,9,30,17,13,57,40,17
2022,3,Al Madinah Region,"Other Professional, Scientific, and Technical Activities",micro,102,44,19,25,173,152,21
2022,3,Tabuk Region,"Other Professional, Scientific, and Technical Activities",small,1,0,0,0,6,6,0
2022,3,Tabuk Region,"Other Professional, Scientific, and Technical Activities",micro,40,10,6,4,76,74,2
2022,3,Jazan Region,"Other Professional, Scientific, and Technical Activities",small,2,16,1,15,6,6,0
2022,3,Jazan Region,"Other Professional, Scientific, and Technical Activities",micro,44,13,2,11,73,68,5
2022,3,Hail Region,"Other Professional, Scientific, and Technical Activities",micro,29,7,2,5,49,45,4
2022,3,Aseer Region,"Other Professional, Scientific, and Technical Activities",small,5,18,7,11,28,28,0
2022,3,Aseer Region,"Other Professional, Scientific, and Technical Activities",micro,54,17,9,8,106,99,7
2022,3,Aseer Region,"Other Professional, Scientific, and Technical Activities",medium,1,22,21,1,64,64,0
2022,3,Makkah Region,"Other Professional, Scientific, and Technical Activities",small,73,346,187,159,595,544,51
2022,3,Makkah Region,"Other Professional, Scientific, and Technical Activities",micro,447,226,74,152,761,642,119
2022,3,Makkah Region,"Other Professional, Scientific, and Technical Activities",medium,3,127,104,23,99,99,0
2022,3,Najran Region,"Other Professional, Scientific, and Technical Activities",micro,31,2,1,1,61,57,4
2022,3,Eastern Province,Activities Auxiliary to Financial Services and Insurance Activities,small,32,346,207,139,160,156,4
2022,3,Eastern Province,Activities Auxiliary to Financial Services and Insurance Activities,large,1,230,99,131,68,64,4
2022,3,Eastern Province,Activities Auxiliary to Financial Services and Insurance Activities,micro,40,52,39,13,47,44,3
2022,3,Eastern Province,Activities Auxiliary to Financial Services and Insurance Activities,medium,5,396,271,125,77,70,7
2022,3,Al Bahah Region,Activities Auxiliary to Financial Services and Insurance Activities,small,1,14,10,4,0,0,0
2022,3,Al Jawf Region,Activities Auxiliary to Financial Services and Insurance Activities,micro,2,0,0,0,3,3,0
2022,3,Riyadh Region,Activities Auxiliary to Financial Services and Insurance Activities,small,225,2848,1905,943,798,752,46
2022,3,Riyadh Region,Activities Auxiliary to Financial Services and Insurance Activities,large,10,21439,17263,4176,1299,1280,19
2022,3,Riyadh Region,Activities Auxiliary to Financial Services and Insurance Activities,micro,231,416,281,135,155,151,4
2022,3,Riyadh Region,Activities Auxiliary to Financial Services and Insurance Activities,medium,41,4523,3163,1360,944,880,64
2022,3,Qassim Region,Activities Auxiliary to Financial Services and Insurance Activities,small,1,0,0,0,11,11,0
2022,3,Qassim Region,Activities Auxiliary to Financial Services and Insurance Activities,micro,6,6,4,2,5,5,0
2022,3,Qassim Region,Activities Auxiliary to Financial Services and Insurance Activities,medium,1,144,123,21,0,0,0
2022,3,Al Madinah Region,Activities Auxiliary to Financial Services and Insurance Activities,small,4,22,16,6,4,4,0
2022,3,Al Madinah Region,Activities Auxiliary to Financial Services and Insurance Activities,micro,14,28,26,2,15,15,0
2022,3,Al Madinah Region,Activities Auxiliary to Financial Services and Insurance Activities,medium,1,153,142,11,0,0,0
2022,3,Tabuk Region,Activities Auxiliary to Financial Services and Insurance Activities,small,1,39,39,0,0,0,0
2022,3,Tabuk Region,Activities Auxiliary to Financial Services and Insurance Activities,micro,2,3,2,1,3,3,0
2022,3,Jazan Region,Activities Auxiliary to Financial Services and Insurance Activities,small,1,2,2,0,4,4,0
2022,3,Jazan Region,Activities Auxiliary to Financial Services and Insurance Activities,micro,1,3,1,2,0,0,0
2022,3,Hail Region,Activities Auxiliary to Financial Services and Insurance Activities,micro,1,1,0,1,0,0,0
2022,3,Aseer Region,Activities Auxiliary to Financial Services and Insurance Activities,small,1,6,6,0,0,0,0
2022,3,Aseer Region,Activities Auxiliary to Financial Services and Insurance Activities,micro,5,1,1,0,7,7,0
2022,3,Aseer Region,Activities Auxiliary to Financial Services and Insurance Activities,medium,1,207,194,13,0,0,0
2022,3,Makkah Region,Activities Auxiliary to Financial Services and Insurance Activities,small,55,630,376,254,314,302,12
2022,3,Makkah Region,Activities Auxiliary to Financial Services and Insurance Activities,micro,72,87,62,25,89,85,4
2022,3,Makkah Region,Activities Auxiliary to Financial Services and Insurance Activities,medium,11,773,493,280,251,243,8
2022,3,Najran Region,Activities Auxiliary to Financial Services and Insurance Activities,small,1,19,18,1,11,11,0
2022,3,Najran Region,Activities Auxiliary to Financial Services and Insurance Activities,micro,3,0,0,0,3,3,0
2022,3,Eastern Province,Legal and Accounting Activities,small,108,723,438,285,472,462,10
2022,3,Eastern Province,Legal and Accounting Activities,micro,277,370,230,140,273,266,7
2022,3,Eastern Province,Legal and Accounting Activities,medium,9,439,252,187,363,362,1
2022,3,Al Bahah Region,Legal and Accounting Activities,micro,14,18,6,12,15,15,0
2022,3,Al Jawf Region,Legal and Accounting Activities,small,8,45,30,15,11,11,0
2022,3,Al Jawf Region,Legal and Accounting Activities,micro,23,27,18,9,18,18,0
2022,3,Northern Borders Region,Legal and Accounting Activities,small,1,8,5,3,6,6,0
2022,3,Northern Borders Region,Legal and Accounting Activities,micro,7,9,5,4,6,6,0
2022,3,Riyadh Region,Legal and Accounting Activities,small,454,3397,2061,1336,2442,2349,93
2022,3,Riyadh Region,Legal and Accounting Activities,large,2,526,282,244,501,460,41
2022,3,Riyadh Region,Legal and Accounting Activities,micro,1527,1481,986,495,2079,2047,32
2022,3,Riyadh Region,Legal and Accounting Activities,medium,28,1120,625,495,1310,1247,63
2022,3,Qassim Region,Legal and Accounting Activities,small,14,95,50,45,20,20,0
2022,3,Qassim Region,Legal and Accounting Activities,micro,81,104,57,47,67,66,1
2022,3,Al Madinah Region,Legal and Accounting Activities,small,32,232,131,101,107,106,1
2022,3,Al Madinah Region,Legal and Accounting Activities,micro,85,79,56,23,92,86,6
2022,3,Tabuk Region,Legal and Accounting Activities,small,5,34,15,19,7,7,0
2022,3,Tabuk Region,Legal and Accounting Activities,micro,20,27,10,17,10,10,0
2022,3,Jazan Region,Legal and Accounting Activities,small,8,69,45,24,20,20,0
2022,3,Jazan Region,Legal and Accounting Activities,micro,35,42,31,11,38,37,1
2022,3,Hail Region,Legal and Accounting Activities,small,4,27,25,2,10,10,0
2022,3,Hail Region,Legal and Accounting Activities,micro,28,29,17,12,28,28,0
2022,3,Aseer Region,Legal and Accounting Activities,small,6,47,42,5,51,51,0
2022,3,Aseer Region,Legal and Accounting Activities,micro,70,72,53,19,74,74,0
2022,3,Aseer Region,Legal and Accounting Activities,medium,2,83,47,36,87,87,0
2022,3,Makkah Region,Legal and Accounting Activities,small,254,2020,1266,754,1162,1097,65
2022,3,Makkah Region,Legal and Accounting Activities,large,1,119,90,29,133,132,1
2022,3,Makkah Region,Legal and Accounting Activities,micro,722,1004,617,387,722,687,35
2022,3,Makkah Region,Legal and Accounting Activities,medium,11,580,351,229,650,632,18
2022,3,Najran Region,Legal and Accounting Activities,small,2,10,9,1,18,18,0
2022,3,Najran Region,Legal and Accounting Activities,micro,41,9,6,3,81,80,1
2022,3,Eastern Province,Real Estate Activities,small,211,1220,759,461,1799,1784,15
2022,3,Eastern Province,Real Estate Activities,large,2,109,51,58,509,509,0
2022,3,Eastern Province,Real Estate Activities,micro,678,546,336,210,879,868,11
2022,3,Eastern Province,Real Estate Activities,medium,16,968,587,381,923,907,16
2022,3,Al Bahah Region,Real Estate Activities,small,5,29,23,6,49,49,0
2022,3,Al Bahah Region,Real Estate Activities,micro,25,12,9,3,41,41,0
2022,3,Al Jawf Region,Real Estate Activities,small,8,55,31,24,77,76,1
2022,3,Al Jawf Region,Real Estate Activities,micro,51,34,23,11,81,81,0
2022,3,Northern Borders Region,Real Estate Activities,small,5,27,18,9,38,38,0
2022,3,Northern Borders Region,Real Estate Activities,micro,42,15,8,7,73,72,1
2022,3,Riyadh Region,Real Estate Activities,small,708,4521,2752,1769,5866,5737,129
2022,3,Riyadh Region,Real Estate Activities,large,9,2323,1592,731,2268,2220,48
2022,3,Riyadh Region,Real Estate Activities,micro,2193,1882,1156,726,2853,2810,43
2022,3,Riyadh Region,Real Estate Activities,medium,63,2820,2014,806,2903,2871,32
2022,3,Qassim Region,Real Estate Activities,small,25,138,90,48,205,205,0
2022,3,Qassim Region,Real Estate Activities,large,3,149,90,59,660,660,0
2022,3,Qassim Region,Real Estate Activities,micro,189,139,87,52,283,278,5
2022,3,Qassim Region,Real Estate Activities,medium,2,64,27,37,118,118,0
2022,3,Al Madinah Region,Real Estate Activities,small,48,206,136,70,369,366,3
2022,3,Al Madinah Region,Real Estate Activities,micro,294,129,76,53,424,422,2
2022,3,Al Madinah Region,Real Estate Activities,medium,3,124,96,28,215,210,5
2022,3,Tabuk Region,Real Estate Activities,small,10,63,48,15,95,95,0
2022,3,Tabuk Region,Real Estate Activities,micro,116,50,34,16,180,180,0
2022,3,Jazan Region,Real Estate Activities,small,20,65,28,37,159,159,0
2022,3,Jazan Region,Real Estate Activities,micro,150,56,33,23,260,258,2
2022,3,Jazan Region,Real Estate Activities,medium,1,23,11,12,30,30,0
2022,3,Hail Region,Real Estate Activities,small,10,28,15,13,72,72,0
2022,3,Hail Region,Real Estate Activities,micro,94,57,28,29,143,143,0
2022,3,Hail Region,Real Estate Activities,medium,1,0,0,0,88,88,0
2022,3,Aseer Region,Real Estate Activities,small,30,135,86,49,237,236,1
2022,3,Aseer Region,Real Estate Activities,micro,257,113,60,53,419,417,2
2022,3,Aseer Region,Real Estate Activities,medium,4,89,46,43,250,249,1
2022,3,Makkah Region,Real Estate Activities,small,429,2274,1369,905,3823,3714,109
2022,3,Makkah Region,Real Estate Activities,large,3,498,302,196,780,766,14
2022,3,Makkah Region,Real Estate Activities,micro,1799,1131,667,464,2729,2658,71
2022,3,Makkah Region,Real Estate Activities,medium,40,1776,1233,543,2235,2166,69
2022,3,Najran Region,Real Estate Activities,small,5,18,9,9,69,69,0
2022,3,Najran Region,Real Estate Activities,micro,63,15,8,7,109,109,0
2022,3,Eastern Province,"Sports, Entertainment, and Recreation Activities",small,130,505,230,275,1164,1017,147
2022,3,Eastern Province,"Sports, Entertainment, and Recreation Activities",micro,301,265,84,181,427,374,53
2022,3,Eastern Province,"Sports, Entertainment, and Recreation Activities",medium,8,242,78,164,450,426,24
2022,3,Al Bahah Region,"Sports, Entertainment, and Recreation Activities",small,3,13,10,3,15,14,1
2022,3,Al Bahah Region,"Sports, Entertainment, and Recreation Activities",micro,29,12,4,8,57,50,7
2022,3,Al Jawf Region,"Sports, Entertainment, and Recreation Activities",small,10,40,26,14,61,61,0
2022,3,Al Jawf Region,"Sports, Entertainment, and Recreation Activities",micro,37,19,10,9,63,56,7
2022,3,Northern Borders Region,"Sports, Entertainment, and Recreation Activities",small,11,26,8,18,78,69,9
2022,3,Northern Borders Region,"Sports, Entertainment, and Recreation Activities",micro,38,16,8,8,82,74,8
2022,3,Riyadh Region,"Sports, Entertainment, and Recreation Activities",small,277,1402,552,850,2662,2324,338
2022,3,Riyadh Region,"Sports, Entertainment, and Recreation Activities",large,6,1345,802,543,1738,1397,341
2022,3,Riyadh Region,"Sports, Entertainment, and Recreation Activities",micro,702,436,153,283,1198,1087,111
2022,3,Riyadh Region,"Sports, Entertainment, and Recreation Activities",medium,24,1096,372,724,1239,1001,238
2022,3,Qassim Region,"Sports, Entertainment, and Recreation Activities",small,40,225,101,124,341,314,27
2022,3,Qassim Region,"Sports, Entertainment, and Recreation Activities",micro,80,68,21,47,118,100,18
2022,3,Qassim Region,"Sports, Entertainment, and Recreation Activities",medium,2,42,9,33,220,220,0
2022,3,Al Madinah Region,"Sports, Entertainment, and Recreation Activities",small,36,193,69,124,243,220,23
2022,3,Al Madinah Region,"Sports, Entertainment, and Recreation Activities",micro,92,61,29,32,157,133,24
2022,3,Al Madinah Region,"Sports, Entertainment, and Recreation Activities",medium,2,86,40,46,123,112,11
2022,3,Tabuk Region,"Sports, Entertainment, and Recreation Activities",small,19,75,27,48,137,121,16
2022,3,Tabuk Region,"Sports, Entertainment, and Recreation Activities",micro,74,40,17,23,123,113,10
2022,3,Jazan Region,"Sports, Entertainment, and Recreation Activities",small,13,35,10,25,190,173,17
2022,3,Jazan Region,"Sports, Entertainment, and Recreation Activities",micro,56,35,16,19,93,85,8
2022,3,Jazan Region,"Sports, Entertainment, and Recreation Activities",medium,3,8,8,0,203,203,0
2022,3,Hail Region,"Sports, Entertainment, and Recreation Activities",small,23,83,36,47,211,210,1
2022,3,Hail Region,"Sports, Entertainment, and Recreation Activities",micro,61,49,31,18,102,95,7
2022,3,Aseer Region,"Sports, Entertainment, and Recreation Activities",small,59,245,84,161,544,494,50
2022,3,Aseer Region,"Sports, Entertainment, and Recreation Activities",micro,131,80,32,48,236,216,20
2022,3,Makkah Region,"Sports, Entertainment, and Recreation Activities",small,188,954,371,583,1473,1273,200
2022,3,Makkah Region,"Sports, Entertainment, and Recreation Activities",micro,566,381,167,214,964,876,88
2022,3,Makkah Region,"Sports, Entertainment, and Recreation Activities",medium,24,1250,494,756,1231,1105,126
2022,3,Najran Region,"Sports, Entertainment, and Recreation Activities",small,17,80,41,39,118,113,5
2022,3,Najran Region,"Sports, Entertainment, and Recreation Activities",micro,34,12,6,6,73,68,5
2022,3,Eastern Province,Veterinary Activities,small,11,68,40,28,89,85,4
2022,3,Eastern Province,Veterinary Activities,micro,53,40,18,22,85,77,8
2022,3,Eastern Province,Veterinary Activities,medium,1,17,9,8,34,34,0
2022,3,Al Bahah Region,Veterinary Activities,micro,1,0,0,0,2,2,0
2022,3,Al Jawf Region,Veterinary Activities,micro,1,0,0,0,3,3,0
2022,3,Northern Borders Region,Veterinary Activities,micro,5,4,3,1,9,9,0
2022,3,Riyadh Region,Veterinary Activities,small,32,146,64,82,308,277,31
2022,3,Riyadh Region,Veterinary Activities,micro,70,33,16,17,115,110,5
2022,3,Riyadh Region,Veterinary Activities,medium,3,79,39,40,116,106,10
2022,3,Qassim Region,Veterinary Activities,small,2,5,4,1,8,8,0
2022,3,Qassim Region,Veterinary Activities,micro,22,6,4,2,37,36,1
2022,3,Qassim Region,Veterinary Activities,medium,1,23,23,0,44,44,0
2022,3,Al Madinah Region,Veterinary Activities,small,2,7,4,3,13,10,3
2022,3,Al Madinah Region,Veterinary Activities,micro,18,8,5,3,36,33,3
2022,3,Tabuk Region,Veterinary Activities,small,2,5,1,4,14,13,1
2022,3,Tabuk Region,Veterinary Activities,micro,9,1,1,0,13,13,0
2022,3,Jazan Region,Veterinary Activities,micro,8,4,4,0,16,16,0
2022,3,Hail Region,Veterinary Activities,small,1,1,0,1,6,6,0
2022,3,Hail Region,Veterinary Activities,micro,8,1,1,0,12,12,0
2022,3,Aseer Region,Veterinary Activities,small,4,27,8,19,27,26,1
2022,3,Aseer Region,Veterinary Activities,micro,29,8,3,5,48,47,1
2022,3,Makkah Region,Veterinary Activities,small,15,70,14,56,124,110,14
2022,3,Makkah Region,Veterinary Activities,micro,55,27,13,14,109,105,4
2022,3,Makkah Region,Veterinary Activities,medium,2,41,21,20,75,62,13
2022,3,Najran Region,Veterinary Activities,small,1,2,2,0,7,7,0
2022,3,Najran Region,Veterinary Activities,micro,8,0,0,0,12,12,0
2022,3,Eastern Province,Rental and Leasing Activities,small,318,1070,726,344,3613,3603,10
2022,3,Eastern Province,Rental and Leasing Activities,large,9,1162,899,263,2634,2631,3
2022,3,Eastern Province,Rental and Leasing Activities,micro,2082,489,278,211,4245,4237,8
2022,3,Eastern Province,Rental and Leasing Activities,medium,40,978,691,287,3289,3284,5
2022,3,Al Bahah Region,Rental and Leasing Activities,small,7,7,3,4,49,49,0
2022,3,Al Bahah Region,Rental and Leasing Activities,micro,155,20,14,6,279,277,2
2022,3,Al Jawf Region,Rental and Leasing Activities,small,28,28,17,11,184,183,1
2022,3,Al Jawf Region,Rental and Leasing Activities,micro,611,50,33,17,1231,1221,10
2022,3,Al Jawf Region,Rental and Leasing Activities,medium,1,10,10,0,45,45,0
2022,3,Northern Borders Region,Rental and Leasing Activities,small,9,40,29,11,52,52,0
2022,3,Northern Borders Region,Rental and Leasing Activities,micro,218,23,18,5,458,454,4
2022,3,Northern Borders Region,Rental and Leasing Activities,medium,1,12,1,11,45,45,0
2022,3,Riyadh Region,Rental and Leasing Activities,small,1158,1508,870,638,8979,8922,57
2022,3,Riyadh Region,Rental and Leasing Activities,large,7,1598,1334,264,2576,2573,3
2022,3,Riyadh Region,Rental and Leasing Activities,micro,51464,3739,1814,1925,129071,128505,566
2022,3,Riyadh Region,Rental and Leasing Activities,medium,37,1340,1004,336,2777,2771,6
2022,3,Qassim Region,Rental and Leasing Activities,small,66,148,110,38,551,549,2
2022,3,Qassim Region,Rental and Leasing Activities,large,1,61,52,9,238,238,0
2022,3,Qassim Region,Rental and Leasing Activities,micro,1205,178,101,77,2736,2723,13
2022,3,Qassim Region,Rental and Leasing Activities,medium,4,118,106,12,426,426,0
2022,3,Al Madinah Region,Rental and Leasing Activities,small,87,234,155,79,851,848,3
2022,3,Al Madinah Region,Rental and Leasing Activities,micro,1028,148,90,58,2078,2066,12
2022,3,Al Madinah Region,Rental and Leasing Activities,medium,4,145,140,5,410,410,0
2022,3,Tabuk Region,Rental and Leasing Activities,small,16,79,73,6,163,163,0
2022,3,Tabuk Region,Rental and Leasing Activities,micro,451,53,25,28,817,814,3
2022,3,Tabuk Region,Rental and Leasing Activities,medium,3,63,46,17,147,147,0
2022,3,Jazan Region,Rental and Leasing Activities,small,26,55,40,15,258,250,8
2022,3,Jazan Region,Rental and Leasing Activities,micro,1162,109,62,47,2630,2622,8
2022,3,Jazan Region,Rental and Leasing Activities,medium,1,37,37,0,28,28,0
2022,3,Hail Region,Rental and Leasing Activities,small,42,39,24,15,324,321,3
2022,3,Hail Region,Rental and Leasing Activities,micro,933,79,44,35,2351,2340,11
2022,3,Hail Region,Rental and Leasing Activities,medium,1,0,0,0,87,87,0
2022,3,Aseer Region,Rental and Leasing Activities,small,68,155,105,50,568,566,2
2022,3,Aseer Region,Rental and Leasing Activities,micro,1433,189,117,72,2815,2809,6
2022,3,Aseer Region,Rental and Leasing Activities,medium,1,74,74,0,56,55,1
2022,3,Makkah Region,Rental and Leasing Activities,small,257,776,504,272,2286,2254,32
2022,3,Makkah Region,Rental and Leasing Activities,large,3,402,347,55,774,773,1
2022,3,Makkah Region,Rental and Leasing Activities,micro,3301,509,307,202,6972,6886,86
2022,3,Makkah Region,Rental and Leasing Activities,medium,23,735,583,152,1376,1375,1
2022,3,Najran Region,Rental and Leasing Activities,small,52,46,29,17,432,432,0
2022,3,Najran Region,Rental and Leasing Activities,micro,1283,95,47,48,3047,3028,19
2022,3,Eastern Province,"Office Administrative, Office Support, and Other Business Support Activities",small,128,687,318,369,1053,1036,17
2022,3,Eastern Province,"Office Administrative, Office Support, and Other Business Support Activities",large,1,459,371,88,586,586,0
2022,3,Eastern Province,"Office Administrative, Office Support, and Other Business Support Activities",micro,734,440,190,250,1169,1143,26
2022,3,Eastern Province,"Office Administrative, Office Support, and Other Business Support Activities",medium,15,896,654,242,964,951,13
2022,3,Al Bahah Region,"Office Administrative, Office Support, and Other Business Support Activities",small,5,22,18,4,32,32,0
2022,3,Al Bahah Region,"Office Administrative, Office Support, and Other Business Support Activities",micro,41,16,15,1,64,64,0
2022,3,Al Jawf Region,"Office Administrative, Office Support, and Other Business Support Activities",small,4,9,3,6,31,31,0
2022,3,Al Jawf Region,"Office Administrative, Office Support, and Other Business Support Activities",micro,79,26,12,14,142,141,1
2022,3,Northern Borders Region,"Office Administrative, Office Support, and Other Business Support Activities",small,3,4,1,3,20,20,0
2022,3,Northern Borders Region,"Office Administrative, Office Support, and Other Business Support Activities",micro,44,13,12,1,87,87,0
2022,3,Riyadh Region,"Office Administrative, Office Support, and Other Business Support Activities",small,536,3214,1379,1835,4398,4142,256
2022,3,Riyadh Region,"Office Administrative, Office Support, and Other Business Support Activities",large,10,4652,2671,1981,2580,2324,256
2022,3,Riyadh Region,"Office Administrative, Office Support, and Other Business Support Activities",micro,2199,1290,608,682,3634,3490,144
2022,3,Riyadh Region,"Office Administrative, Office Support, and Other Business Support Activities",medium,46,2133,961,1172,2442,2263,179
2022,3,Qassim Region,"Office Administrative, Office Support, and Other Business Support Activities",small,19,88,46,42,205,205,0
2022,3,Qassim Region,"Office Administrative, Office Support, and Other Business Support Activities",micro,214,74,48,26,351,348,3
2022,3,Qassim Region,"Office Administrative, Office Support, and Other Business Support Activities",medium,3,23,3,20,164,163,1
2022,3,Al Madinah Region,"Office Administrative, Office Support, and Other Business Support Activities",small,32,143,72,71,214,208,6
2022,3,Al Madinah Region,"Office Administrative, Office Support, and Other Business Support Activities",micro,281,91,52,39,505,487,18
2022,3,Al Madinah Region,"Office Administrative, Office Support, and Other Business Support Activities",medium,2,80,52,28,117,111,6
2022,3,Tabuk Region,"Office Administrative, Office Support, and Other Business Support Activities",small,8,21,16,5,56,56,0
2022,3,Tabuk Region,"Office Administrative, Office Support, and Other Business Support Activities",micro,117,42,13,29,186,184,2
2022,3,Tabuk Region,"Office Administrative, Office Support, and Other Business Support Activities",medium,1,34,19,15,39,34,5
2022,3,Jazan Region,"Office Administrative, Office Support, and Other Business Support Activities",small,4,13,6,7,30,30,0
2022,3,Jazan Region,"Office Administrative, Office Support, and Other Business Support Activities",micro,126,36,16,20,231,230,1
2022,3,Hail Region,"Office Administrative, Office Support, and Other Business Support Activities",small,7,29,23,6,70,70,0
2022,3,Hail Region,"Office Administrative, Office Support, and Other Business Support Activities",micro,168,41,19,22,280,272,8
2022,3,Aseer Region,"Office Administrative, Office Support, and Other Business Support Activities",small,19,60,21,39,133,133,0
2022,3,Aseer Region,"Office Administrative, Office Support, and Other Business Support Activities",micro,287,90,51,39,486,484,2
2022,3,Aseer Region,"Office Administrative, Office Support, and Other Business Support Activities",medium,1,25,15,10,32,32,0
2022,3,Makkah Region,"Office Administrative, Office Support, and Other Business Support Activities",small,292,1454,712,742,2240,2102,138
2022,3,Makkah Region,"Office Administrative, Office Support, and Other Business Support Activities",large,4,2797,1739,1058,965,907,58
2022,3,Makkah Region,"Office Administrative, Office Support, and Other Business Support Activities",micro,1438,678,343,335,2578,2447,131
2022,3,Makkah Region,"Office Administrative, Office Support, and Other Business Support Activities",medium,28,1172,667,505,1395,1335,60
2022,3,Najran Region,"Office Administrative, Office Support, and Other Business Support Activities",small,2,4,2,2,9,9,0
2022,3,Najran Region,"Office Administrative, Office Support, and Other Business Support Activities",micro,94,30,14,16,174,173,1
2022,3,Eastern Province,Other Mining and Quarrying Activities,small,54,199,118,81,704,700,4
2022,3,Eastern Province,Other Mining and Quarrying Activities,large,3,1032,813,219,2088,2084,4
2022,3,Eastern Province,Other Mining and Quarrying Activities,micro,89,65,42,23,152,150,2
2022,3,Eastern Province,Other Mining and Quarrying Activities,medium,12,304,222,82,631,631,0
2022,3,Al Bahah Region,Other Mining and Quarrying Activities,small,2,9,2,7,31,31,0
2022,3,Al Bahah Region,Other Mining and Quarrying Activities,micro,4,3,1,2,11,11,0
2022,3,Al Jawf Region,Other Mining and Quarrying Activities,small,2,12,10,2,59,59,0
2022,3,Al Jawf Region,Other Mining and Quarrying Activities,micro,12,5,5,0,18,18,0
2022,3,Northern Borders Region,Other Mining and Quarrying Activities,small,4,7,5,2,23,23,0
2022,3,Northern Borders Region,Other Mining and Quarrying Activities,micro,6,3,2,1,15,15,0
2022,3,Northern Borders Region,Other Mining and Quarrying Activities,medium,2,132,122,10,92,92,0
2022,3,Riyadh Region,Other Mining and Quarrying Activities,small,152,630,356,274,1882,1875,7
2022,3,Riyadh Region,Other Mining and Quarrying Activities,large,4,358,293,65,1298,1298,0
2022,3,Riyadh Region,Other Mining and Quarrying Activities,micro,257,178,94,84,467,464,3
2022,3,Riyadh Region,Other Mining and Quarrying Activities,medium,24,771,391,380,1698,1696,2
2022,3,Qassim Region,Other Mining and Quarrying Activities,small,11,77,45,32,182,182,0
2022,3,Qassim Region,Other Mining and Quarrying Activities,micro,26,11,9,2,48,48,0
2022,3,Qassim Region,Other Mining and Quarrying Activities,medium,2,38,17,21,154,154,0
2022,3,Al Madinah Region,Other Mining and Quarrying Activities,small,26,140,99,41,348,348,0
2022,3,Al Madinah Region,Other Mining and Quarrying Activities,large,2,315,302,13,375,375,0
2022,3,Al Madinah Region,Other Mining and Quarrying Activities,micro,49,26,17,9,91,91,0
2022,3,Al Madinah Region,Other Mining and Quarrying Activities,medium,1,22,22,0,47,47,0
2022,3,Tabuk Region,Other Mining and Quarrying Activities,small,6,32,20,12,61,61,0
2022,3,Tabuk Region,Other Mining and Quarrying Activities,micro,11,7,4,3,18,18,0
2022,3,Tabuk Region,Other Mining and Quarrying Activities,medium,1,17,10,7,107,107,0
2022,3,Jazan Region,Other Mining and Quarrying Activities,small,17,79,50,29,220,220,0
2022,3,Jazan Region,Other Mining and Quarrying Activities,micro,27,15,9,6,48,48,0
2022,3,Jazan Region,Other Mining and Quarrying Activities,medium,1,17,4,13,34,34,0
2022,3,Hail Region,Other Mining and Quarrying Activities,small,1,3,0,3,10,10,0
2022,3,Hail Region,Other Mining and Quarrying Activities,micro,14,4,1,3,14,14,0
2022,3,Aseer Region,Other Mining and Quarrying Activities,small,24,108,84,24,271,271,0
2022,3,Aseer Region,Other Mining and Quarrying Activities,micro,55,32,25,7,95,95,0
2022,3,Makkah Region,Other Mining and Quarrying Activities,small,70,277,134,143,790,787,3
2022,3,Makkah Region,Other Mining and Quarrying Activities,large,1,178,107,71,303,303,0
2022,3,Makkah Region,Other Mining and Quarrying Activities,micro,123,90,56,34,211,210,1
2022,3,Makkah Region,Other Mining and Quarrying Activities,medium,9,360,315,45,649,649,0
2022,3,Najran Region,Other Mining and Quarrying Activities,small,6,33,18,15,95,95,0
2022,3,Najran Region,Other Mining and Quarrying Activities,micro,17,9,4,5,38,38,0
2022,3,Eastern Province,"Creative, Arts, and Entertainment Activities",small,3,13,8,5,25,25,0
2022,3,Eastern Province,"Creative, Arts, and Entertainment Activities",micro,31,20,7,13,43,38,5
2022,3,Al Bahah Region,"Creative, Arts, and Entertainment Activities",micro,2,1,0,1,5,5,0
2022,3,Northern Borders Region,"Creative, Arts, and Entertainment Activities",micro,1,0,0,0,4,4,0
2022,3,Riyadh Region,"Creative, Arts, and Entertainment Activities",small,17,93,36,57,90,79,11
2022,3,Riyadh Region,"Creative, Arts, and Entertainment Activities",large,2,143,95,48,488,483,5
2022,3,Riyadh Region,"Creative, Arts, and Entertainment Activities",micro,88,59,31,28,127,114,13
2022,3,Riyadh Region,"Creative, Arts, and Entertainment Activities",medium,2,175,130,45,143,140,3
2022,3,Qassim Region,"Creative, Arts, and Entertainment Activities",micro,4,1,0,1,11,11,0
2022,3,Al Madinah Region,"Creative, Arts, and Entertainment Activities",small,1,0,0,0,7,7,0
2022,3,Al Madinah Region,"Creative, Arts, and Entertainment Activities",micro,13,3,2,1,20,18,2
2022,3,Tabuk Region,"Creative, Arts, and Entertainment Activities",micro,3,3,1,2,7,7,0
2022,3,Jazan Region,"Creative, Arts, and Entertainment Activities",micro,1,1,1,0,2,2,0
2022,3,Hail Region,"Creative, Arts, and Entertainment Activities",micro,1,0,0,0,1,1,0
2022,3,Aseer Region,"Creative, Arts, and Entertainment Activities",small,2,2,2,0,11,11,0
2022,3,Aseer Region,"Creative, Arts, and Entertainment Activities",micro,9,1,1,0,20,20,0
2022,3,Aseer Region,"Creative, Arts, and Entertainment Activities",medium,1,22,3,19,30,30,0
2022,3,Makkah Region,"Creative, Arts, and Entertainment Activities",small,9,34,15,19,64,64,0
2022,3,Makkah Region,"Creative, Arts, and Entertainment Activities",micro,96,61,20,41,128,112,16
2022,3,Najran Region,"Creative, Arts, and Entertainment Activities",micro,2,0,0,0,3,3,0
2022,3,Eastern Province,Accommodation,small,265,1201,642,559,2409,2381,28
2022,3,Eastern Province,Accommodation,large,1,99,72,27,172,172,0
2022,3,Eastern Province,Accommodation,micro,300,265,156,109,536,528,8
2022,3,Eastern Province,Accommodation,medium,37,1295,758,537,2157,2073,84
2022,3,Al Bahah Region,Accommodation,small,23,86,54,32,168,168,0
2022,3,Al Bahah Region,Accommodation,micro,77,47,36,11,118,118,0
2022,3,Al Bahah Region,Accommodation,medium,1,29,15,14,45,45,0
2022,3,Al Jawf Region,Accommodation,small,7,16,11,5,53,53,0
2022,3,Al Jawf Region,Accommodation,micro,63,39,24,15,125,125,0
2022,3,Al Jawf Region,Accommodation,medium,1,15,6,9,38,38,0
2022,3,Northern Borders Region,Accommodation,small,12,47,20,27,107,107,0
2022,3,Northern Borders Region,Accommodation,micro,40,26,18,8,78,78,0
2022,3,Northern Borders Region,Accommodation,medium,1,24,14,10,39,39,0
2022,3,Riyadh Region,Accommodation,small,401,2090,1126,964,4178,4137,41
2022,3,Riyadh Region,Accommodation,large,8,1330,874,456,1666,1579,87
2022,3,Riyadh Region,Accommodation,micro,734,540,279,261,1441,1422,19
2022,3,Riyadh Region,Accommodation,medium,71,2552,1470,1082,4353,4272,81
2022,3,Qassim Region,Accommodation,small,55,241,164,77,450,449,1
2022,3,Qassim Region,Accommodation,large,1,0,0,0,332,331,1
2022,3,Qassim Region,Accommodation,micro,107,85,60,25,209,209,0
2022,3,Qassim Region,Accommodation,medium,3,75,43,32,128,128,0
2022,3,Al Madinah Region,Accommodation,small,172,1066,768,298,1507,1493,14
2022,3,Al Madinah Region,Accommodation,large,4,553,378,175,760,752,8
2022,3,Al Madinah Region,Accommodation,micro,390,279,192,87,680,669,11
2022,3,Al Madinah Region,Accommodation,medium,31,1251,866,385,1857,1839,18
2022,3,Tabuk Region,Accommodation,small,42,214,113,101,344,344,0
2022,3,Tabuk Region,Accommodation,micro,99,77,45,32,167,165,2
2022,3,Tabuk Region,Accommodation,medium,5,193,116,77,346,332,14
2022,3,Jazan Region,Accommodation,small,49,224,110,114,393,369,24
2022,3,Jazan Region,Accommodation,micro,268,141,72,69,444,442,2
2022,3,Jazan Region,Accommodation,medium,5,105,49,56,237,237,0
2022,3,Hail Region,Accommodation,small,26,102,77,25,180,180,0
2022,3,Hail Region,Accommodation,micro,63,51,30,21,123,123,0
2022,3,Hail Region,Accommodation,medium,1,22,15,7,52,52,0
2022,3,Aseer Region,Accommodation,small,113,419,238,181,817,804,13
2022,3,Aseer Region,Accommodation,micro,406,290,175,115,764,759,5
2022,3,Aseer Region,Accommodation,medium,7,207,124,83,369,366,3
2022,3,Makkah Region,Accommodation,small,603,2657,1614,1043,5440,5297,143
2022,3,Makkah Region,Accommodation,large,14,1878,1357,521,2643,2624,19
2022,3,Makkah Region,Accommodation,micro,1123,822,516,306,1940,1900,40
2022,3,Makkah Region,Accommodation,medium,81,3336,2280,1056,4916,4791,125
2022,3,Najran Region,Accommodation,small,26,110,45,65,256,253,3
2022,3,Najran Region,Accommodation,micro,104,45,26,19,231,230,1
2022,3,Najran Region,Accommodation,medium,1,23,8,15,36,33,3
2022,3,Eastern Province,Public Administration and Defense; Compulsory Social Security,small,20,187,118,69,170,162,8
2022,3,Eastern Province,Public Administration and Defense; Compulsory Social Security,large,2,635,500,135,155,151,4
2022,3,Eastern Province,Public Administration and Defense; Compulsory Social Security,micro,96,60,36,24,125,123,2
2022,3,Eastern Province,Public Administration and Defense; Compulsory Social Security,medium,3,168,119,49,126,121,5
2022,3,Al Bahah Region,Public Administration and Defense; Compulsory Social Security,small,2,23,10,13,18,1,17
2022,3,Al Bahah Region,Public Administration and Defense; Compulsory Social Security,micro,8,1,1,0,22,22,0
2022,3,Al Jawf Region,Public Administration and Defense; Compulsory Social Security,micro,7,3,1,2,15,14,1
2022,3,Northern Borders Region,Public Administration and Defense; Compulsory Social Security,small,1,2,1,1,5,5,0
2022,3,Northern Borders Region,Public Administration and Defense; Compulsory Social Security,micro,3,5,3,2,5,5,0
2022,3,Riyadh Region,Public Administration and Defense; Compulsory Social Security,small,48,462,236,226,455,415,40
2022,3,Riyadh Region,Public Administration and Defense; Compulsory Social Security,large,2,1231,809,422,216,207,9
2022,3,Riyadh Region,Public Administration and Defense; Compulsory Social Security,micro,229,129,65,64,373,359,14
2022,3,Riyadh Region,Public Administration and Defense; Compulsory Social Security,medium,5,376,289,87,118,109,9
2022,3,Qassim Region,Public Administration and Defense; Compulsory Social Security,small,7,69,40,29,31,31,0
2022,3,Qassim Region,Public Administration and Defense; Compulsory Social Security,micro,23,6,5,1,47,45,2
2022,3,Qassim Region,Public Administration and Defense; Compulsory Social Security,medium,1,34,11,23,18,13,5
2022,3,Al Madinah Region,Public Administration and Defense; Compulsory Social Security,small,4,25,17,8,16,15,1
2022,3,Al Madinah Region,Public Administration and Defense; Compulsory Social Security,micro,34,8,7,1,73,72,1
2022,3,Tabuk Region,Public Administration and Defense; Compulsory Social Security,small,2,19,8,11,7,6,1
2022,3,Tabuk Region,Public Administration and Defense; Compulsory Social Security,micro,15,1,0,1,39,38,1
2022,3,Tabuk Region,Public Administration and Defense; Compulsory Social Security,medium,1,38,20,18,14,14,0
2022,3,Jazan Region,Public Administration and Defense; Compulsory Social Security,small,1,3,1,2,4,1,3
2022,3,Jazan Region,Public Administration and Defense; Compulsory Social Security,micro,39,7,4,3,117,117,0
2022,3,Hail Region,Public Administration and Defense; Compulsory Social Security,micro,11,7,5,2,17,17,0
2022,3,Aseer Region,Public Administration and Defense; Compulsory Social Security,small,2,12,10,2,15,15,0
2022,3,Aseer Region,Public Administration and Defense; Compulsory Social Security,micro,23,3,0,3,58,58,0
2022,3,Makkah Region,Public Administration and Defense; Compulsory Social Security,small,46,295,176,119,308,296,12
2022,3,Makkah Region,Public Administration and Defense; Compulsory Social Security,large,1,173,106,67,78,77,1
2022,3,Makkah Region,Public Administration and Defense; Compulsory Social Security,micro,232,101,60,41,393,382,11
2022,3,Makkah Region,Public Administration and Defense; Compulsory Social Security,medium,2,316,165,151,86,82,4
2022,3,Najran Region,Public Administration and Defense; Compulsory Social Security,micro,16,5,5,0,29,29,0
2022,3,Eastern Province,Telecommunications,small,27,138,90,48,206,197,9
2022,3,Eastern Province,Telecommunications,micro,97,65,42,23,151,151,0
2022,3,Eastern Province,Telecommunications,medium,4,129,116,13,113,113,0
2022,3,Al Bahah Region,Telecommunications,small,1,3,1,2,9,9,0
2022,3,Al Bahah Region,Telecommunications,micro,3,2,2,0,5,5,0
2022,3,Al Jawf Region,Telecommunications,micro,12,7,2,5,18,18,0
2022,3,Northern Borders Region,Telecommunications,small,2,6,1,5,8,8,0
2022,3,Northern Borders Region,Telecommunications,micro,12,1,0,1,20,19,1
2022,3,Riyadh Region,Telecommunications,small,136,799,399,400,1523,1454,69
2022,3,Riyadh Region,Telecommunications,large,14,20352,15889,4463,3067,2996,71
2022,3,Riyadh Region,Telecommunications,micro,337,192,117,75,593,585,8
2022,3,Riyadh Region,Telecommunications,medium,35,2044,1387,657,1439,1410,29
2022,3,Qassim Region,Telecommunications,small,10,17,9,8,101,101,0
2022,3,Qassim Region,Telecommunications,micro,54,23,9,14,109,109,0
2022,3,Al Madinah Region,Telecommunications,small,2,14,5,9,2,2,0
2022,3,Al Madinah Region,Telecommunications,micro,32,12,5,7,56,56,0
2022,3,Tabuk Region,Telecommunications,micro,14,4,4,0,22,22,0
2022,3,Jazan Region,Telecommunications,small,1,2,2,0,4,4,0
2022,3,Jazan Region,Telecommunications,micro,19,8,6,2,27,27,0
2022,3,Hail Region,Telecommunications,small,2,1,1,0,15,15,0
2022,3,Hail Region,Telecommunications,micro,17,8,1,7,30,28,2
2022,3,Aseer Region,Telecommunications,small,4,5,1,4,20,20,0
2022,3,Aseer Region,Telecommunications,micro,42,15,12,3,65,65,0
2022,3,Makkah Region,Telecommunications,small,33,207,97,110,297,291,6
2022,3,Makkah Region,Telecommunications,micro,234,98,62,36,363,355,8
2022,3,Makkah Region,Telecommunications,medium,2,92,79,13,62,62,0
2022,3,Najran Region,Telecommunications,small,2,2,0,2,25,25,0
2022,3,Najran Region,Telecommunications,micro,12,2,1,1,23,23,0
2022,3,Eastern Province,Repair and Installation of Machinery and Equipment,small,285,1042,734,308,3082,3076,6
2022,3,Eastern Province,Repair and Installation of Machinery and Equipment,large,16,2686,2194,492,6508,6493,15
2022,3,Eastern Province,Repair and Installation of Machinery and Equipment,micro,862,338,188,150,1799,1797,2
2022,3,Eastern Province,Repair and Installation of Machinery and Equipment,medium,66,2050,1591,459,4872,4869,3
2022,3,Al Bahah Region,Repair and Installation of Machinery and Equipment,small,2,3,2,1,14,14,0
2022,3,Al Bahah Region,Repair and Installation of Machinery and Equipment,micro,47,10,7,3,70,70,0
2022,3,Al Jawf Region,Repair and Installation of Machinery and Equipment,small,6,5,4,1,46,46,0
2022,3,Al Jawf Region,Repair and Installation of Machinery and Equipment,micro,59,11,8,3,129,129,0
2022,3,Al Jawf Region,Repair and Installation of Machinery and Equipment,medium,1,42,33,9,106,106,0
2022,3,Northern Borders Region,Repair and Installation of Machinery and Equipment,small,1,2,0,2,5,5,0
2022,3,Northern Borders Region,Repair and Installation of Machinery and Equipment,micro,65,7,5,2,176,176,0
2022,3,Northern Borders Region,Repair and Installation of Machinery and Equipment,medium,2,50,46,4,216,216,0
2022,3,Riyadh Region,Repair and Installation of Machinery and Equipment,small,253,920,536,384,2978,2967,11
2022,3,Riyadh Region,Repair and Installation of Machinery and Equipment,large,16,4947,4436,511,5407,5345,62
2022,3,Riyadh Region,Repair and Installation of Machinery and Equipment,micro,1103,307,162,145,2509,2494,15
2022,3,Riyadh Region,Repair and Installation of Machinery and Equipment,medium,71,2176,1717,459,5237,5191,46
2022,3,Qassim Region,Repair and Installation of Machinery and Equipment,small,29,70,33,37,293,293,0
2022,3,Qassim Region,Repair and Installation of Machinery and Equipment,micro,221,29,17,12,521,521,0
2022,3,Qassim Region,Repair and Installation of Machinery and Equipment,medium,7,122,95,27,607,607,0
2022,3,Al Madinah Region,Repair and Installation of Machinery and Equipment,small,19,93,73,20,149,149,0
2022,3,Al Madinah Region,Repair and Installation of Machinery and Equipment,micro,281,55,31,24,584,581,3
2022,3,Al Madinah Region,Repair and Installation of Machinery and Equipment,medium,3,52,30,22,225,225,0
2022,3,Tabuk Region,Repair and Installation of Machinery and Equipment,small,3,4,2,2,22,22,0
2022,3,Tabuk Region,Repair and Installation of Machinery and Equipment,micro,130,11,8,3,271,269,2
2022,3,Tabuk Region,Repair and Installation of Machinery and Equipment,medium,1,34,34,0,21,21,0
2022,3,Jazan Region,Repair and Installation of Machinery and Equipment,small,12,10,6,4,79,79,0
2022,3,Jazan Region,Repair and Installation of Machinery and Equipment,micro,333,34,24,10,791,791,0
2022,3,Jazan Region,Repair and Installation of Machinery and Equipment,medium,1,0,0,0,144,144,0
2022,3,Hail Region,Repair and Installation of Machinery and Equipment,small,3,5,1,4,20,20,0
2022,3,Hail Region,Repair and Installation of Machinery and Equipment,micro,76,10,7,3,164,164,0
2022,3,Hail Region,Repair and Installation of Machinery and Equipment,medium,1,0,0,0,57,57,0
2022,3,Aseer Region,Repair and Installation of Machinery and Equipment,small,14,30,23,7,122,122,0
2022,3,Aseer Region,Repair and Installation of Machinery and Equipment,large,1,63,39,24,281,281,0
2022,3,Aseer Region,Repair and Installation of Machinery and Equipment,micro,207,36,22,14,441,439,2
2022,3,Aseer Region,Repair and Installation of Machinery and Equipment,medium,1,12,11,1,43,43,0
2022,3,Makkah Region,Repair and Installation of Machinery and Equipment,small,156,471,263,208,1686,1677,9
2022,3,Makkah Region,Repair and Installation of Machinery and Equipment,large,1,361,355,6,105,105,0
2022,3,Makkah Region,Repair and Installation of Machinery and Equipment,micro,962,201,101,100,2132,2127,5
2022,3,Makkah Region,Repair and Installation of Machinery and Equipment,medium,31,1310,1078,232,2289,2274,15
2022,3,Najran Region,Repair and Installation of Machinery and Equipment,small,5,7,5,2,45,45,0
2022,3,Najran Region,Repair and Installation of Machinery and Equipment,micro,49,12,5,7,121,121,0
2022,3,Eastern Province,Repair of Computers and Personal and Household Goods,small,108,184,122,62,1111,1095,16
2022,3,Eastern Province,Repair of Computers and Personal and Household Goods,large,1,0,0,0,353,353,0
2022,3,Eastern Province,Repair of Computers and Personal and Household Goods,micro,902,224,145,79,1880,1877,3
2022,3,Eastern Province,Repair of Computers and Personal and Household Goods,medium,12,415,315,100,1007,1007,0
2022,3,Al Bahah Region,Repair of Computers and Personal and Household Goods,small,2,4,2,2,17,17,0
2022,3,Al Bahah Region,Repair of Computers and Personal and Household Goods,micro,65,9,9,0,112,112,0
2022,3,Al Jawf Region,Repair of Computers and Personal and Household Goods,small,11,9,7,2,101,101,0
2022,3,Al Jawf Region,Repair of Computers and Personal and Household Goods,micro,145,17,11,6,304,304,0
2022,3,Al Jawf Region,Repair of Computers and Personal and Household Goods,medium,1,0,0,0,58,58,0
2022,3,Northern Borders Region,Repair of Computers and Personal and Household Goods,small,3,2,1,1,17,17,0
2022,3,Northern Borders Region,Repair of Computers and Personal and Household Goods,micro,74,10,7,3,163,163,0
2022,3,Riyadh Region,Repair of Computers and Personal and Household Goods,small,383,360,203,157,5859,5835,24
2022,3,Riyadh Region,Repair of Computers and Personal and Household Goods,large,34,238,103,135,19094,19090,4
2022,3,Riyadh Region,Repair of Computers and Personal and Household Goods,micro,1909,309,152,157,4356,4326,30
2022,3,Riyadh Region,Repair of Computers and Personal and Household Goods,medium,160,231,90,141,17744,17632,112
2022,3,Qassim Region,Repair of Computers and Personal and Household Goods,small,203,56,29,27,3121,3107,14
2022,3,Qassim Region,Repair of Computers and Personal and Household Goods,large,5,0,0,0,4182,4174,8
2022,3,Qassim Region,Repair of Computers and Personal and Household Goods,micro,626,89,59,30,1450,1448,2
2022,3,Qassim Region,Repair of Computers and Personal and Household Goods,medium,41,44,36,8,3806,3800,6
2022,3,Al Madinah Region,Repair of Computers and Personal and Household Goods,small,17,13,4,9,178,175,3
2022,3,Al Madinah Region,Repair of Computers and Personal and Household Goods,micro,351,68,42,26,698,693,5
2022,3,Tabuk Region,Repair of Computers and Personal and Household Goods,small,18,17,13,4,148,148,0
2022,3,Tabuk Region,Repair of Computers and Personal and Household Goods,micro,254,46,33,13,553,551,2
2022,3,Tabuk Region,Repair of Computers and Personal and Household Goods,medium,2,1,1,0,185,185,0
2022,3,Jazan Region,Repair of Computers and Personal and Household Goods,small,13,11,6,5,113,113,0
2022,3,Jazan Region,Repair of Computers and Personal and Household Goods,micro,270,52,27,25,612,609,3
2022,3,Hail Region,Repair of Computers and Personal and Household Goods,small,29,19,10,9,297,297,0
2022,3,Hail Region,Repair of Computers and Personal and Household Goods,micro,312,38,27,11,715,709,6
2022,3,Aseer Region,Repair of Computers and Personal and Household Goods,small,44,20,13,7,399,399,0
2022,3,Aseer Region,Repair of Computers and Personal and Household Goods,micro,525,85,52,33,1149,1148,1
2022,3,Makkah Region,Repair of Computers and Personal and Household Goods,small,140,278,146,132,1344,1335,9
2022,3,Makkah Region,Repair of Computers and Personal and Household Goods,micro,1391,309,180,129,3033,3002,31
2022,3,Makkah Region,Repair of Computers and Personal and Household Goods,medium,5,76,53,23,406,406,0
2022,3,Najran Region,Repair of Computers and Personal and Household Goods,small,54,12,4,8,857,856,1
2022,3,Najran Region,Repair of Computers and Personal and Household Goods,large,1,0,0,0,318,318,0
2022,3,Najran Region,Repair of Computers and Personal and Household Goods,micro,225,18,6,12,572,570,2
2022,3,Najran Region,Repair of Computers and Personal and Household Goods,medium,8,10,2,8,824,824,0
2022,3,Eastern Province,Extraction of Crude Petroleum and Natural Gas,small,17,107,77,30,187,187,0
2022,3,Eastern Province,Extraction of Crude Petroleum and Natural Gas,large,5,65943,62253,3690,7156,6570,586
2022,3,Eastern Province,Extraction of Crude Petroleum and Natural Gas,micro,30,23,19,4,41,41,0
2022,3,Eastern Province,Extraction of Crude Petroleum and Natural Gas,medium,11,765,718,47,542,537,5
2022,3,Al Jawf Region,Extraction of Crude Petroleum and Natural Gas,micro,6,2,2,0,10,10,0
2022,3,Riyadh Region,Extraction of Crude Petroleum and Natural Gas,small,9,1,1,0,138,138,0
2022,3,Riyadh Region,Extraction of Crude Petroleum and Natural Gas,micro,15,7,4,3,26,26,0
2022,3,Riyadh Region,Extraction of Crude Petroleum and Natural Gas,medium,2,51,38,13,125,125,0
2022,3,Qassim Region,Extraction of Crude Petroleum and Natural Gas,micro,1,1,0,1,4,4,0
2022,3,Al Madinah Region,Extraction of Crude Petroleum and Natural Gas,micro,1,0,0,0,2,2,0
2022,3,Al Madinah Region,Extraction of Crude Petroleum and Natural Gas,medium,1,76,76,0,34,34,0
2022,3,Jazan Region,Extraction of Crude Petroleum and Natural Gas,micro,2,2,2,0,4,4,0
2022,3,Aseer Region,Extraction of Crude Petroleum and Natural Gas,micro,3,1,0,1,4,4,0
2022,3,Makkah Region,Extraction of Crude Petroleum and Natural Gas,large,1,336,334,2,26,26,0
2022,3,Makkah Region,Extraction of Crude Petroleum and Natural Gas,micro,2,0,0,0,9,9,0
2022,3,Najran Region,Extraction of Crude Petroleum and Natural Gas,small,2,5,4,1,15,15,0
2022,3,Najran Region,Extraction of Crude Petroleum and Natural Gas,micro,6,3,3,0,12,11,1
2022,3,Eastern Province,Advertising and Market Research,small,203,908,419,489,1570,1552,18
2022,3,Eastern Province,Advertising and Market Research,large,3,652,590,62,713,710,3
2022,3,Eastern Province,Advertising and Market Research,micro,660,409,149,260,1170,1151,19
2022,3,Eastern Province,Advertising and Market Research,medium,10,477,131,346,453,446,7
2022,3,Al Bahah Region,Advertising and Market Research,small,4,21,6,15,8,8,0
2022,3,Al Bahah Region,Advertising and Market Research,micro,26,14,7,7,48,48,0
2022,3,Al Jawf Region,Advertising and Market Research,small,5,5,4,1,30,30,0
2022,3,Al Jawf Region,Advertising and Market Research,micro,80,14,9,5,184,182,2
2022,3,Northern Borders Region,Advertising and Market Research,small,4,17,8,9,34,34,0
2022,3,Northern Borders Region,Advertising and Market Research,micro,28,7,5,2,49,49,0
2022,3,Riyadh Region,Advertising and Market Research,small,596,3554,1509,2045,4555,4344,211
2022,3,Riyadh Region,Advertising and Market Research,large,8,6593,5238,1355,1297,1063,234
2022,3,Riyadh Region,Advertising and Market Research,micro,1968,1277,509,768,3174,3036,138
2022,3,Riyadh Region,Advertising and Market Research,medium,31,1173,666,507,1532,1327,205
2022,3,Qassim Region,Advertising and Market Research,small,33,110,51,59,287,286,1
2022,3,Qassim Region,Advertising and Market Research,micro,156,63,30,33,282,280,2
2022,3,Al Madinah Region,Advertising and Market Research,small,29,76,41,35,156,155,1
2022,3,Al Madinah Region,Advertising and Market Research,micro,209,95,39,56,364,354,10
2022,3,Tabuk Region,Advertising and Market Research,small,10,36,15,21,72,72,0
2022,3,Tabuk Region,Advertising and Market Research,micro,83,24,11,13,179,176,3
2022,3,Jazan Region,Advertising and Market Research,small,11,44,21,23,73,72,1
2022,3,Jazan Region,Advertising and Market Research,micro,101,26,13,13,190,190,0
2022,3,Hail Region,Advertising and Market Research,small,10,4,4,0,60,60,0
2022,3,Hail Region,Advertising and Market Research,micro,64,19,7,12,118,118,0
2022,3,Aseer Region,Advertising and Market Research,small,23,96,56,40,195,195,0
2022,3,Aseer Region,Advertising and Market Research,micro,169,81,45,36,326,326,0
2022,3,Makkah Region,Advertising and Market Research,small,348,1681,739,942,2804,2654,150
2022,3,Makkah Region,Advertising and Market Research,large,1,189,183,6,237,236,1
2022,3,Makkah Region,Advertising and Market Research,micro,1470,699,289,410,2623,2449,174
2022,3,Makkah Region,Advertising and Market Research,medium,20,811,361,450,853,773,80
2022,3,Najran Region,Advertising and Market Research,small,10,35,11,24,125,125,0
2022,3,Najran Region,Advertising and Market Research,micro,39,11,6,5,90,90,0
2022,3,Eastern Province,Unknown,small,151,295,181,114,1263,1228,35
2022,3,Eastern Province,Unknown,large,1,0,0,0,301,246,55
2022,3,Eastern Province,Unknown,micro,3704,575,340,235,6327,6289,38
2022,3,Eastern Province,Unknown,medium,4,105,73,32,333,333,0
2022,3,Al Bahah Region,Unknown,small,10,21,19,2,81,81,0
2022,3,Al Bahah Region,Unknown,micro,616,95,67,28,879,871,8
2022,3,Al Jawf Region,Unknown,small,23,32,11,21,190,188,2
2022,3,Al Jawf Region,Unknown,micro,1338,81,59,22,2213,2195,18
2022,3,Al Jawf Region,Unknown,medium,1,60,40,20,0,0,0
2022,3,Northern Borders Region,Unknown,small,17,28,17,11,120,120,0
2022,3,Northern Borders Region,Unknown,micro,467,63,41,22,776,769,7
2022,3,Riyadh Region,Unknown,small,791,1116,549,567,6874,6785,89
2022,3,Riyadh Region,Unknown,large,5,2081,1271,810,943,920,23
2022,3,Riyadh Region,Unknown,micro,59600,3741,1857,1884,133177,132159,1018
2022,3,Riyadh Region,Unknown,medium,17,259,152,107,1337,1292,45
2022,3,Qassim Region,Unknown,small,48,66,47,19,433,432,1
2022,3,Qassim Region,Unknown,micro,2097,141,79,62,4254,4223,31
2022,3,Qassim Region,Unknown,medium,2,34,17,17,128,79,49
2022,3,Al Madinah Region,Unknown,small,91,174,92,82,701,690,11
2022,3,Al Madinah Region,Unknown,micro,3439,366,228,138,5597,5497,100
2022,3,Tabuk Region,Unknown,small,37,58,42,16,313,313,0
2022,3,Tabuk Region,Unknown,micro,1242,127,77,50,1939,1928,11
2022,3,Tabuk Region,Unknown,medium,1,0,0,0,62,33,29
2022,3,Jazan Region,Unknown,small,47,63,38,25,359,355,4
2022,3,Jazan Region,Unknown,micro,2648,216,129,87,4341,4293,48
2022,3,Jazan Region,Unknown,medium,1,6,4,2,119,119,0
2022,3,Hail Region,Unknown,small,32,40,26,14,314,314,0
2022,3,Hail Region,Unknown,micro,2984,190,94,96,6235,6211,24
2022,3,Hail Region,Unknown,medium,1,0,0,0,100,54,46
2022,3,Aseer Region,Unknown,small,80,122,94,28,599,584,15
2022,3,Aseer Region,Unknown,micro,4270,537,360,177,6150,6118,32
2022,3,Aseer Region,Unknown,medium,1,3,3,0,198,198,0
2022,3,Makkah Region,Unknown,small,401,625,350,275,3332,3276,56
2022,3,Makkah Region,Unknown,large,1,45,28,17,418,418,0
2022,3,Makkah Region,Unknown,micro,10971,1379,732,647,17802,17267,535
2022,3,Makkah Region,Unknown,medium,9,220,169,51,623,546,77
2022,3,Najran Region,Unknown,small,43,22,13,9,352,352,0
2022,3,Najran Region,Unknown,micro,2935,180,82,98,6218,6186,32
2022,3,Najran Region,Unknown,medium,1,9,6,3,51,51,0
2022,4,Eastern Province,"Travel Agencies, Tour Operators, Reservation Services, and Related Activities",small,54,340,170,170,570,563,7
2022,4,Eastern Province,"Travel Agencies, Tour Operators, Reservation Services, and Related Activities",large,1,227,212,15,209,208,1
2022,4,Eastern Province,"Travel Agencies, Tour Operators, Reservation Services, and Related Activities",micro,186,136,66,70,280,279,1
2022,4,Eastern Province,"Travel Agencies, Tour Operators, Reservation Services, and Related Activities",medium,4,177,89,88,242,241,1
2022,4,Al Bahah Region,"Travel Agencies, Tour Operators, Reservation Services, and Related Activities",micro,5,1,1,0,9,9,0
2022,4,Al Jawf Region,"Travel Agencies, Tour Operators, Reservation Services, and Related Activities",small,2,11,7,4,18,18,0
2022,4,Al Jawf Region,"Travel Agencies, Tour Operators, Reservation Services, and Related Activities",micro,16,6,2,4,29,29,0
2022,4,Northern Borders Region,"Travel Agencies, Tour Operators, Reservation Services, and Related Activities",small,1,4,4,0,14,14,0
2022,4,Northern Borders Region,"Travel Agencies, Tour Operators, Reservation Services, and Related Activities",micro,13,2,2,0,27,26,1
2022,4,Riyadh Region,"Travel Agencies, Tour Operators, Reservation Services, and Related Activities",small,153,915,380,535,1297,1266,31
2022,4,Riyadh Region,"Travel Agencies, Tour Operators, Reservation Services, and Related Activities",large,3,523,350,173,631,602,29
2022,4,Riyadh Region,"Travel Agencies, Tour Operators, Reservation Services, and Related Activities",micro,399,242,109,133,691,673,18
2022,4,Riyadh Region,"Travel Agencies, Tour Operators, Reservation Services, and Related Activities",medium,16,643,380,263,984,976,8
2022,4,Qassim Region,"Travel Agencies, Tour Operators, Reservation Services, and Related Activities",small,11,32,12,20,85,82,3
2022,4,Qassim Region,"Travel Agencies, Tour Operators, Reservation Services, and Related Activities",micro,80,25,11,14,173,172,1
2022,4,Al Madinah Region,"Travel Agencies, Tour Operators, Reservation Services, and Related Activities",small,28,138,81,57,287,282,5
2022,4,Al Madinah Region,"Travel Agencies, Tour Operators, Reservation Services, and Related Activities",micro,128,81,45,36,211,205,6
2022,4,Tabuk Region,"Travel Agencies, Tour Operators, Reservation Services, and Related Activities",small,7,26,16,10,70,70,0
2022,4,Tabuk Region,"Travel Agencies, Tour Operators, Reservation Services, and Related Activities",micro,37,14,5,9,63,61,2
2022,4,Jazan Region,"Travel Agencies, Tour Operators, Reservation Services, and Related Activities",small,2,10,3,7,18,18,0
2022,4,Jazan Region,"Travel Agencies, Tour Operators, Reservation Services, and Related Activities",micro,24,15,6,9,40,40,0
2022,4,Hail Region,"Travel Agencies, Tour Operators, Reservation Services, and Related Activities",small,7,30,10,20,65,63,2
2022,4,Hail Region,"Travel Agencies, Tour Operators, Reservation Services, and Related Activities",micro,19,11,7,4,41,41,0
2022,4,Aseer Region,"Travel Agencies, Tour Operators, Reservation Services, and Related Activities",small,3,14,7,7,23,23,0
2022,4,Aseer Region,"Travel Agencies, Tour Operators, Reservation Services, and Related Activities",micro,58,30,20,10,102,102,0
2022,4,Makkah Region,"Travel Agencies, Tour Operators, Reservation Services, and Related Activities",small,200,811,479,332,1551,1518,33
2022,4,Makkah Region,"Travel Agencies, Tour Operators, Reservation Services, and Related Activities",large,3,3950,3104,846,1443,1442,1
2022,4,Makkah Region,"Travel Agencies, Tour Operators, Reservation Services, and Related Activities",micro,688,477,296,181,1162,1138,24
2022,4,Makkah Region,"Travel Agencies, Tour Operators, Reservation Services, and Related Activities",medium,12,347,220,127,561,560,1
2022,4,Najran Region,"Travel Agencies, Tour Operators, Reservation Services, and Related Activities",small,3,10,2,8,25,25,0
2022,4,Najran Region,"Travel Agencies, Tour Operators, Reservation Services, and Related Activities",micro,13,8,5,3,29,29,0
2022,4,Eastern Province,Fishing and Aquaculture,small,138,98,37,61,1284,1283,1
2022,4,Eastern Province,Fishing and Aquaculture,micro,1681,197,92,105,4516,4511,5
2022,4,Al Bahah Region,Fishing and Aquaculture,small,1,0,0,0,7,7,0
2022,4,Al Bahah Region,Fishing and Aquaculture,micro,114,15,12,3,292,292,0
2022,4,Al Jawf Region,Fishing and Aquaculture,small,2,1,1,0,13,13,0
2022,4,Al Jawf Region,Fishing and Aquaculture,micro,495,30,19,11,998,993,5
2022,4,Northern Borders Region,Fishing and Aquaculture,small,1,5,1,4,15,15,0
2022,4,Northern Borders Region,Fishing and Aquaculture,micro,166,17,10,7,411,411,0
2022,4,Riyadh Region,Fishing and Aquaculture,small,562,512,214,298,4000,3990,10
2022,4,Riyadh Region,Fishing and Aquaculture,micro,83570,9317,4535,4782,230108,228800,1308
2022,4,Qassim Region,Fishing and Aquaculture,small,16,5,1,4,135,135,0
2022,4,Qassim Region,Fishing and Aquaculture,micro,2162,197,106,91,6122,6110,12
2022,4,Qassim Region,Fishing and Aquaculture,medium,1,0,0,0,50,50,0
2022,4,Al Madinah Region,Fishing and Aquaculture,small,27,16,8,8,259,259,0
2022,4,Al Madinah Region,Fishing and Aquaculture,micro,925,98,53,45,2244,2190,54
2022,4,Tabuk Region,Fishing and Aquaculture,small,21,7,2,5,220,220,0
2022,4,Tabuk Region,Fishing and Aquaculture,micro,382,36,21,15,905,903,2
2022,4,Jazan Region,Fishing and Aquaculture,small,56,71,39,32,656,654,2
2022,4,Jazan Region,Fishing and Aquaculture,micro,792,64,29,35,1810,1794,16
2022,4,Jazan Region,Fishing and Aquaculture,medium,4,73,61,12,335,334,1
2022,4,Hail Region,Fishing and Aquaculture,small,17,3,3,0,110,110,0
2022,4,Hail Region,Fishing and Aquaculture,micro,3956,326,182,144,10716,10692,24
2022,4,Aseer Region,Fishing and Aquaculture,small,27,33,22,11,236,236,0
2022,4,Aseer Region,Fishing and Aquaculture,micro,888,73,38,35,1851,1845,6
2022,4,Aseer Region,Fishing and Aquaculture,medium,1,6,2,4,46,46,0
2022,4,Makkah Region,Fishing and Aquaculture,small,97,61,27,34,779,777,2
2022,4,Makkah Region,Fishing and Aquaculture,large,1,276,253,23,2009,2006,3
2022,4,Makkah Region,Fishing and Aquaculture,micro,5162,565,292,273,12133,11712,421
2022,4,Makkah Region,Fishing and Aquaculture,medium,2,38,36,2,249,249,0
2022,4,Najran Region,Fishing and Aquaculture,small,26,16,6,10,170,170,0
2022,4,Najran Region,Fishing and Aquaculture,micro,1867,159,89,70,5186,5176,10
2022,4,Eastern Province,Manufacture of Shaped Metal Products (Except Machinery and Equipment),small,674,1938,1131,807,7710,7698,12
2022,4,Eastern Province,Manufacture of Shaped Metal Products (Except Machinery and Equipment),large,20,6503,6229,274,6491,6480,11
2022,4,Eastern Province,Manufacture of Shaped Metal Products (Except Machinery and Equipment),micro,1509,474,265,209,3383,3381,2
2022,4,Eastern Province,Manufacture of Shaped Metal Products (Except Machinery and Equipment),medium,112,3145,2286,859,8583,8575,8
2022,4,Al Bahah Region,Manufacture of Shaped Metal Products (Except Machinery and Equipment),small,22,20,13,7,130,130,0
2022,4,Al Bahah Region,Manufacture of Shaped Metal Products (Except Machinery and Equipment),micro,317,59,38,21,641,641,0
2022,4,Al Jawf Region,Manufacture of Shaped Metal Products (Except Machinery and Equipment),small,27,39,29,10,251,251,0
2022,4,Al Jawf Region,Manufacture of Shaped Metal Products (Except Machinery and Equipment),micro,302,39,26,13,688,687,1
2022,4,Northern Borders Region,Manufacture of Shaped Metal Products (Except Machinery and Equipment),small,17,35,20,15,220,220,0
2022,4,Northern Borders Region,Manufacture of Shaped Metal Products (Except Machinery and Equipment),micro,119,21,8,13,303,300,3
2022,4,Riyadh Region,Manufacture of Shaped Metal Products (Except Machinery and Equipment),small,987,2937,1284,1653,12502,12449,53
2022,4,Riyadh Region,Manufacture of Shaped Metal Products (Except Machinery and Equipment),large,17,2236,1438,798,5678,5671,7
2022,4,Riyadh Region,Manufacture of Shaped Metal Products (Except Machinery and Equipment),micro,2635,628,282,346,5995,5971,24
2022,4,Riyadh Region,Manufacture of Shaped Metal Products (Except Machinery and Equipment),medium,161,3520,1867,1653,12014,11990,24
2022,4,Qassim Region,Manufacture of Shaped Metal Products (Except Machinery and Equipment),small,176,359,197,162,1580,1578,2
2022,4,Qassim Region,Manufacture of Shaped Metal Products (Except Machinery and Equipment),large,1,124,102,22,378,378,0
2022,4,Qassim Region,Manufacture of Shaped Metal Products (Except Machinery and Equipment),micro,1256,204,121,83,2915,2911,4
2022,4,Qassim Region,Manufacture of Shaped Metal Products (Except Machinery and Equipment),medium,9,144,86,58,617,616,1
2022,4,Al Madinah Region,Manufacture of Shaped Metal Products (Except Machinery and Equipment),small,94,173,86,87,926,925,1
2022,4,Al Madinah Region,Manufacture of Shaped Metal Products (Except Machinery and Equipment),micro,660,123,72,51,1499,1497,2
2022,4,Al Madinah Region,Manufacture of Shaped Metal Products (Except Machinery and Equipment),medium,8,284,203,81,752,751,1
2022,4,Tabuk Region,Manufacture of Shaped Metal Products (Except Machinery and Equipment),small,33,74,45,29,394,392,2
2022,4,Tabuk Region,Manufacture of Shaped Metal Products (Except Machinery and Equipment),micro,226,50,29,21,546,545,1
2022,4,Tabuk Region,Manufacture of Shaped Metal Products (Except Machinery and Equipment),medium,1,26,17,9,84,84,0
2022,4,Jazan Region,Manufacture of Shaped Metal Products (Except Machinery and Equipment),small,51,89,58,31,416,415,1
2022,4,Jazan Region,Manufacture of Shaped Metal Products (Except Machinery and Equipment),micro,841,89,52,37,2012,2009,3
2022,4,Jazan Region,Manufacture of Shaped Metal Products (Except Machinery and Equipment),medium,1,16,5,11,36,36,0
2022,4,Hail Region,Manufacture of Shaped Metal Products (Except Machinery and Equipment),small,58,156,84,72,613,613,0
2022,4,Hail Region,Manufacture of Shaped Metal Products (Except Machinery and Equipment),micro,245,51,20,31,525,522,3
2022,4,Hail Region,Manufacture of Shaped Metal Products (Except Machinery and Equipment),medium,1,9,4,5,58,58,0
2022,4,Aseer Region,Manufacture of Shaped Metal Products (Except Machinery and Equipment),small,93,199,121,78,949,949,0
2022,4,Aseer Region,Manufacture of Shaped Metal Products (Except Machinery and Equipment),micro,1107,182,100,82,2513,2513,0
2022,4,Aseer Region,Manufacture of Shaped Metal Products (Except Machinery and Equipment),medium,7,109,58,51,464,464,0
2022,4,Makkah Region,Manufacture of Shaped Metal Products (Except Machinery and Equipment),small,364,984,505,479,4307,4277,30
2022,4,Makkah Region,Manufacture of Shaped Metal Products (Except Machinery and Equipment),large,8,857,603,254,2288,2283,5
2022,4,Makkah Region,Manufacture of Shaped Metal Products (Except Machinery and Equipment),micro,2186,346,186,160,5000,4986,14
2022,4,Makkah Region,Manufacture of Shaped Metal Products (Except Machinery and Equipment),medium,77,2109,1532,577,6651,6629,22
2022,4,Najran Region,Manufacture of Shaped Metal Products (Except Machinery and Equipment),small,16,16,6,10,115,115,0
2022,4,Najran Region,Manufacture of Shaped Metal Products (Except Machinery and Equipment),micro,347,45,23,22,841,840,1
2022,4,Najran Region,Manufacture of Shaped Metal Products (Except Machinery and Equipment),medium,1,7,3,4,44,44,0
2022,4,Eastern Province,Manufacture of Other Non-Metallic Mineral Products,small,305,1097,655,442,4946,4942,4
2022,4,Eastern Province,Manufacture of Other Non-Metallic Mineral Products,large,16,2109,1711,398,5327,5324,3
2022,4,Eastern Province,Manufacture of Other Non-Metallic Mineral Products,micro,361,125,76,49,882,879,3
2022,4,Eastern Province,Manufacture of Other Non-Metallic Mineral Products,medium,136,2885,1836,1049,10406,10344,62
2022,4,Al Bahah Region,Manufacture of Other Non-Metallic Mineral Products,small,29,116,81,35,503,503,0
2022,4,Al Bahah Region,Manufacture of Other Non-Metallic Mineral Products,micro,40,7,7,0,74,74,0
2022,4,Al Bahah Region,Manufacture of Other Non-Metallic Mineral Products,medium,8,122,72,50,476,472,4
2022,4,Al Jawf Region,Manufacture of Other Non-Metallic Mineral Products,small,32,110,74,36,514,512,2
2022,4,Al Jawf Region,Manufacture of Other Non-Metallic Mineral Products,micro,42,3,2,1,96,95,1
2022,4,Al Jawf Region,Manufacture of Other Non-Metallic Mineral Products,medium,13,253,178,75,1039,1038,1
2022,4,Northern Borders Region,Manufacture of Other Non-Metallic Mineral Products,small,22,57,33,24,322,322,0
2022,4,Northern Borders Region,Manufacture of Other Non-Metallic Mineral Products,large,1,220,218,2,184,184,0
2022,4,Northern Borders Region,Manufacture of Other Non-Metallic Mineral Products,micro,36,13,10,3,79,79,0
2022,4,Northern Borders Region,Manufacture of Other Non-Metallic Mineral Products,medium,4,89,50,39,277,277,0
2022,4,Riyadh Region,Manufacture of Other Non-Metallic Mineral Products,small,1358,2041,937,1104,22928,22851,77
2022,4,Riyadh Region,Manufacture of Other Non-Metallic Mineral Products,large,37,4942,3422,1520,12023,12005,18
2022,4,Riyadh Region,Manufacture of Other Non-Metallic Mineral Products,micro,1744,324,154,170,4484,4453,31
2022,4,Riyadh Region,Manufacture of Other Non-Metallic Mineral Products,medium,433,4642,2427,2215,32554,32460,94
2022,4,Qassim Region,Manufacture of Other Non-Metallic Mineral Products,small,168,353,197,156,2754,2750,4
2022,4,Qassim Region,Manufacture of Other Non-Metallic Mineral Products,large,8,872,720,152,2600,2599,1
2022,4,Qassim Region,Manufacture of Other Non-Metallic Mineral Products,micro,272,67,43,24,717,716,1
2022,4,Qassim Region,Manufacture of Other Non-Metallic Mineral Products,medium,49,855,508,347,3561,3561,0
2022,4,Al Madinah Region,Manufacture of Other Non-Metallic Mineral Products,small,107,250,165,85,1416,1405,11
2022,4,Al Madinah Region,Manufacture of Other Non-Metallic Mineral Products,large,7,1079,739,340,2337,2335,2
2022,4,Al Madinah Region,Manufacture of Other Non-Metallic Mineral Products,micro,164,35,27,8,406,405,1
2022,4,Al Madinah Region,Manufacture of Other Non-Metallic Mineral Products,medium,44,942,683,259,3904,3902,2
2022,4,Tabuk Region,Manufacture of Other Non-Metallic Mineral Products,small,28,108,66,42,363,363,0
2022,4,Tabuk Region,Manufacture of Other Non-Metallic Mineral Products,large,2,368,345,23,533,533,0
2022,4,Tabuk Region,Manufacture of Other Non-Metallic Mineral Products,micro,52,12,5,7,125,124,1
2022,4,Tabuk Region,Manufacture of Other Non-Metallic Mineral Products,medium,8,198,129,69,686,686,0
2022,4,Jazan Region,Manufacture of Other Non-Metallic Mineral Products,small,76,217,135,82,1149,1147,2
2022,4,Jazan Region,Manufacture of Other Non-Metallic Mineral Products,large,2,419,414,5,347,347,0
2022,4,Jazan Region,Manufacture of Other Non-Metallic Mineral Products,micro,137,26,17,9,356,355,1
2022,4,Jazan Region,Manufacture of Other Non-Metallic Mineral Products,medium,30,577,357,220,1887,1887,0
2022,4,Hail Region,Manufacture of Other Non-Metallic Mineral Products,small,51,65,38,27,602,600,2
2022,4,Hail Region,Manufacture of Other Non-Metallic Mineral Products,large,1,258,258,0,166,166,0
2022,4,Hail Region,Manufacture of Other Non-Metallic Mineral Products,micro,127,25,14,11,317,317,0
2022,4,Hail Region,Manufacture of Other Non-Metallic Mineral Products,medium,11,193,119,74,996,996,0
2022,4,Aseer Region,Manufacture of Other Non-Metallic Mineral Products,small,174,462,289,173,2407,2403,4
2022,4,Aseer Region,Manufacture of Other Non-Metallic Mineral Products,large,6,937,801,136,1657,1655,2
2022,4,Aseer Region,Manufacture of Other Non-Metallic Mineral Products,micro,279,60,26,34,699,693,6
2022,4,Aseer Region,Manufacture of Other Non-Metallic Mineral Products,medium,48,955,598,357,3560,3560,0
2022,4,Makkah Region,Manufacture of Other Non-Metallic Mineral Products,small,273,736,375,361,3828,3813,15
2022,4,Makkah Region,Manufacture of Other Non-Metallic Mineral Products,large,15,2917,1963,954,5970,5963,7
2022,4,Makkah Region,Manufacture of Other Non-Metallic Mineral Products,micro,497,152,95,57,1182,1172,10
2022,4,Makkah Region,Manufacture of Other Non-Metallic Mineral Products,medium,103,2255,1399,856,7920,7912,8
2022,4,Najran Region,Manufacture of Other Non-Metallic Mineral Products,small,36,110,57,53,537,537,0
2022,4,Najran Region,Manufacture of Other Non-Metallic Mineral Products,large,1,337,317,20,398,398,0
2022,4,Najran Region,Manufacture of Other Non-Metallic Mineral Products,micro,81,10,5,5,209,208,1
2022,4,Najran Region,Manufacture of Other Non-Metallic Mineral Products,medium,25,426,245,181,1900,1895,5
2022,4,Eastern Province,Manufacture of Rubber and Plastic Products,small,63,253,159,94,973,972,1
2022,4,Eastern Province,Manufacture of Rubber and Plastic Products,large,3,406,391,15,866,866,0
2022,4,Eastern Province,Manufacture of Rubber and Plastic Products,micro,49,32,14,18,91,91,0
2022,4,Eastern Province,Manufacture of Rubber and Plastic Products,medium,35,1011,759,252,2588,2582,6
2022,4,Al Bahah Region,Manufacture of Rubber and Plastic Products,micro,1,0,0,0,1,1,0
2022,4,Al Jawf Region,Manufacture of Rubber and Plastic Products,small,2,10,7,3,33,33,0
2022,4,Al Jawf Region,Manufacture of Rubber and Plastic Products,large,1,120,85,35,382,382,0
2022,4,Al Jawf Region,Manufacture of Rubber and Plastic Products,micro,13,3,2,1,35,35,0
2022,4,Northern Borders Region,Manufacture of Rubber and Plastic Products,small,1,3,1,2,6,6,0
2022,4,Riyadh Region,Manufacture of Rubber and Plastic Products,small,138,650,286,364,2603,2591,12
2022,4,Riyadh Region,Manufacture of Rubber and Plastic Products,large,11,976,484,492,3415,3409,6
2022,4,Riyadh Region,Manufacture of Rubber and Plastic Products,micro,188,59,31,28,457,448,9
2022,4,Riyadh Region,Manufacture of Rubber and Plastic Products,medium,85,2185,1188,997,7503,7489,14
2022,4,Qassim Region,Manufacture of Rubber and Plastic Products,small,5,15,4,11,57,57,0
2022,4,Qassim Region,Manufacture of Rubber and Plastic Products,micro,11,5,0,5,15,15,0
2022,4,Qassim Region,Manufacture of Rubber and Plastic Products,medium,9,247,161,86,622,621,1
2022,4,Al Madinah Region,Manufacture of Rubber and Plastic Products,small,23,120,64,56,473,473,0
2022,4,Al Madinah Region,Manufacture of Rubber and Plastic Products,large,1,127,63,64,340,340,0
2022,4,Al Madinah Region,Manufacture of Rubber and Plastic Products,micro,21,14,8,6,28,28,0
2022,4,Al Madinah Region,Manufacture of Rubber and Plastic Products,medium,8,232,146,86,693,688,5
2022,4,Tabuk Region,Manufacture of Rubber and Plastic Products,small,7,28,15,13,100,100,0
2022,4,Tabuk Region,Manufacture of Rubber and Plastic Products,micro,4,2,0,2,12,12,0
2022,4,Tabuk Region,Manufacture of Rubber and Plastic Products,medium,1,18,10,8,79,79,0
2022,4,Jazan Region,Manufacture of Rubber and Plastic Products,small,1,2,1,1,9,9,0
2022,4,Jazan Region,Manufacture of Rubber and Plastic Products,micro,6,3,3,0,21,21,0
2022,4,Hail Region,Manufacture of Rubber and Plastic Products,small,3,15,7,8,56,56,0
2022,4,Hail Region,Manufacture of Rubber and Plastic Products,micro,6,0,0,0,13,13,0
2022,4,Hail Region,Manufacture of Rubber and Plastic Products,medium,2,104,80,24,144,144,0
2022,4,Aseer Region,Manufacture of Rubber and Plastic Products,small,5,12,7,5,62,62,0
2022,4,Aseer Region,Manufacture of Rubber and Plastic Products,micro,26,10,6,4,49,49,0
2022,4,Aseer Region,Manufacture of Rubber and Plastic Products,medium,4,62,36,26,235,235,0
2022,4,Makkah Region,Manufacture of Rubber and Plastic Products,small,84,400,215,185,1519,1507,12
2022,4,Makkah Region,Manufacture of Rubber and Plastic Products,large,11,1251,943,308,2986,2971,15
2022,4,Makkah Region,Manufacture of Rubber and Plastic Products,micro,67,30,19,11,140,139,1
2022,4,Makkah Region,Manufacture of Rubber and Plastic Products,medium,35,884,480,404,3162,3159,3
2022,4,Najran Region,Manufacture of Rubber and Plastic Products,small,3,19,10,9,68,68,0
2022,4,Najran Region,Manufacture of Rubber and Plastic Products,micro,10,1,0,1,28,28,0
2022,4,Najran Region,Manufacture of Rubber and Plastic Products,medium,3,55,22,33,243,243,0
2022,4,Eastern Province,Manufacture of Coke and Refined Petroleum Products,small,27,140,88,52,526,526,0
2022,4,Eastern Province,Manufacture of Coke and Refined Petroleum Products,large,7,3573,3518,55,1597,1596,1
2022,4,Eastern Province,Manufacture of Coke and Refined Petroleum Products,micro,11,9,5,4,18,18,0
2022,4,Eastern Province,Manufacture of Coke and Refined Petroleum Products,medium,8,577,549,28,665,665,0
2022,4,Riyadh Region,Manufacture of Coke and Refined Petroleum Products,small,31,172,104,68,408,405,3
2022,4,Riyadh Region,Manufacture of Coke and Refined Petroleum Products,micro,42,36,21,15,73,72,1
2022,4,Riyadh Region,Manufacture of Coke and Refined Petroleum Products,medium,5,161,116,45,351,351,0
2022,4,Qassim Region,Manufacture of Coke and Refined Petroleum Products,small,4,26,23,3,79,79,0
2022,4,Qassim Region,Manufacture of Coke and Refined Petroleum Products,micro,3,1,1,0,8,8,0
2022,4,Al Madinah Region,Manufacture of Coke and Refined Petroleum Products,small,2,17,17,0,31,31,0
2022,4,Al Madinah Region,Manufacture of Coke and Refined Petroleum Products,large,4,2059,1992,67,502,502,0
2022,4,Al Madinah Region,Manufacture of Coke and Refined Petroleum Products,micro,5,5,4,1,9,9,0
2022,4,Al Madinah Region,Manufacture of Coke and Refined Petroleum Products,medium,4,200,196,4,465,465,0
2022,4,Tabuk Region,Manufacture of Coke and Refined Petroleum Products,micro,1,1,1,0,4,4,0
2022,4,Jazan Region,Manufacture of Coke and Refined Petroleum Products,large,1,224,218,6,54,50,4
2022,4,Jazan Region,Manufacture of Coke and Refined Petroleum Products,micro,2,1,1,0,3,3,0
2022,4,Hail Region,Manufacture of Coke and Refined Petroleum Products,micro,1,0,0,0,3,3,0
2022,4,Aseer Region,Manufacture of Coke and Refined Petroleum Products,small,1,5,2,3,16,16,0
2022,4,Aseer Region,Manufacture of Coke and Refined Petroleum Products,medium,1,16,9,7,47,47,0
2022,4,Makkah Region,Manufacture of Coke and Refined Petroleum Products,small,19,91,52,39,276,273,3
2022,4,Makkah Region,Manufacture of Coke and Refined Petroleum Products,large,3,2722,2637,85,1346,1334,12
2022,4,Makkah Region,Manufacture of Coke and Refined Petroleum Products,micro,17,9,9,0,28,28,0
2022,4,Makkah Region,Manufacture of Coke and Refined Petroleum Products,medium,3,124,120,4,94,94,0
2022,4,Eastern Province,Manufacture of Paper and Paper Products,small,48,262,126,136,941,938,3
2022,4,Eastern Province,Manufacture of Paper and Paper Products,large,7,716,552,164,1760,1756,4
2022,4,Eastern Province,Manufacture of Paper and Paper Products,micro,51,31,13,18,101,100,1
2022,4,Eastern Province,Manufacture of Paper and Paper Products,medium,22,647,446,201,1751,1747,4
2022,4,Al Jawf Region,Manufacture of Paper and Paper Products,small,1,2,2,0,9,9,0
2022,4,Al Jawf Region,Manufacture of Paper and Paper Products,micro,2,0,0,0,6,6,0
2022,4,Northern Borders Region,Manufacture of Paper and Paper Products,small,2,2,1,1,20,20,0
2022,4,Northern Borders Region,Manufacture of Paper and Paper Products,micro,1,0,0,0,1,1,0
2022,4,Riyadh Region,Manufacture of Paper and Paper Products,small,102,403,152,251,1599,1590,9
2022,4,Riyadh Region,Manufacture of Paper and Paper Products,large,1,67,21,46,203,203,0
2022,4,Riyadh Region,Manufacture of Paper and Paper Products,micro,118,80,33,47,267,266,1
2022,4,Riyadh Region,Manufacture of Paper and Paper Products,medium,46,1182,648,534,3779,3760,19
2022,4,Qassim Region,Manufacture of Paper and Paper Products,small,9,23,13,10,171,170,1
2022,4,Qassim Region,Manufacture of Paper and Paper Products,micro,23,6,1,5,52,52,0
2022,4,Qassim Region,Manufacture of Paper and Paper Products,medium,5,107,73,34,407,407,0
2022,4,Al Madinah Region,Manufacture of Paper and Paper Products,small,14,48,28,20,193,191,2
2022,4,Al Madinah Region,Manufacture of Paper and Paper Products,micro,13,3,1,2,19,19,0
2022,4,Al Madinah Region,Manufacture of Paper and Paper Products,medium,2,41,28,13,110,110,0
2022,4,Tabuk Region,Manufacture of Paper and Paper Products,small,4,13,7,6,68,68,0
2022,4,Tabuk Region,Manufacture of Paper and Paper Products,micro,3,0,0,0,7,7,0
2022,4,Tabuk Region,Manufacture of Paper and Paper Products,medium,1,12,4,8,38,38,0
2022,4,Jazan Region,Manufacture of Paper and Paper Products,small,2,3,2,1,12,12,0
2022,4,Jazan Region,Manufacture of Paper and Paper Products,micro,6,3,2,1,16,16,0
2022,4,Jazan Region,Manufacture of Paper and Paper Products,medium,1,18,8,10,73,73,0
2022,4,Hail Region,Manufacture of Paper and Paper Products,small,5,10,2,8,67,67,0
2022,4,Hail Region,Manufacture of Paper and Paper Products,micro,4,0,0,0,13,13,0
2022,4,Aseer Region,Manufacture of Paper and Paper Products,small,11,29,15,14,112,112,0
2022,4,Aseer Region,Manufacture of Paper and Paper Products,micro,9,3,2,1,25,25,0
2022,4,Aseer Region,Manufacture of Paper and Paper Products,medium,2,45,35,10,116,116,0
2022,4,Makkah Region,Manufacture of Paper and Paper Products,small,77,294,173,121,1133,1129,4
2022,4,Makkah Region,Manufacture of Paper and Paper Products,large,4,668,517,151,1417,1407,10
2022,4,Makkah Region,Manufacture of Paper and Paper Products,micro,55,20,11,9,124,117,7
2022,4,Makkah Region,Manufacture of Paper and Paper Products,medium,28,822,428,394,2140,2128,12
2022,4,Najran Region,Manufacture of Paper and Paper Products,small,5,5,3,2,60,60,0
2022,4,Najran Region,Manufacture of Paper and Paper Products,micro,18,3,1,2,38,38,0
2022,4,Eastern Province,Manufacture of Chemicals and Chemical Products,small,189,1081,742,339,2987,2971,16
2022,4,Eastern Province,Manufacture of Chemicals and Chemical Products,large,16,10961,10814,147,2525,2525,0
2022,4,Eastern Province,Manufacture of Chemicals and Chemical Products,micro,131,78,48,30,240,239,1
2022,4,Eastern Province,Manufacture of Chemicals and Chemical Products,medium,95,3765,3230,535,6118,6111,7
2022,4,Al Bahah Region,Manufacture of Chemicals and Chemical Products,small,4,7,6,1,28,28,0
2022,4,Al Bahah Region,Manufacture of Chemicals and Chemical Products,micro,4,0,0,0,11,11,0
2022,4,Al Bahah Region,Manufacture of Chemicals and Chemical Products,medium,1,15,4,11,50,50,0
2022,4,Al Jawf Region,Manufacture of Chemicals and Chemical Products,small,1,3,1,2,5,5,0
2022,4,Al Jawf Region,Manufacture of Chemicals and Chemical Products,micro,8,1,1,0,16,16,0
2022,4,Northern Borders Region,Manufacture of Chemicals and Chemical Products,small,3,16,16,0,14,14,0
2022,4,Northern Borders Region,Manufacture of Chemicals and Chemical Products,large,1,628,614,14,217,217,0
2022,4,Northern Borders Region,Manufacture of Chemicals and Chemical Products,micro,7,2,2,0,7,7,0
2022,4,Riyadh Region,Manufacture of Chemicals and Chemical Products,small,419,1740,779,961,6581,6556,25
2022,4,Riyadh Region,Manufacture of Chemicals and Chemical Products,large,15,3323,2293,1030,4126,4112,14
2022,4,Riyadh Region,Manufacture of Chemicals and Chemical Products,micro,480,221,105,116,985,971,14
2022,4,Riyadh Region,Manufacture of Chemicals and Chemical Products,medium,106,2529,1340,1189,7431,7411,20
2022,4,Qassim Region,Manufacture of Chemicals and Chemical Products,small,21,62,36,26,235,235,0
2022,4,Qassim Region,Manufacture of Chemicals and Chemical Products,large,2,448,424,24,1400,1399,1
2022,4,Qassim Region,Manufacture of Chemicals and Chemical Products,micro,28,9,4,5,54,54,0
2022,4,Qassim Region,Manufacture of Chemicals and Chemical Products,medium,8,185,112,73,609,609,0
2022,4,Al Madinah Region,Manufacture of Chemicals and Chemical Products,small,35,198,145,53,503,502,1
2022,4,Al Madinah Region,Manufacture of Chemicals and Chemical Products,large,5,2836,2817,19,661,661,0
2022,4,Al Madinah Region,Manufacture of Chemicals and Chemical Products,micro,36,15,6,9,61,58,3
2022,4,Al Madinah Region,Manufacture of Chemicals and Chemical Products,medium,12,372,335,37,705,704,1
2022,4,Tabuk Region,Manufacture of Chemicals and Chemical Products,small,11,54,36,18,200,198,2
2022,4,Tabuk Region,Manufacture of Chemicals and Chemical Products,large,1,379,222,157,507,506,1
2022,4,Tabuk Region,Manufacture of Chemicals and Chemical Products,micro,17,3,2,1,34,34,0
2022,4,Jazan Region,Manufacture of Chemicals and Chemical Products,small,10,24,9,15,103,103,0
2022,4,Jazan Region,Manufacture of Chemicals and Chemical Products,micro,20,7,4,3,50,48,2
2022,4,Jazan Region,Manufacture of Chemicals and Chemical Products,medium,1,9,9,0,69,69,0
2022,4,Hail Region,Manufacture of Chemicals and Chemical Products,small,10,13,5,8,103,103,0
2022,4,Hail Region,Manufacture of Chemicals and Chemical Products,micro,59,9,5,4,170,170,0
2022,4,Hail Region,Manufacture of Chemicals and Chemical Products,medium,1,13,7,6,42,42,0
2022,4,Aseer Region,Manufacture of Chemicals and Chemical Products,small,26,87,48,39,427,424,3
2022,4,Aseer Region,Manufacture of Chemicals and Chemical Products,large,1,609,496,113,1399,1396,3
2022,4,Aseer Region,Manufacture of Chemicals and Chemical Products,micro,33,12,6,6,74,74,0
2022,4,Aseer Region,Manufacture of Chemicals and Chemical Products,medium,5,135,86,49,340,340,0
2022,4,Makkah Region,Manufacture of Chemicals and Chemical Products,small,207,948,523,425,3228,3198,30
2022,4,Makkah Region,Manufacture of Chemicals and Chemical Products,large,4,732,545,187,1636,1632,4
2022,4,Makkah Region,Manufacture of Chemicals and Chemical Products,micro,243,122,68,54,477,465,12
2022,4,Makkah Region,Manufacture of Chemicals and Chemical Products,medium,77,2097,1295,802,5438,5402,36
2022,4,Najran Region,Manufacture of Chemicals and Chemical Products,small,4,17,13,4,95,95,0
2022,4,Najran Region,Manufacture of Chemicals and Chemical Products,micro,12,1,1,0,29,29,0
2022,4,Najran Region,Manufacture of Chemicals and Chemical Products,medium,3,44,17,27,161,161,0
2022,4,Eastern Province,Manufacture of Textiles,small,80,165,88,77,825,813,12
2022,4,Eastern Province,Manufacture of Textiles,large,1,70,48,22,184,184,0
2022,4,Eastern Province,Manufacture of Textiles,micro,311,59,23,36,666,649,17
2022,4,Eastern Province,Manufacture of Textiles,medium,7,161,138,23,647,646,1
2022,4,Al Bahah Region,Manufacture of Textiles,small,2,4,3,1,24,24,0
2022,4,Al Bahah Region,Manufacture of Textiles,micro,21,6,3,3,54,53,1
2022,4,Al Jawf Region,Manufacture of Textiles,small,5,4,1,3,32,32,0
2022,4,Al Jawf Region,Manufacture of Textiles,micro,64,10,5,5,160,159,1
2022,4,Northern Borders Region,Manufacture of Textiles,small,2,1,1,0,14,14,0
2022,4,Northern Borders Region,Manufacture of Textiles,micro,27,6,5,1,61,61,0
2022,4,Riyadh Region,Manufacture of Textiles,small,114,238,91,147,1184,1180,4
2022,4,Riyadh Region,Manufacture of Textiles,large,7,1519,1037,482,3950,3923,27
2022,4,Riyadh Region,Manufacture of Textiles,micro,499,88,38,50,1159,1150,9
2022,4,Riyadh Region,Manufacture of Textiles,medium,11,301,177,124,909,907,2
2022,4,Qassim Region,Manufacture of Textiles,small,15,26,24,2,117,117,0
2022,4,Qassim Region,Manufacture of Textiles,micro,87,22,10,12,208,208,0
2022,4,Qassim Region,Manufacture of Textiles,medium,1,18,8,10,49,49,0
2022,4,Al Madinah Region,Manufacture of Textiles,small,19,33,25,8,167,167,0
2022,4,Al Madinah Region,Manufacture of Textiles,micro,138,22,10,12,297,288,9
2022,4,Al Madinah Region,Manufacture of Textiles,medium,5,103,63,40,358,357,1
2022,4,Tabuk Region,Manufacture of Textiles,small,6,2,0,2,38,38,0
2022,4,Tabuk Region,Manufacture of Textiles,micro,71,10,5,5,167,165,2
2022,4,Jazan Region,Manufacture of Textiles,small,1,1,1,0,7,7,0
2022,4,Jazan Region,Manufacture of Textiles,micro,32,5,3,2,72,72,0
2022,4,Hail Region,Manufacture of Textiles,small,7,14,8,6,72,72,0
2022,4,Hail Region,Manufacture of Textiles,micro,52,3,0,3,133,131,2
2022,4,Aseer Region,Manufacture of Textiles,small,6,5,3,2,47,47,0
2022,4,Aseer Region,Manufacture of Textiles,micro,70,14,6,8,160,157,3
2022,4,Makkah Region,Manufacture of Textiles,small,53,150,51,99,677,676,1
2022,4,Makkah Region,Manufacture of Textiles,large,2,220,211,9,671,671,0
2022,4,Makkah Region,Manufacture of Textiles,micro,282,56,34,22,629,615,14
2022,4,Makkah Region,Manufacture of Textiles,medium,9,260,176,84,772,771,1
2022,4,Najran Region,Manufacture of Textiles,small,3,1,1,0,27,22,5
2022,4,Najran Region,Manufacture of Textiles,micro,52,9,4,5,121,118,3
2022,4,Eastern Province,Manufacture of Food Products,small,333,1185,567,618,4514,4504,10
2022,4,Eastern Province,Manufacture of Food Products,large,16,1620,900,720,5173,5164,9
2022,4,Eastern Province,Manufacture of Food Products,micro,750,265,127,138,1504,1500,4
2022,4,Eastern Province,Manufacture of Food Products,medium,77,1781,1007,774,5483,5462,21
2022,4,Al Bahah Region,Manufacture of Food Products,small,18,32,17,15,175,174,1
2022,4,Al Bahah Region,Manufacture of Food Products,micro,99,21,10,11,196,196,0
2022,4,Al Bahah Region,Manufacture of Food Products,medium,1,10,4,6,46,46,0
2022,4,Al Jawf Region,Manufacture of Food Products,small,37,67,40,27,343,343,0
2022,4,Al Jawf Region,Manufacture of Food Products,micro,177,34,25,9,379,378,1
2022,4,Al Jawf Region,Manufacture of Food Products,medium,2,59,52,7,113,113,0
2022,4,Northern Borders Region,Manufacture of Food Products,small,17,25,12,13,187,187,0
2022,4,Northern Borders Region,Manufacture of Food Products,micro,108,14,11,3,237,237,0
2022,4,Northern Borders Region,Manufacture of Food Products,medium,1,8,7,1,59,59,0
2022,4,Riyadh Region,Manufacture of Food Products,small,590,1904,785,1119,8284,8214,70
2022,4,Riyadh Region,Manufacture of Food Products,large,49,7602,5398,2204,24919,24848,71
2022,4,Riyadh Region,Manufacture of Food Products,micro,1872,481,203,278,3872,3845,27
2022,4,Riyadh Region,Manufacture of Food Products,medium,160,3733,1890,1843,12449,12380,69
2022,4,Qassim Region,Manufacture of Food Products,small,125,562,326,236,1962,1956,6
2022,4,Qassim Region,Manufacture of Food Products,large,11,935,618,317,3697,3567,130
2022,4,Qassim Region,Manufacture of Food Products,micro,402,93,55,38,853,851,2
2022,4,Qassim Region,Manufacture of Food Products,medium,50,1183,680,503,4287,4283,4
2022,4,Al Madinah Region,Manufacture of Food Products,small,130,379,196,183,1685,1676,9
2022,4,Al Madinah Region,Manufacture of Food Products,large,1,120,86,34,324,324,0
2022,4,Al Madinah Region,Manufacture of Food Products,micro,509,150,83,67,1065,1051,14
2022,4,Al Madinah Region,Manufacture of Food Products,medium,15,522,361,161,1289,1288,1
2022,4,Tabuk Region,Manufacture of Food Products,small,37,103,62,41,440,440,0
2022,4,Tabuk Region,Manufacture of Food Products,large,2,204,44,160,600,599,1
2022,4,Tabuk Region,Manufacture of Food Products,micro,218,44,15,29,417,417,0
2022,4,Tabuk Region,Manufacture of Food Products,medium,7,123,38,85,540,540,0
2022,4,Jazan Region,Manufacture of Food Products,small,54,143,81,62,630,624,6
2022,4,Jazan Region,Manufacture of Food Products,micro,303,51,34,17,651,648,3
2022,4,Jazan Region,Manufacture of Food Products,medium,6,167,89,78,574,573,1
2022,4,Hail Region,Manufacture of Food Products,small,34,115,44,71,425,424,1
2022,4,Hail Region,Manufacture of Food Products,large,1,67,31,36,200,199,1
2022,4,Hail Region,Manufacture of Food Products,micro,209,39,21,18,455,454,1
2022,4,Hail Region,Manufacture of Food Products,medium,9,216,73,143,710,706,4
2022,4,Aseer Region,Manufacture of Food Products,small,93,260,108,152,1126,1126,0
2022,4,Aseer Region,Manufacture of Food Products,large,4,325,185,140,1616,1616,0
2022,4,Aseer Region,Manufacture of Food Products,micro,534,110,60,50,990,989,1
2022,4,Aseer Region,Manufacture of Food Products,medium,16,377,225,152,1120,1119,1
2022,4,Makkah Region,Manufacture of Food Products,small,424,1298,617,681,5348,5302,46
2022,4,Makkah Region,Manufacture of Food Products,large,38,6387,3384,3003,16198,15849,349
2022,4,Makkah Region,Manufacture of Food Products,micro,1486,390,193,197,3167,3144,23
2022,4,Makkah Region,Manufacture of Food Products,medium,102,2509,1219,1290,8212,8153,59
2022,4,Najran Region,Manufacture of Food Products,small,22,42,18,24,233,233,0
2022,4,Najran Region,Manufacture of Food Products,micro,171,32,18,14,368,365,3
2022,4,Eastern Province,Manufacture of Basic Pharmaceuticals and Pharmaceutical Preparations,small,7,32,16,16,89,75,14
2022,4,Eastern Province,Manufacture of Basic Pharmaceuticals and Pharmaceutical Preparations,large,1,6,6,0,388,386,2
2022,4,Eastern Province,Manufacture of Basic Pharmaceuticals and Pharmaceutical Preparations,micro,12,5,1,4,28,25,3
2022,4,Eastern Province,Manufacture of Basic Pharmaceuticals and Pharmaceutical Preparations,medium,5,211,149,62,257,254,3
2022,4,Al Jawf Region,Manufacture of Basic Pharmaceuticals and Pharmaceutical Preparations,micro,7,0,0,0,22,21,1
2022,4,Northern Borders Region,Manufacture of Basic Pharmaceuticals and Pharmaceutical Preparations,micro,2,1,0,1,4,4,0
2022,4,Riyadh Region,Manufacture of Basic Pharmaceuticals and Pharmaceutical Preparations,small,28,185,82,103,357,350,7
2022,4,Riyadh Region,Manufacture of Basic Pharmaceuticals and Pharmaceutical Preparations,large,5,572,291,281,1462,1430,32
2022,4,Riyadh Region,Manufacture of Basic Pharmaceuticals and Pharmaceutical Preparations,micro,205,41,20,21,594,591,3
2022,4,Riyadh Region,Manufacture of Basic Pharmaceuticals and Pharmaceutical Preparations,medium,9,252,101,151,597,586,11
2022,4,Qassim Region,Manufacture of Basic Pharmaceuticals and Pharmaceutical Preparations,small,1,3,1,2,16,16,0
2022,4,Qassim Region,Manufacture of Basic Pharmaceuticals and Pharmaceutical Preparations,large,1,295,274,21,323,323,0
2022,4,Qassim Region,Manufacture of Basic Pharmaceuticals and Pharmaceutical Preparations,micro,11,1,0,1,27,27,0
2022,4,Qassim Region,Manufacture of Basic Pharmaceuticals and Pharmaceutical Preparations,medium,1,31,25,6,92,83,9
2022,4,Al Madinah Region,Manufacture of Basic Pharmaceuticals and Pharmaceutical Preparations,small,1,10,7,3,29,29,0
2022,4,Al Madinah Region,Manufacture of Basic Pharmaceuticals and Pharmaceutical Preparations,micro,5,1,0,1,6,6,0
2022,4,Tabuk Region,Manufacture of Basic Pharmaceuticals and Pharmaceutical Preparations,micro,2,0,0,0,5,5,0
2022,4,Jazan Region,Manufacture of Basic Pharmaceuticals and Pharmaceutical Preparations,micro,6,0,0,0,13,11,2
2022,4,Hail Region,Manufacture of Basic Pharmaceuticals and Pharmaceutical Preparations,small,1,2,0,2,6,6,0
2022,4,Hail Region,Manufacture of Basic Pharmaceuticals and Pharmaceutical Preparations,micro,7,3,2,1,17,17,0
2022,4,Hail Region,Manufacture of Basic Pharmaceuticals and Pharmaceutical Preparations,medium,1,90,62,28,60,59,1
2022,4,Aseer Region,Manufacture of Basic Pharmaceuticals and Pharmaceutical Preparations,micro,7,3,2,1,20,20,0
2022,4,Aseer Region,Manufacture of Basic Pharmaceuticals and Pharmaceutical Preparations,medium,1,16,4,12,37,31,6
2022,4,Makkah Region,Manufacture of Basic Pharmaceuticals and Pharmaceutical Preparations,small,12,88,58,30,121,115,6
2022,4,Makkah Region,Manufacture of Basic Pharmaceuticals and Pharmaceutical Preparations,large,2,614,317,297,663,643,20
2022,4,Makkah Region,Manufacture of Basic Pharmaceuticals and Pharmaceutical Preparations,micro,23,14,10,4,40,39,1
2022,4,Makkah Region,Manufacture of Basic Pharmaceuticals and Pharmaceutical Preparations,medium,8,379,190,189,625,600,25
2022,4,Najran Region,Manufacture of Basic Pharmaceuticals and Pharmaceutical Preparations,small,1,2,0,2,18,18,0
2022,4,Najran Region,Manufacture of Basic Pharmaceuticals and Pharmaceutical Preparations,micro,2,0,0,0,7,7,0
2022,4,Eastern Province,Manufacture of Leather and Leather Products,small,8,19,10,9,164,164,0
2022,4,Eastern Province,Manufacture of Leather and Leather Products,micro,15,1,1,0,34,34,0
2022,4,Eastern Province,Manufacture of Leather and Leather Products,medium,1,50,50,0,91,91,0
2022,4,Al Jawf Region,Manufacture of Leather and Leather Products,small,1,1,1,0,5,5,0
2022,4,Al Jawf Region,Manufacture of Leather and Leather Products,micro,1,0,0,0,2,2,0
2022,4,Northern Borders Region,Manufacture of Leather and Leather Products,small,1,0,0,0,9,9,0
2022,4,Northern Borders Region,Manufacture of Leather and Leather Products,micro,7,1,0,1,18,18,0
2022,4,Riyadh Region,Manufacture of Leather and Leather Products,small,42,42,23,19,441,438,3
2022,4,Riyadh Region,Manufacture of Leather and Leather Products,large,3,206,56,150,826,823,3
2022,4,Riyadh Region,Manufacture of Leather and Leather Products,micro,76,10,4,6,200,200,0
2022,4,Riyadh Region,Manufacture of Leather and Leather Products,medium,5,117,35,82,488,487,1
2022,4,Qassim Region,Manufacture of Leather and Leather Products,small,1,1,0,1,6,6,0
2022,4,Qassim Region,Manufacture of Leather and Leather Products,micro,8,1,0,1,17,17,0
2022,4,Al Madinah Region,Manufacture of Leather and Leather Products,small,2,1,0,1,18,18,0
2022,4,Al Madinah Region,Manufacture of Leather and Leather Products,micro,10,1,1,0,23,22,1
2022,4,Al Madinah Region,Manufacture of Leather and Leather Products,medium,1,11,4,7,49,49,0
2022,4,Tabuk Region,Manufacture of Leather and Leather Products,micro,1,0,0,0,1,1,0
2022,4,Jazan Region,Manufacture of Leather and Leather Products,small,2,0,0,0,12,12,0
2022,4,Jazan Region,Manufacture of Leather and Leather Products,micro,53,1,0,1,179,179,0
2022,4,Hail Region,Manufacture of Leather and Leather Products,small,3,0,0,0,20,20,0
2022,4,Hail Region,Manufacture of Leather and Leather Products,micro,6,1,0,1,18,18,0
2022,4,Aseer Region,Manufacture of Leather and Leather Products,small,1,0,0,0,8,8,0
2022,4,Aseer Region,Manufacture of Leather and Leather Products,micro,12,3,2,1,25,25,0
2022,4,Makkah Region,Manufacture of Leather and Leather Products,small,7,26,12,14,107,106,1
2022,4,Makkah Region,Manufacture of Leather and Leather Products,micro,31,4,1,3,81,81,0
2022,4,Makkah Region,Manufacture of Leather and Leather Products,medium,2,23,11,12,81,81,0
2022,4,Najran Region,Manufacture of Leather and Leather Products,micro,3,1,0,1,5,5,0
2022,4,Eastern Province,Manufacture of Wearing Apparel,small,238,519,195,324,2199,1968,231
2022,4,Eastern Province,Manufacture of Wearing Apparel,large,1,76,4,72,185,182,3
2022,4,Eastern Province,Manufacture of Wearing Apparel,micro,2308,393,152,241,4854,4561,293
2022,4,Eastern Province,Manufacture of Wearing Apparel,medium,11,317,89,228,731,728,3
2022,4,Al Bahah Region,Manufacture of Wearing Apparel,small,12,24,10,14,103,83,20
2022,4,Al Bahah Region,Manufacture of Wearing Apparel,micro,160,34,20,14,297,255,42
2022,4,Al Jawf Region,Manufacture of Wearing Apparel,small,13,11,6,5,88,75,13
2022,4,Al Jawf Region,Manufacture of Wearing Apparel,micro,292,29,11,18,605,566,39
2022,4,Northern Borders Region,Manufacture of Wearing Apparel,small,4,9,4,5,22,14,8
2022,4,Northern Borders Region,Manufacture of Wearing Apparel,micro,284,23,14,9,703,666,37
2022,4,Riyadh Region,Manufacture of Wearing Apparel,small,425,1014,315,699,4145,3737,408
2022,4,Riyadh Region,Manufacture of Wearing Apparel,large,6,930,129,801,1506,1469,37
2022,4,Riyadh Region,Manufacture of Wearing Apparel,micro,3874,693,247,446,8165,7495,670
2022,4,Riyadh Region,Manufacture of Wearing Apparel,medium,29,609,183,426,2095,1908,187
2022,4,Qassim Region,Manufacture of Wearing Apparel,small,32,56,27,29,238,194,44
2022,4,Qassim Region,Manufacture of Wearing Apparel,micro,829,93,44,49,1725,1602,123
2022,4,Qassim Region,Manufacture of Wearing Apparel,medium,4,108,73,35,270,269,1
2022,4,Al Madinah Region,Manufacture of Wearing Apparel,small,48,76,29,47,374,320,54
2022,4,Al Madinah Region,Manufacture of Wearing Apparel,micro,1067,134,56,78,2215,1970,245
2022,4,Al Madinah Region,Manufacture of Wearing Apparel,medium,3,79,36,43,235,229,6
2022,4,Tabuk Region,Manufacture of Wearing Apparel,small,26,44,18,26,223,208,15
2022,4,Tabuk Region,Manufacture of Wearing Apparel,micro,809,79,39,40,2115,2074,41
2022,4,Tabuk Region,Manufacture of Wearing Apparel,medium,1,0,0,0,90,90,0
2022,4,Jazan Region,Manufacture of Wearing Apparel,small,22,29,15,14,139,120,19
2022,4,Jazan Region,Manufacture of Wearing Apparel,micro,660,62,34,28,1391,1285,106
2022,4,Hail Region,Manufacture of Wearing Apparel,small,23,33,5,28,179,163,16
2022,4,Hail Region,Manufacture of Wearing Apparel,large,1,47,8,39,219,219,0
2022,4,Hail Region,Manufacture of Wearing Apparel,micro,425,58,20,38,877,800,77
2022,4,Aseer Region,Manufacture of Wearing Apparel,small,54,97,38,59,465,439,26
2022,4,Aseer Region,Manufacture of Wearing Apparel,micro,1052,141,72,69,2169,1966,203
2022,4,Aseer Region,Manufacture of Wearing Apparel,medium,2,43,26,17,131,131,0
2022,4,Makkah Region,Manufacture of Wearing Apparel,small,198,443,139,304,1883,1678,205
2022,4,Makkah Region,Manufacture of Wearing Apparel,large,2,218,51,167,600,600,0
2022,4,Makkah Region,Manufacture of Wearing Apparel,micro,2992,461,190,271,6219,5649,570
2022,4,Makkah Region,Manufacture of Wearing Apparel,medium,20,408,115,293,1116,1107,9
2022,4,Najran Region,Manufacture of Wearing Apparel,small,17,26,8,18,130,125,5
2022,4,Najran Region,Manufacture of Wearing Apparel,micro,420,30,7,23,941,877,64
2022,4,Najran Region,Manufacture of Wearing Apparel,medium,1,24,6,18,43,43,0
2022,4,Eastern Province,Manufacture of Electrical Equipment,small,57,322,229,93,900,896,4
2022,4,Eastern Province,Manufacture of Electrical Equipment,large,7,1884,1835,49,1624,1619,5
2022,4,Eastern Province,Manufacture of Electrical Equipment,micro,118,50,32,18,237,237,0
2022,4,Eastern Province,Manufacture of Electrical Equipment,medium,27,807,583,224,1849,1848,1
2022,4,Al Bahah Region,Manufacture of Electrical Equipment,micro,5,0,0,0,9,9,0
2022,4,Al Jawf Region,Manufacture of Electrical Equipment,small,1,2,1,1,5,5,0
2022,4,Al Jawf Region,Manufacture of Electrical Equipment,micro,12,1,1,0,19,19,0
2022,4,Northern Borders Region,Manufacture of Electrical Equipment,micro,16,0,0,0,34,34,0
2022,4,Riyadh Region,Manufacture of Electrical Equipment,small,97,353,168,185,1538,1532,6
2022,4,Riyadh Region,Manufacture of Electrical Equipment,large,10,985,851,134,2499,2494,5
2022,4,Riyadh Region,Manufacture of Electrical Equipment,micro,157,45,30,15,345,345,0
2022,4,Riyadh Region,Manufacture of Electrical Equipment,medium,57,1674,985,689,4632,4623,9
2022,4,Qassim Region,Manufacture of Electrical Equipment,small,13,32,17,15,193,193,0
2022,4,Qassim Region,Manufacture of Electrical Equipment,micro,29,5,5,0,65,65,0
2022,4,Qassim Region,Manufacture of Electrical Equipment,medium,2,26,20,6,134,134,0
2022,4,Al Madinah Region,Manufacture of Electrical Equipment,small,10,51,35,16,144,142,2
2022,4,Al Madinah Region,Manufacture of Electrical Equipment,large,1,108,100,8,298,298,0
2022,4,Al Madinah Region,Manufacture of Electrical Equipment,micro,41,6,4,2,80,80,0
2022,4,Al Madinah Region,Manufacture of Electrical Equipment,medium,2,64,38,26,242,242,0
2022,4,Tabuk Region,Manufacture of Electrical Equipment,small,1,1,0,1,7,7,0
2022,4,Tabuk Region,Manufacture of Electrical Equipment,micro,10,0,0,0,19,19,0
2022,4,Jazan Region,Manufacture of Electrical Equipment,small,1,0,0,0,6,6,0
2022,4,Jazan Region,Manufacture of Electrical Equipment,micro,26,1,1,0,66,66,0
2022,4,Hail Region,Manufacture of Electrical Equipment,small,1,3,2,1,4,4,0
2022,4,Hail Region,Manufacture of Electrical Equipment,micro,14,3,1,2,42,42,0
2022,4,Hail Region,Manufacture of Electrical Equipment,medium,1,34,11,23,90,90,0
2022,4,Aseer Region,Manufacture of Electrical Equipment,small,5,16,9,7,66,66,0
2022,4,Aseer Region,Manufacture of Electrical Equipment,micro,29,8,4,4,57,57,0
2022,4,Aseer Region,Manufacture of Electrical Equipment,medium,1,13,5,8,51,50,1
2022,4,Makkah Region,Manufacture of Electrical Equipment,small,44,182,107,75,734,732,2
2022,4,Makkah Region,Manufacture of Electrical Equipment,large,2,286,267,19,855,854,1
2022,4,Makkah Region,Manufacture of Electrical Equipment,micro,140,31,20,11,293,288,5
2022,4,Makkah Region,Manufacture of Electrical Equipment,medium,9,221,150,71,781,778,3
2022,4,Najran Region,Manufacture of Electrical Equipment,small,2,6,4,2,30,30,0
2022,4,Najran Region,Manufacture of Electrical Equipment,micro,7,2,0,2,12,12,0
2022,4,Eastern Province,Manufacture of Beverages,small,21,76,35,41,336,336,0
2022,4,Eastern Province,Manufacture of Beverages,large,4,580,386,194,1509,1508,1
2022,4,Eastern Province,Manufacture of Beverages,micro,37,14,6,8,71,70,1
2022,4,Eastern Province,Manufacture of Beverages,medium,6,145,54,91,475,472,3
2022,4,Al Bahah Region,Manufacture of Beverages,small,3,12,9,3,55,55,0
2022,4,Al Bahah Region,Manufacture of Beverages,micro,3,1,0,1,6,6,0
2022,4,Al Bahah Region,Manufacture of Beverages,medium,2,60,12,48,186,186,0
2022,4,Al Jawf Region,Manufacture of Beverages,small,2,4,0,4,14,14,0
2022,4,Al Jawf Region,Manufacture of Beverages,micro,6,2,1,1,10,10,0
2022,4,Al Jawf Region,Manufacture of Beverages,medium,1,16,9,7,51,51,0
2022,4,Northern Borders Region,Manufacture of Beverages,small,1,2,2,0,11,11,0
2022,4,Riyadh Region,Manufacture of Beverages,small,36,173,87,86,524,524,0
2022,4,Riyadh Region,Manufacture of Beverages,large,11,1890,1324,566,4412,4403,9
2022,4,Riyadh Region,Manufacture of Beverages,micro,75,33,9,24,149,148,1
2022,4,Riyadh Region,Manufacture of Beverages,medium,36,944,416,528,2943,2940,3
2022,4,Qassim Region,Manufacture of Beverages,small,6,14,4,10,109,109,0
2022,4,Qassim Region,Manufacture of Beverages,large,2,377,167,210,783,783,0
2022,4,Qassim Region,Manufacture of Beverages,micro,16,2,1,1,27,27,0
2022,4,Qassim Region,Manufacture of Beverages,medium,4,133,45,88,416,416,0
2022,4,Al Madinah Region,Manufacture of Beverages,small,11,52,26,26,218,217,1
2022,4,Al Madinah Region,Manufacture of Beverages,micro,19,8,5,3,34,34,0
2022,4,Al Madinah Region,Manufacture of Beverages,medium,6,181,74,107,562,562,0
2022,4,Tabuk Region,Manufacture of Beverages,small,4,21,14,7,69,69,0
2022,4,Tabuk Region,Manufacture of Beverages,micro,16,4,4,0,39,39,0
2022,4,Tabuk Region,Manufacture of Beverages,medium,2,70,40,30,149,149,0
2022,4,Jazan Region,Manufacture of Beverages,small,7,18,5,13,81,81,0
2022,4,Jazan Region,Manufacture of Beverages,large,2,125,76,49,402,402,0
2022,4,Jazan Region,Manufacture of Beverages,micro,24,4,2,2,53,53,0
2022,4,Jazan Region,Manufacture of Beverages,medium,4,128,87,41,401,401,0
2022,4,Hail Region,Manufacture of Beverages,small,5,22,14,8,68,68,0
2022,4,Hail Region,Manufacture of Beverages,large,1,108,44,64,226,224,2
2022,4,Hail Region,Manufacture of Beverages,micro,6,3,3,0,7,7,0
2022,4,Hail Region,Manufacture of Beverages,medium,1,13,3,10,44,43,1
2022,4,Aseer Region,Manufacture of Beverages,small,13,34,24,10,200,200,0
2022,4,Aseer Region,Manufacture of Beverages,large,1,126,116,10,312,312,0
2022,4,Aseer Region,Manufacture of Beverages,micro,21,3,1,2,45,45,0
2022,4,Aseer Region,Manufacture of Beverages,medium,2,55,33,22,122,122,0
2022,4,Makkah Region,Manufacture of Beverages,small,42,170,87,83,660,659,1
2022,4,Makkah Region,Manufacture of Beverages,large,7,1174,919,255,2368,2362,6
2022,4,Makkah Region,Manufacture of Beverages,micro,103,26,18,8,198,197,1
2022,4,Makkah Region,Manufacture of Beverages,medium,22,534,292,242,1621,1617,4
2022,4,Najran Region,Manufacture of Beverages,small,3,21,8,13,73,73,0
2022,4,Najran Region,Manufacture of Beverages,micro,5,1,0,1,12,12,0
2022,4,Najran Region,Manufacture of Beverages,medium,1,87,67,20,122,122,0
2022,4,Eastern Province,Manufacture of Basic Metals,small,106,527,350,177,1666,1665,1
2022,4,Eastern Province,Manufacture of Basic Metals,large,20,2773,2550,223,5045,5044,1
2022,4,Eastern Province,Manufacture of Basic Metals,micro,106,45,35,10,194,194,0
2022,4,Eastern Province,Manufacture of Basic Metals,medium,56,1741,1273,468,4623,4622,1
2022,4,Al Bahah Region,Manufacture of Basic Metals,micro,10,3,3,0,18,18,0
2022,4,Al Jawf Region,Manufacture of Basic Metals,small,2,0,0,0,12,12,0
2022,4,Al Jawf Region,Manufacture of Basic Metals,micro,15,4,4,0,35,35,0
2022,4,Northern Borders Region,Manufacture of Basic Metals,small,1,3,3,0,3,3,0
2022,4,Northern Borders Region,Manufacture of Basic Metals,micro,10,1,1,0,27,27,0
2022,4,Riyadh Region,Manufacture of Basic Metals,small,185,680,340,340,2722,2706,16
2022,4,Riyadh Region,Manufacture of Basic Metals,large,11,934,614,320,2842,2836,6
2022,4,Riyadh Region,Manufacture of Basic Metals,micro,351,87,45,42,786,783,3
2022,4,Riyadh Region,Manufacture of Basic Metals,medium,57,1307,765,542,4665,4641,24
2022,4,Qassim Region,Manufacture of Basic Metals,small,13,28,14,14,207,206,1
2022,4,Qassim Region,Manufacture of Basic Metals,micro,72,9,5,4,151,150,1
2022,4,Qassim Region,Manufacture of Basic Metals,medium,6,55,36,19,342,342,0
2022,4,Al Madinah Region,Manufacture of Basic Metals,small,14,49,20,29,160,159,1
2022,4,Al Madinah Region,Manufacture of Basic Metals,micro,47,6,3,3,113,113,0
2022,4,Al Madinah Region,Manufacture of Basic Metals,medium,3,227,196,31,312,312,0
2022,4,Tabuk Region,Manufacture of Basic Metals,small,3,3,2,1,27,27,0
2022,4,Tabuk Region,Manufacture of Basic Metals,micro,12,3,2,1,26,26,0
2022,4,Tabuk Region,Manufacture of Basic Metals,medium,2,62,23,39,192,192,0
2022,4,Jazan Region,Manufacture of Basic Metals,small,2,8,3,5,28,28,0
2022,4,Jazan Region,Manufacture of Basic Metals,large,1,150,150,0,115,115,0
2022,4,Jazan Region,Manufacture of Basic Metals,micro,36,6,3,3,79,79,0
2022,4,Jazan Region,Manufacture of Basic Metals,medium,2,105,91,14,249,249,0
2022,4,Hail Region,Manufacture of Basic Metals,small,3,3,2,1,21,21,0
2022,4,Hail Region,Manufacture of Basic Metals,micro,36,2,1,1,78,78,0
2022,4,Hail Region,Manufacture of Basic Metals,medium,2,27,10,17,97,97,0
2022,4,Aseer Region,Manufacture of Basic Metals,small,18,47,39,8,195,195,0
2022,4,Aseer Region,Manufacture of Basic Metals,micro,69,18,10,8,140,140,0
2022,4,Aseer Region,Manufacture of Basic Metals,medium,2,54,53,1,149,149,0
2022,4,Makkah Region,Manufacture of Basic Metals,small,93,393,214,179,1305,1301,4
2022,4,Makkah Region,Manufacture of Basic Metals,large,11,1233,839,394,2914,2911,3
2022,4,Makkah Region,Manufacture of Basic Metals,micro,172,64,33,31,368,361,7
2022,4,Makkah Region,Manufacture of Basic Metals,medium,32,857,635,222,2771,2761,10
2022,4,Najran Region,Manufacture of Basic Metals,small,2,1,0,1,11,11,0
2022,4,Najran Region,Manufacture of Basic Metals,large,1,211,208,3,357,357,0
2022,4,Najran Region,Manufacture of Basic Metals,micro,41,5,4,1,76,76,0
2022,4,Najran Region,Manufacture of Basic Metals,medium,1,28,14,14,108,108,0
2022,4,Eastern Province,"Manufacture of Wood and Wood Products (Except Furniture), Manufacture of Straw and Plaiting Materials",small,171,423,227,196,1940,1933,7
2022,4,Eastern Province,"Manufacture of Wood and Wood Products (Except Furniture), Manufacture of Straw and Plaiting Materials",large,1,60,60,0,250,250,0
2022,4,Eastern Province,"Manufacture of Wood and Wood Products (Except Furniture), Manufacture of Straw and Plaiting Materials",micro,429,159,65,94,1021,1017,4
2022,4,Eastern Province,"Manufacture of Wood and Wood Products (Except Furniture), Manufacture of Straw and Plaiting Materials",medium,15,368,227,141,1210,1207,3
2022,4,Al Bahah Region,"Manufacture of Wood and Wood Products (Except Furniture), Manufacture of Straw and Plaiting Materials",small,13,24,17,7,84,84,0
2022,4,Al Bahah Region,"Manufacture of Wood and Wood Products (Except Furniture), Manufacture of Straw and Plaiting Materials",micro,84,20,12,8,197,196,1
2022,4,Al Jawf Region,"Manufacture of Wood and Wood Products (Except Furniture), Manufacture of Straw and Plaiting Materials",small,12,14,8,6,90,90,0
2022,4,Al Jawf Region,"Manufacture of Wood and Wood Products (Except Furniture), Manufacture of Straw and Plaiting Materials",micro,83,11,10,1,168,167,1
2022,4,Northern Borders Region,"Manufacture of Wood and Wood Products (Except Furniture), Manufacture of Straw and Plaiting Materials",small,3,3,2,1,16,16,0
2022,4,Northern Borders Region,"Manufacture of Wood and Wood Products (Except Furniture), Manufacture of Straw and Plaiting Materials",micro,54,6,2,4,108,108,0
2022,4,Riyadh Region,"Manufacture of Wood and Wood Products (Except Furniture), Manufacture of Straw and Plaiting Materials",small,302,752,289,463,3281,3260,21
2022,4,Riyadh Region,"Manufacture of Wood and Wood Products (Except Furniture), Manufacture of Straw and Plaiting Materials",micro,925,247,90,157,2154,2147,7
2022,4,Riyadh Region,"Manufacture of Wood and Wood Products (Except Furniture), Manufacture of Straw and Plaiting Materials",medium,29,668,234,434,2209,2134,75
2022,4,Qassim Region,"Manufacture of Wood and Wood Products (Except Furniture), Manufacture of Straw and Plaiting Materials",small,28,81,60,21,314,314,0
2022,4,Qassim Region,"Manufacture of Wood and Wood Products (Except Furniture), Manufacture of Straw and Plaiting Materials",large,1,65,42,23,201,201,0
2022,4,Qassim Region,"Manufacture of Wood and Wood Products (Except Furniture), Manufacture of Straw and Plaiting Materials",micro,266,51,28,23,643,643,0
2022,4,Qassim Region,"Manufacture of Wood and Wood Products (Except Furniture), Manufacture of Straw and Plaiting Materials",medium,1,13,8,5,38,38,0
2022,4,Al Madinah Region,"Manufacture of Wood and Wood Products (Except Furniture), Manufacture of Straw and Plaiting Materials",small,28,79,46,33,291,291,0
2022,4,Al Madinah Region,"Manufacture of Wood and Wood Products (Except Furniture), Manufacture of Straw and Plaiting Materials",micro,156,29,17,12,381,381,0
2022,4,Al Madinah Region,"Manufacture of Wood and Wood Products (Except Furniture), Manufacture of Straw and Plaiting Materials",medium,1,16,11,5,45,45,0
2022,4,Tabuk Region,"Manufacture of Wood and Wood Products (Except Furniture), Manufacture of Straw and Plaiting Materials",small,16,21,10,11,96,96,0
2022,4,Tabuk Region,"Manufacture of Wood and Wood Products (Except Furniture), Manufacture of Straw and Plaiting Materials",micro,90,11,6,5,194,194,0
2022,4,Jazan Region,"Manufacture of Wood and Wood Products (Except Furniture), Manufacture of Straw and Plaiting Materials",small,16,28,10,18,126,122,4
2022,4,Jazan Region,"Manufacture of Wood and Wood Products (Except Furniture), Manufacture of Straw and Plaiting Materials",micro,204,23,14,9,506,506,0
2022,4,Jazan Region,"Manufacture of Wood and Wood Products (Except Furniture), Manufacture of Straw and Plaiting Materials",medium,1,18,4,14,75,75,0
2022,4,Hail Region,"Manufacture of Wood and Wood Products (Except Furniture), Manufacture of Straw and Plaiting Materials",small,12,26,13,13,114,113,1
2022,4,Hail Region,"Manufacture of Wood and Wood Products (Except Furniture), Manufacture of Straw and Plaiting Materials",micro,53,12,6,6,114,114,0
2022,4,Aseer Region,"Manufacture of Wood and Wood Products (Except Furniture), Manufacture of Straw and Plaiting Materials",small,39,87,52,35,352,351,1
2022,4,Aseer Region,"Manufacture of Wood and Wood Products (Except Furniture), Manufacture of Straw and Plaiting Materials",micro,301,67,30,37,670,667,3
2022,4,Aseer Region,"Manufacture of Wood and Wood Products (Except Furniture), Manufacture of Straw and Plaiting Materials",medium,1,13,6,7,43,43,0
2022,4,Makkah Region,"Manufacture of Wood and Wood Products (Except Furniture), Manufacture of Straw and Plaiting Materials",small,121,292,130,162,1251,1250,1
2022,4,Makkah Region,"Manufacture of Wood and Wood Products (Except Furniture), Manufacture of Straw and Plaiting Materials",large,2,193,159,34,569,569,0
2022,4,Makkah Region,"Manufacture of Wood and Wood Products (Except Furniture), Manufacture of Straw and Plaiting Materials",micro,691,147,85,62,1568,1558,10
2022,4,Makkah Region,"Manufacture of Wood and Wood Products (Except Furniture), Manufacture of Straw and Plaiting Materials",medium,13,307,177,130,897,887,10
2022,4,Najran Region,"Manufacture of Wood and Wood Products (Except Furniture), Manufacture of Straw and Plaiting Materials",small,5,7,2,5,32,32,0
2022,4,Najran Region,"Manufacture of Wood and Wood Products (Except Furniture), Manufacture of Straw and Plaiting Materials",micro,82,4,2,2,186,186,0
2022,4,Eastern Province,"Manufacture of Computers, Electronic and Optical Products",small,22,119,89,30,261,261,0
2022,4,Eastern Province,"Manufacture of Computers, Electronic and Optical Products",micro,46,21,15,6,72,71,1
2022,4,Eastern Province,"Manufacture of Computers, Electronic and Optical Products",medium,5,167,106,61,365,363,2
2022,4,Al Bahah Region,"Manufacture of Computers, Electronic and Optical Products",micro,7,6,6,0,9,9,0
2022,4,Al Jawf Region,"Manufacture of Computers, Electronic and Optical Products",micro,5,1,0,1,14,14,0
2022,4,Northern Borders Region,"Manufacture of Computers, Electronic and Optical Products",micro,3,1,1,0,5,5,0
2022,4,Riyadh Region,"Manufacture of Computers, Electronic and Optical Products",small,26,101,63,38,339,338,1
2022,4,Riyadh Region,"Manufacture of Computers, Electronic and Optical Products",micro,62,33,18,15,112,112,0
2022,4,Riyadh Region,"Manufacture of Computers, Electronic and Optical Products",medium,2,11,3,8,96,93,3
2022,4,Qassim Region,"Manufacture of Computers, Electronic and Optical Products",micro,9,1,1,0,12,12,0
2022,4,Al Madinah Region,"Manufacture of Computers, Electronic and Optical Products",small,4,16,15,1,28,28,0
2022,4,Al Madinah Region,"Manufacture of Computers, Electronic and Optical Products",micro,15,3,2,1,30,30,0
2022,4,Tabuk Region,"Manufacture of Computers, Electronic and Optical Products",micro,11,1,0,1,16,16,0
2022,4,Jazan Region,"Manufacture of Computers, Electronic and Optical Products",small,1,0,0,0,17,17,0
2022,4,Jazan Region,"Manufacture of Computers, Electronic and Optical Products",micro,23,3,3,0,36,36,0
2022,4,Hail Region,"Manufacture of Computers, Electronic and Optical Products",micro,7,1,0,1,17,17,0
2022,4,Aseer Region,"Manufacture of Computers, Electronic and Optical Products",small,2,3,2,1,10,10,0
2022,4,Aseer Region,"Manufacture of Computers, Electronic and Optical Products",micro,39,3,2,1,77,77,0
2022,4,Makkah Region,"Manufacture of Computers, Electronic and Optical Products",small,23,40,24,16,190,188,2
2022,4,Makkah Region,"Manufacture of Computers, Electronic and Optical Products",micro,131,54,33,21,227,227,0
2022,4,Makkah Region,"Manufacture of Computers, Electronic and Optical Products",medium,3,140,119,21,247,245,2
2022,4,Najran Region,"Manufacture of Computers, Electronic and Optical Products",micro,6,1,0,1,14,14,0
2022,4,Eastern Province,Manufacture of Furniture,small,156,467,216,251,2159,2151,8
2022,4,Eastern Province,Manufacture of Furniture,large,3,108,60,48,794,791,3
2022,4,Eastern Province,Manufacture of Furniture,micro,556,121,52,69,1358,1357,1
2022,4,Eastern Province,Manufacture of Furniture,medium,30,613,351,262,2257,2251,6
2022,4,Al Bahah Region,Manufacture of Furniture,small,9,4,3,1,74,74,0
2022,4,Al Bahah Region,Manufacture of Furniture,micro,93,9,8,1,202,202,0
2022,4,Al Jawf Region,Manufacture of Furniture,small,9,10,7,3,66,66,0
2022,4,Al Jawf Region,Manufacture of Furniture,micro,124,21,15,6,270,269,1
2022,4,Northern Borders Region,Manufacture of Furniture,small,5,9,6,3,41,41,0
2022,4,Northern Borders Region,Manufacture of Furniture,micro,88,7,6,1,236,236,0
2022,4,Riyadh Region,Manufacture of Furniture,small,458,1080,429,651,5942,5925,17
2022,4,Riyadh Region,Manufacture of Furniture,large,10,871,387,484,3032,3025,7
2022,4,Riyadh Region,Manufacture of Furniture,micro,1441,238,102,136,3503,3489,14
2022,4,Riyadh Region,Manufacture of Furniture,medium,89,1914,795,1119,6773,6741,32
2022,4,Qassim Region,Manufacture of Furniture,small,57,116,74,42,675,671,4
2022,4,Qassim Region,Manufacture of Furniture,large,1,67,22,45,358,358,0
2022,4,Qassim Region,Manufacture of Furniture,micro,224,39,26,13,555,554,1
2022,4,Qassim Region,Manufacture of Furniture,medium,9,133,86,47,598,598,0
2022,4,Al Madinah Region,Manufacture of Furniture,small,41,53,30,23,434,431,3
2022,4,Al Madinah Region,Manufacture of Furniture,micro,280,50,30,20,643,641,2
2022,4,Al Madinah Region,Manufacture of Furniture,medium,1,14,10,4,40,40,0
2022,4,Tabuk Region,Manufacture of Furniture,small,22,18,5,13,181,181,0
2022,4,Tabuk Region,Manufacture of Furniture,micro,213,23,13,10,551,551,0
2022,4,Jazan Region,Manufacture of Furniture,small,28,24,13,11,208,207,1
2022,4,Jazan Region,Manufacture of Furniture,micro,374,32,18,14,1026,1022,4
2022,4,Hail Region,Manufacture of Furniture,small,21,39,22,17,249,248,1
2022,4,Hail Region,Manufacture of Furniture,micro,159,19,9,10,379,379,0
2022,4,Aseer Region,Manufacture of Furniture,small,75,121,73,48,750,749,1
2022,4,Aseer Region,Manufacture of Furniture,micro,567,75,44,31,1346,1343,3
2022,4,Aseer Region,Manufacture of Furniture,medium,4,42,28,14,193,193,0
2022,4,Makkah Region,Manufacture of Furniture,small,132,253,132,121,1469,1463,6
2022,4,Makkah Region,Manufacture of Furniture,large,1,76,49,27,281,280,1
2022,4,Makkah Region,Manufacture of Furniture,micro,716,101,49,52,1694,1686,8
2022,4,Makkah Region,Manufacture of Furniture,medium,30,717,293,424,2608,2597,11
2022,4,Najran Region,Manufacture of Furniture,small,15,29,11,18,185,185,0
2022,4,Najran Region,Manufacture of Furniture,micro,113,20,7,13,300,300,0
2022,4,Najran Region,Manufacture of Furniture,medium,3,68,18,50,313,313,0
2022,4,Eastern Province,Manufacture of Other Transport Equipment,small,4,20,14,6,90,90,0
2022,4,Eastern Province,Manufacture of Other Transport Equipment,large,2,2225,2187,38,563,562,1
2022,4,Eastern Province,Manufacture of Other Transport Equipment,micro,13,6,4,2,27,26,1
2022,4,Eastern Province,Manufacture of Other Transport Equipment,medium,3,92,81,11,297,297,0
2022,4,Al Bahah Region,Manufacture of Other Transport Equipment,micro,1,0,0,0,1,1,0
2022,4,Al Jawf Region,Manufacture of Other Transport Equipment,micro,1,0,0,0,1,1,0
2022,4,Northern Borders Region,Manufacture of Other Transport Equipment,micro,1,0,0,0,4,4,0
2022,4,Riyadh Region,Manufacture of Other Transport Equipment,small,17,90,65,25,209,208,1
2022,4,Riyadh Region,Manufacture of Other Transport Equipment,large,1,1268,1242,26,588,588,0
2022,4,Riyadh Region,Manufacture of Other Transport Equipment,micro,67,16,6,10,144,143,1
2022,4,Riyadh Region,Manufacture of Other Transport Equipment,medium,5,196,126,70,430,430,0
2022,4,Qassim Region,Manufacture of Other Transport Equipment,micro,1,0,0,0,1,1,0
2022,4,Al Madinah Region,Manufacture of Other Transport Equipment,small,2,1,1,0,15,15,0
2022,4,Al Madinah Region,Manufacture of Other Transport Equipment,micro,6,1,0,1,11,11,0
2022,4,Tabuk Region,Manufacture of Other Transport Equipment,micro,1,1,0,1,1,1,0
2022,4,Jazan Region,Manufacture of Other Transport Equipment,small,1,5,5,0,25,25,0
2022,4,Jazan Region,Manufacture of Other Transport Equipment,micro,5,1,0,1,16,16,0
2022,4,Hail Region,Manufacture of Other Transport Equipment,micro,1,0,0,0,3,3,0
2022,4,Aseer Region,Manufacture of Other Transport Equipment,micro,5,2,2,0,17,17,0
2022,4,Makkah Region,Manufacture of Other Transport Equipment,small,6,70,22,48,113,112,1
2022,4,Makkah Region,Manufacture of Other Transport Equipment,micro,29,8,5,3,59,58,1
2022,4,Makkah Region,Manufacture of Other Transport Equipment,medium,2,7,6,1,120,120,0
2022,4,Najran Region,Manufacture of Other Transport Equipment,small,1,0,0,0,10,10,0
2022,4,Najran Region,Manufacture of Other Transport Equipment,micro,4,1,0,1,9,9,0
2022,4,Eastern Province,"Manufacture of Motor Vehicles, Trailers, and Semi-Trailers",small,27,132,83,49,404,404,0
2022,4,Eastern Province,"Manufacture of Motor Vehicles, Trailers, and Semi-Trailers",large,2,310,298,12,812,812,0
2022,4,Eastern Province,"Manufacture of Motor Vehicles, Trailers, and Semi-Trailers",micro,26,6,4,2,57,57,0
2022,4,Eastern Province,"Manufacture of Motor Vehicles, Trailers, and Semi-Trailers",medium,10,341,257,84,969,968,1
2022,4,Al Bahah Region,"Manufacture of Motor Vehicles, Trailers, and Semi-Trailers",micro,2,0,0,0,4,4,0
2022,4,Al Jawf Region,"Manufacture of Motor Vehicles, Trailers, and Semi-Trailers",small,1,2,2,0,8,8,0
2022,4,Al Jawf Region,"Manufacture of Motor Vehicles, Trailers, and Semi-Trailers",micro,9,1,1,0,18,18,0
2022,4,Northern Borders Region,"Manufacture of Motor Vehicles, Trailers, and Semi-Trailers",micro,1,0,0,0,2,2,0
2022,4,Riyadh Region,"Manufacture of Motor Vehicles, Trailers, and Semi-Trailers",small,35,163,91,72,604,603,1
2022,4,Riyadh Region,"Manufacture of Motor Vehicles, Trailers, and Semi-Trailers",large,2,92,36,56,928,924,4
2022,4,Riyadh Region,"Manufacture of Motor Vehicles, Trailers, and Semi-Trailers",micro,55,23,13,10,119,119,0
2022,4,Riyadh Region,"Manufacture of Motor Vehicles, Trailers, and Semi-Trailers",medium,15,286,131,155,899,891,8
2022,4,Qassim Region,"Manufacture of Motor Vehicles, Trailers, and Semi-Trailers",small,8,38,20,18,122,122,0
2022,4,Qassim Region,"Manufacture of Motor Vehicles, Trailers, and Semi-Trailers",large,1,101,80,21,258,258,0
2022,4,Qassim Region,"Manufacture of Motor Vehicles, Trailers, and Semi-Trailers",micro,12,1,1,0,28,28,0
2022,4,Al Madinah Region,"Manufacture of Motor Vehicles, Trailers, and Semi-Trailers",small,1,3,3,0,15,15,0
2022,4,Al Madinah Region,"Manufacture of Motor Vehicles, Trailers, and Semi-Trailers",micro,13,2,1,1,37,37,0
2022,4,Tabuk Region,"Manufacture of Motor Vehicles, Trailers, and Semi-Trailers",small,1,1,1,0,5,5,0
2022,4,Tabuk Region,"Manufacture of Motor Vehicles, Trailers, and Semi-Trailers",micro,3,1,1,0,11,11,0
2022,4,Tabuk Region,"Manufacture of Motor Vehicles, Trailers, and Semi-Trailers",medium,1,13,5,8,42,42,0
2022,4,Jazan Region,"Manufacture of Motor Vehicles, Trailers, and Semi-Trailers",small,1,4,1,3,18,18,0
2022,4,Jazan Region,"Manufacture of Motor Vehicles, Trailers, and Semi-Trailers",micro,13,0,0,0,37,37,0
2022,4,Hail Region,"Manufacture of Motor Vehicles, Trailers, and Semi-Trailers",small,1,0,0,0,6,6,0
2022,4,Hail Region,"Manufacture of Motor Vehicles, Trailers, and Semi-Trailers",micro,5,1,1,0,11,11,0
2022,4,Aseer Region,"Manufacture of Motor Vehicles, Trailers, and Semi-Trailers",small,1,1,0,1,5,5,0
2022,4,Aseer Region,"Manufacture of Motor Vehicles, Trailers, and Semi-Trailers",micro,8,0,0,0,16,16,0
2022,4,Makkah Region,"Manufacture of Motor Vehicles, Trailers, and Semi-Trailers",small,15,60,45,15,195,195,0
2022,4,Makkah Region,"Manufacture of Motor Vehicles, Trailers, and Semi-Trailers",large,1,85,65,20,213,213,0
2022,4,Makkah Region,"Manufacture of Motor Vehicles, Trailers, and Semi-Trailers",micro,39,10,9,1,88,88,0
2022,4,Makkah Region,"Manufacture of Motor Vehicles, Trailers, and Semi-Trailers",medium,9,341,221,120,783,783,0
2022,4,Najran Region,"Manufacture of Motor Vehicles, Trailers, and Semi-Trailers",micro,8,1,0,1,13,13,0
2022,4,Eastern Province,Manufacture of Other Machinery and Equipment Not Classified Elsewhere,small,72,481,362,119,1140,1139,1
2022,4,Eastern Province,Manufacture of Other Machinery and Equipment Not Classified Elsewhere,large,7,1493,1380,113,2004,2002,2
2022,4,Eastern Province,Manufacture of Other Machinery and Equipment Not Classified Elsewhere,micro,66,34,23,11,125,123,2
2022,4,Eastern Province,Manufacture of Other Machinery and Equipment Not Classified Elsewhere,medium,36,1609,1407,202,2391,2387,4
2022,4,Al Bahah Region,Manufacture of Other Machinery and Equipment Not Classified Elsewhere,small,1,1,0,1,5,5,0
2022,4,Al Bahah Region,Manufacture of Other Machinery and Equipment Not Classified Elsewhere,micro,5,3,2,1,9,9,0
2022,4,Al Jawf Region,Manufacture of Other Machinery and Equipment Not Classified Elsewhere,micro,2,1,1,0,4,4,0
2022,4,Northern Borders Region,Manufacture of Other Machinery and Equipment Not Classified Elsewhere,micro,4,0,0,0,11,11,0
2022,4,Riyadh Region,Manufacture of Other Machinery and Equipment Not Classified Elsewhere,small,84,318,174,144,1351,1346,5
2022,4,Riyadh Region,Manufacture of Other Machinery and Equipment Not Classified Elsewhere,large,1,111,55,56,268,267,1
2022,4,Riyadh Region,Manufacture of Other Machinery and Equipment Not Classified Elsewhere,micro,287,70,31,39,631,629,2
2022,4,Riyadh Region,Manufacture of Other Machinery and Equipment Not Classified Elsewhere,medium,31,946,521,425,3014,3009,5
2022,4,Qassim Region,Manufacture of Other Machinery and Equipment Not Classified Elsewhere,small,4,7,5,2,29,29,0
2022,4,Qassim Region,Manufacture of Other Machinery and Equipment Not Classified Elsewhere,micro,33,6,4,2,62,62,0
2022,4,Qassim Region,Manufacture of Other Machinery and Equipment Not Classified Elsewhere,medium,3,64,28,36,203,203,0
2022,4,Al Madinah Region,Manufacture of Other Machinery and Equipment Not Classified Elsewhere,small,6,19,13,6,82,82,0
2022,4,Al Madinah Region,Manufacture of Other Machinery and Equipment Not Classified Elsewhere,micro,21,3,2,1,50,50,0
2022,4,Al Madinah Region,Manufacture of Other Machinery and Equipment Not Classified Elsewhere,medium,4,60,44,16,239,239,0
2022,4,Tabuk Region,Manufacture of Other Machinery and Equipment Not Classified Elsewhere,micro,5,0,0,0,12,12,0
2022,4,Jazan Region,Manufacture of Other Machinery and Equipment Not Classified Elsewhere,small,3,4,2,2,27,27,0
2022,4,Jazan Region,Manufacture of Other Machinery and Equipment Not Classified Elsewhere,micro,19,1,0,1,46,46,0
2022,4,Hail Region,Manufacture of Other Machinery and Equipment Not Classified Elsewhere,small,1,18,18,0,3,3,0
2022,4,Hail Region,Manufacture of Other Machinery and Equipment Not Classified Elsewhere,micro,14,0,0,0,31,31,0
2022,4,Aseer Region,Manufacture of Other Machinery and Equipment Not Classified Elsewhere,small,4,28,26,2,64,64,0
2022,4,Aseer Region,Manufacture of Other Machinery and Equipment Not Classified Elsewhere,micro,17,3,2,1,32,32,0
2022,4,Aseer Region,Manufacture of Other Machinery and Equipment Not Classified Elsewhere,medium,2,47,47,0,135,135,0
2022,4,Makkah Region,Manufacture of Other Machinery and Equipment Not Classified Elsewhere,small,38,170,84,86,609,607,2
2022,4,Makkah Region,Manufacture of Other Machinery and Equipment Not Classified Elsewhere,large,2,648,640,8,962,961,1
2022,4,Makkah Region,Manufacture of Other Machinery and Equipment Not Classified Elsewhere,micro,89,28,19,9,175,175,0
2022,4,Makkah Region,Manufacture of Other Machinery and Equipment Not Classified Elsewhere,medium,14,357,266,91,1195,1193,2
2022,4,Najran Region,Manufacture of Other Machinery and Equipment Not Classified Elsewhere,small,1,1,0,1,5,5,0
2022,4,Najran Region,Manufacture of Other Machinery and Equipment Not Classified Elsewhere,micro,10,1,1,0,26,26,0
2022,4,Najran Region,Manufacture of Other Machinery and Equipment Not Classified Elsewhere,medium,1,0,0,0,135,135,0
2022,4,Eastern Province,"Electricity, Gas, Steam, and Air Conditioning Supply",small,52,313,218,95,622,621,1
2022,4,Eastern Province,"Electricity, Gas, Steam, and Air Conditioning Supply",large,1,6188,6176,12,464,464,0
2022,4,Eastern Province,"Electricity, Gas, Steam, and Air Conditioning Supply",micro,60,28,19,9,115,113,2
2022,4,Eastern Province,"Electricity, Gas, Steam, and Air Conditioning Supply",medium,6,242,214,28,246,246,0
2022,4,Al Bahah Region,"Electricity, Gas, Steam, and Air Conditioning Supply",micro,3,3,3,0,7,7,0
2022,4,Al Jawf Region,"Electricity, Gas, Steam, and Air Conditioning Supply",micro,6,1,1,0,11,11,0
2022,4,Northern Borders Region,"Electricity, Gas, Steam, and Air Conditioning Supply",micro,4,2,1,1,8,8,0
2022,4,Riyadh Region,"Electricity, Gas, Steam, and Air Conditioning Supply",small,60,311,168,143,681,679,2
2022,4,Riyadh Region,"Electricity, Gas, Steam, and Air Conditioning Supply",large,2,10679,10314,365,1068,1066,2
2022,4,Riyadh Region,"Electricity, Gas, Steam, and Air Conditioning Supply",micro,117,87,47,40,216,215,1
2022,4,Riyadh Region,"Electricity, Gas, Steam, and Air Conditioning Supply",medium,6,302,254,48,243,242,1
2022,4,Qassim Region,"Electricity, Gas, Steam, and Air Conditioning Supply",small,3,12,10,2,50,50,0
2022,4,Qassim Region,"Electricity, Gas, Steam, and Air Conditioning Supply",micro,12,5,4,1,35,35,0
2022,4,Qassim Region,"Electricity, Gas, Steam, and Air Conditioning Supply",medium,1,61,61,0,132,132,0
2022,4,Al Madinah Region,"Electricity, Gas, Steam, and Air Conditioning Supply",small,4,67,67,0,21,21,0
2022,4,Al Madinah Region,"Electricity, Gas, Steam, and Air Conditioning Supply",micro,19,7,2,5,33,33,0
2022,4,Tabuk Region,"Electricity, Gas, Steam, and Air Conditioning Supply",micro,13,3,0,3,25,25,0
2022,4,Jazan Region,"Electricity, Gas, Steam, and Air Conditioning Supply",small,4,22,16,6,85,85,0
2022,4,Jazan Region,"Electricity, Gas, Steam, and Air Conditioning Supply",micro,18,6,4,2,41,41,0
2022,4,Jazan Region,"Electricity, Gas, Steam, and Air Conditioning Supply",medium,1,8,8,0,55,55,0
2022,4,Hail Region,"Electricity, Gas, Steam, and Air Conditioning Supply",small,1,1,0,1,5,5,0
2022,4,Hail Region,"Electricity, Gas, Steam, and Air Conditioning Supply",micro,7,3,3,0,18,18,0
2022,4,Aseer Region,"Electricity, Gas, Steam, and Air Conditioning Supply",small,5,9,7,2,40,40,0
2022,4,Aseer Region,"Electricity, Gas, Steam, and Air Conditioning Supply",large,1,4575,4575,0,256,255,1
2022,4,Aseer Region,"Electricity, Gas, Steam, and Air Conditioning Supply",micro,20,6,2,4,41,41,0
2022,4,Aseer Region,"Electricity, Gas, Steam, and Air Conditioning Supply",medium,4,134,127,7,186,186,0
2022,4,Makkah Region,"Electricity, Gas, Steam, and Air Conditioning Supply",small,30,177,109,68,460,459,1
2022,4,Makkah Region,"Electricity, Gas, Steam, and Air Conditioning Supply",large,2,9440,9439,1,631,631,0
2022,4,Makkah Region,"Electricity, Gas, Steam, and Air Conditioning Supply",micro,67,22,15,7,124,124,0
2022,4,Makkah Region,"Electricity, Gas, Steam, and Air Conditioning Supply",medium,6,187,138,49,346,345,1
2022,4,Najran Region,"Electricity, Gas, Steam, and Air Conditioning Supply",small,1,4,3,1,7,7,0
2022,4,Najran Region,"Electricity, Gas, Steam, and Air Conditioning Supply",micro,8,0,0,0,15,15,0
2022,4,Eastern Province,"Activities of Financial Services, Except Mandatory Social Security",small,7,145,96,49,10,9,1
2022,4,Eastern Province,"Activities of Financial Services, Except Mandatory Social Security",large,2,583,431,152,156,146,10
2022,4,Eastern Province,"Activities of Financial Services, Except Mandatory Social Security",micro,2,5,3,2,2,2,0
2022,4,Eastern Province,"Activities of Financial Services, Except Mandatory Social Security",medium,4,264,169,95,165,161,4
2022,4,Al Bahah Region,"Activities of Financial Services, Except Mandatory Social Security",small,1,0,0,0,6,6,0
2022,4,Riyadh Region,"Activities of Financial Services, Except Mandatory Social Security",small,6,98,80,18,42,41,1
2022,4,Riyadh Region,"Activities of Financial Services, Except Mandatory Social Security",large,8,3241,2007,1234,865,825,40
2022,4,Riyadh Region,"Activities of Financial Services, Except Mandatory Social Security",micro,25,24,11,13,9,9,0
2022,4,Riyadh Region,"Activities of Financial Services, Except Mandatory Social Security",medium,7,711,536,175,259,254,5
2022,4,Qassim Region,"Activities of Financial Services, Except Mandatory Social Security",micro,1,1,1,0,0,0,0
2022,4,Al Madinah Region,"Activities of Financial Services, Except Mandatory Social Security",micro,4,3,1,2,7,6,1
2022,4,Tabuk Region,"Activities of Financial Services, Except Mandatory Social Security",micro,1,1,1,0,0,0,0
2022,4,Jazan Region,"Activities of Financial Services, Except Mandatory Social Security",micro,1,0,0,0,2,2,0
2022,4,Aseer Region,"Activities of Financial Services, Except Mandatory Social Security",micro,1,0,0,0,2,2,0
2022,4,Makkah Region,"Activities of Financial Services, Except Mandatory Social Security",small,10,185,109,76,52,51,1
2022,4,Makkah Region,"Activities of Financial Services, Except Mandatory Social Security",large,1,856,447,409,383,314,69
2022,4,Makkah Region,"Activities of Financial Services, Except Mandatory Social Security",micro,10,1,1,0,17,17,0
2022,4,Makkah Region,"Activities of Financial Services, Except Mandatory Social Security",medium,4,473,302,171,144,136,8
2022,4,Najran Region,"Activities of Financial Services, Except Mandatory Social Security",micro,2,0,0,0,5,5,0
2022,4,Eastern Province,Mining of Metal Ores,small,10,18,15,3,90,90,0
2022,4,Eastern Province,Mining of Metal Ores,large,1,575,571,4,3,3,0
2022,4,Eastern Province,Mining of Metal Ores,micro,63,18,11,7,127,127,0
2022,4,Eastern Province,Mining of Metal Ores,medium,1,80,67,13,55,54,1
2022,4,Al Bahah Region,Mining of Metal Ores,micro,4,0,0,0,5,5,0
2022,4,Al Jawf Region,Mining of Metal Ores,micro,1,0,0,0,4,4,0
2022,4,Northern Borders Region,Mining of Metal Ores,micro,3,0,0,0,7,7,0
2022,4,Riyadh Region,Mining of Metal Ores,small,16,58,26,32,190,187,3
2022,4,Riyadh Region,Mining of Metal Ores,micro,27,14,8,6,45,45,0
2022,4,Riyadh Region,Mining of Metal Ores,medium,1,0,0,0,52,52,0
2022,4,Qassim Region,Mining of Metal Ores,small,1,1,1,0,8,8,0
2022,4,Qassim Region,Mining of Metal Ores,micro,13,3,2,1,29,29,0
2022,4,Qassim Region,Mining of Metal Ores,medium,1,90,90,0,14,14,0
2022,4,Al Madinah Region,Mining of Metal Ores,small,1,0,0,0,7,7,0
2022,4,Al Madinah Region,Mining of Metal Ores,micro,6,1,1,0,14,14,0
2022,4,Tabuk Region,Mining of Metal Ores,small,1,1,1,0,6,6,0
2022,4,Jazan Region,Mining of Metal Ores,micro,7,0,0,0,20,20,0
2022,4,Hail Region,Mining of Metal Ores,micro,2,0,0,0,6,6,0
2022,4,Aseer Region,Mining of Metal Ores,small,4,5,2,3,28,28,0
2022,4,Aseer Region,Mining of Metal Ores,micro,37,3,2,1,65,65,0
2022,4,Makkah Region,Mining of Metal Ores,small,6,24,7,17,68,66,2
2022,4,Makkah Region,Mining of Metal Ores,micro,40,15,8,7,73,73,0
2022,4,Makkah Region,Mining of Metal Ores,medium,4,395,365,30,50,50,0
2022,4,Najran Region,Mining of Metal Ores,small,1,0,0,0,15,15,0
2022,4,Najran Region,Mining of Metal Ores,micro,4,0,0,0,5,5,0
2022,4,Eastern Province,Mining of Coal and Lignite,small,2,6,6,0,13,13,0
2022,4,Eastern Province,Mining of Coal and Lignite,micro,4,2,2,0,7,7,0
2022,4,Riyadh Region,Mining of Coal and Lignite,small,3,5,4,1,26,26,0
2022,4,Riyadh Region,Mining of Coal and Lignite,micro,12,3,2,1,40,40,0
2022,4,Qassim Region,Mining of Coal and Lignite,small,1,2,0,2,15,15,0
2022,4,Qassim Region,Mining of Coal and Lignite,micro,3,1,1,0,6,6,0
2022,4,Hail Region,Mining of Coal and Lignite,micro,1,0,0,0,4,4,0
2022,4,Makkah Region,Mining of Coal and Lignite,small,1,2,0,2,14,14,0
2022,4,Makkah Region,Mining of Coal and Lignite,micro,9,3,3,0,15,15,0
2022,4,Najran Region,Mining of Coal and Lignite,micro,1,0,0,0,4,4,0
2022,4,Eastern Province,Construction of Buildings,small,5063,11712,6188,5524,67581,67401,180
2022,4,Eastern Province,Construction of Buildings,large,132,25750,17551,8199,126767,125951,816
2022,4,Eastern Province,Construction of Buildings,micro,12683,3267,1663,1604,29811,29714,97
2022,4,Eastern Province,Construction of Buildings,medium,746,11484,6899,4585,63930,63813,117
2022,4,Al Bahah Region,Construction of Buildings,small,250,389,270,119,2312,2303,9
2022,4,Al Bahah Region,Construction of Buildings,micro,1252,243,145,98,3066,3060,6
2022,4,Al Bahah Region,Construction of Buildings,medium,5,76,56,20,338,338,0
2022,4,Al Jawf Region,Construction of Buildings,small,257,370,239,131,2727,2717,10
2022,4,Al Jawf Region,Construction of Buildings,large,1,263,197,66,377,306,71
2022,4,Al Jawf Region,Construction of Buildings,micro,1639,228,159,69,4041,4032,9
2022,4,Al Jawf Region,Construction of Buildings,medium,8,147,103,44,628,605,23
2022,4,Northern Borders Region,Construction of Buildings,small,188,295,169,126,1921,1915,6
2022,4,Northern Borders Region,Construction of Buildings,large,3,372,200,172,1952,1929,23
2022,4,Northern Borders Region,Construction of Buildings,micro,1618,153,77,76,4258,4251,7
2022,4,Northern Borders Region,Construction of Buildings,medium,8,95,52,43,530,530,0
2022,4,Riyadh Region,Construction of Buildings,small,7149,15228,6643,8585,90643,89938,705
2022,4,Riyadh Region,Construction of Buildings,large,355,25991,13847,12144,218220,216242,1978
2022,4,Riyadh Region,Construction of Buildings,micro,24480,5712,2672,3040,54261,53843,418
2022,4,Riyadh Region,Construction of Buildings,medium,1084,14424,7150,7274,100320,99628,692
2022,4,Qassim Region,Construction of Buildings,small,1402,2174,1289,885,16200,16125,75
2022,4,Qassim Region,Construction of Buildings,large,34,289,151,138,14014,13978,36
2022,4,Qassim Region,Construction of Buildings,micro,9648,1221,681,540,23088,23042,46
2022,4,Qassim Region,Construction of Buildings,medium,160,1163,765,398,16180,16112,68
2022,4,Al Madinah Region,Construction of Buildings,small,1338,2481,1398,1083,14740,14661,79
2022,4,Al Madinah Region,Construction of Buildings,large,11,2343,1049,1294,17684,17170,514
2022,4,Al Madinah Region,Construction of Buildings,micro,6086,1046,577,469,15240,15181,59
2022,4,Al Madinah Region,Construction of Buildings,medium,78,978,667,311,5921,5918,3
2022,4,Tabuk Region,Construction of Buildings,small,326,515,284,231,3127,3122,5
2022,4,Tabuk Region,Construction of Buildings,large,1,51,51,0,226,226,0
2022,4,Tabuk Region,Construction of Buildings,micro,2800,425,228,197,7107,7096,11
2022,4,Tabuk Region,Construction of Buildings,medium,11,115,59,56,1078,1039,39
2022,4,Jazan Region,Construction of Buildings,small,386,656,313,343,3710,3699,11
2022,4,Jazan Region,Construction of Buildings,micro,4184,626,338,288,10767,10743,24
2022,4,Jazan Region,Construction of Buildings,medium,16,269,159,110,1241,1226,15
2022,4,Hail Region,Construction of Buildings,small,402,609,306,303,4432,4414,18
2022,4,Hail Region,Construction of Buildings,large,1,19,5,14,347,347,0
2022,4,Hail Region,Construction of Buildings,micro,3211,428,222,206,7823,7803,20
2022,4,Hail Region,Construction of Buildings,medium,29,393,256,137,2674,2673,1
2022,4,Aseer Region,Construction of Buildings,small,1058,1700,1016,684,10190,10152,38
2022,4,Aseer Region,Construction of Buildings,large,2,178,169,9,1059,1059,0
2022,4,Aseer Region,Construction of Buildings,micro,8308,1371,770,601,19910,19883,27
2022,4,Aseer Region,Construction of Buildings,medium,41,666,470,196,2825,2824,1
2022,4,Makkah Region,Construction of Buildings,small,5492,9935,4856,5079,63145,62637,508
2022,4,Makkah Region,Construction of Buildings,large,93,13736,9633,4103,90975,90169,806
2022,4,Makkah Region,Construction of Buildings,micro,22102,4515,2265,2250,53773,53337,436
2022,4,Makkah Region,Construction of Buildings,medium,465,7218,4161,3057,37522,37257,265
2022,4,Najran Region,Construction of Buildings,small,392,564,271,293,4275,4263,12
2022,4,Najran Region,Construction of Buildings,large,7,806,418,388,2454,2447,7
2022,4,Najran Region,Construction of Buildings,micro,2776,348,176,172,6644,6617,27
2022,4,Najran Region,Construction of Buildings,medium,44,705,465,240,4332,4329,3
2022,4,Eastern Province,"Water Collection, Treatment, and Supply",small,37,181,128,53,408,408,0
2022,4,Eastern Province,"Water Collection, Treatment, and Supply",large,2,819,808,11,216,216,0
2022,4,Eastern Province,"Water Collection, Treatment, and Supply",micro,81,26,14,12,162,162,0
2022,4,Eastern Province,"Water Collection, Treatment, and Supply",medium,1,143,137,6,104,104,0
2022,4,Al Bahah Region,"Water Collection, Treatment, and Supply",small,2,2,1,1,13,13,0
2022,4,Al Bahah Region,"Water Collection, Treatment, and Supply",micro,30,5,2,3,52,52,0
2022,4,Al Jawf Region,"Water Collection, Treatment, and Supply",small,3,19,13,6,70,70,0
2022,4,Al Jawf Region,"Water Collection, Treatment, and Supply",micro,17,3,3,0,42,42,0
2022,4,Northern Borders Region,"Water Collection, Treatment, and Supply",small,5,5,4,1,30,30,0
2022,4,Northern Borders Region,"Water Collection, Treatment, and Supply",micro,18,3,3,0,43,43,0
2022,4,Riyadh Region,"Water Collection, Treatment, and Supply",small,61,237,126,111,578,578,0
2022,4,Riyadh Region,"Water Collection, Treatment, and Supply",large,1,156,122,34,115,110,5
2022,4,Riyadh Region,"Water Collection, Treatment, and Supply",micro,209,58,23,35,455,450,5
2022,4,Riyadh Region,"Water Collection, Treatment, and Supply",medium,13,481,322,159,963,963,0
2022,4,Qassim Region,"Water Collection, Treatment, and Supply",small,13,37,19,18,112,112,0
2022,4,Qassim Region,"Water Collection, Treatment, and Supply",micro,61,16,9,7,137,137,0
2022,4,Qassim Region,"Water Collection, Treatment, and Supply",medium,1,35,35,0,126,126,0
2022,4,Al Madinah Region,"Water Collection, Treatment, and Supply",small,8,36,28,8,91,91,0
2022,4,Al Madinah Region,"Water Collection, Treatment, and Supply",large,1,734,734,0,186,186,0
2022,4,Al Madinah Region,"Water Collection, Treatment, and Supply",micro,64,12,6,6,119,119,0
2022,4,Al Madinah Region,"Water Collection, Treatment, and Supply",medium,1,29,17,12,69,69,0
2022,4,Tabuk Region,"Water Collection, Treatment, and Supply",small,5,17,13,4,79,79,0
2022,4,Tabuk Region,"Water Collection, Treatment, and Supply",micro,51,12,6,6,104,104,0
2022,4,Jazan Region,"Water Collection, Treatment, and Supply",small,7,58,53,5,42,42,0
2022,4,Jazan Region,"Water Collection, Treatment, and Supply",micro,86,22,12,10,160,160,0
2022,4,Jazan Region,"Water Collection, Treatment, and Supply",medium,1,52,50,2,26,26,0
2022,4,Hail Region,"Water Collection, Treatment, and Supply",small,2,11,9,2,37,37,0
2022,4,Hail Region,"Water Collection, Treatment, and Supply",micro,32,3,1,2,71,71,0
2022,4,Hail Region,"Water Collection, Treatment, and Supply",medium,2,45,32,13,114,114,0
2022,4,Aseer Region,"Water Collection, Treatment, and Supply",small,18,55,26,29,191,191,0
2022,4,Aseer Region,"Water Collection, Treatment, and Supply",micro,140,19,6,13,264,264,0
2022,4,Makkah Region,"Water Collection, Treatment, and Supply",small,64,337,251,86,580,579,1
2022,4,Makkah Region,"Water Collection, Treatment, and Supply",micro,381,87,46,41,808,807,1
2022,4,Makkah Region,"Water Collection, Treatment, and Supply",medium,11,702,611,91,624,623,1
2022,4,Najran Region,"Water Collection, Treatment, and Supply",small,4,6,3,3,63,63,0
2022,4,Najran Region,"Water Collection, Treatment, and Supply",large,1,103,80,23,204,201,3
2022,4,Najran Region,"Water Collection, Treatment, and Supply",micro,26,7,4,3,55,55,0
2022,4,Najran Region,"Water Collection, Treatment, and Supply",medium,1,23,19,4,37,37,0
2022,4,Eastern Province,"Wholesale and Retail Trade, Repair of Motor Vehicles and Motorcycles",small,1932,4554,2902,1652,17487,17466,21
2022,4,Eastern Province,"Wholesale and Retail Trade, Repair of Motor Vehicles and Motorcycles",large,6,917,812,105,1429,1427,2
2022,4,Eastern Province,"Wholesale and Retail Trade, Repair of Motor Vehicles and Motorcycles",micro,7245,2265,1421,844,16551,16527,24
2022,4,Eastern Province,"Wholesale and Retail Trade, Repair of Motor Vehicles and Motorcycles",medium,64,1776,1445,331,3891,3889,2
2022,4,Al Bahah Region,"Wholesale and Retail Trade, Repair of Motor Vehicles and Motorcycles",small,73,138,102,36,513,512,1
2022,4,Al Bahah Region,"Wholesale and Retail Trade, Repair of Motor Vehicles and Motorcycles",micro,704,158,116,42,1509,1508,1
2022,4,Al Jawf Region,"Wholesale and Retail Trade, Repair of Motor Vehicles and Motorcycles",small,127,228,175,53,992,991,1
2022,4,Al Jawf Region,"Wholesale and Retail Trade, Repair of Motor Vehicles and Motorcycles",micro,1037,191,134,57,2411,2409,2
2022,4,Northern Borders Region,"Wholesale and Retail Trade, Repair of Motor Vehicles and Motorcycles",small,79,152,89,63,591,588,3
2022,4,Northern Borders Region,"Wholesale and Retail Trade, Repair of Motor Vehicles and Motorcycles",micro,725,112,86,26,1688,1687,1
2022,4,Riyadh Region,"Wholesale and Retail Trade, Repair of Motor Vehicles and Motorcycles",small,2905,7719,3842,3877,28133,28039,94
2022,4,Riyadh Region,"Wholesale and Retail Trade, Repair of Motor Vehicles and Motorcycles",large,9,1765,1538,227,3965,3961,4
2022,4,Riyadh Region,"Wholesale and Retail Trade, Repair of Motor Vehicles and Motorcycles",micro,14364,3238,1704,1534,33041,32920,121
2022,4,Riyadh Region,"Wholesale and Retail Trade, Repair of Motor Vehicles and Motorcycles",medium,115,2831,1857,974,7940,7903,37
2022,4,Qassim Region,"Wholesale and Retail Trade, Repair of Motor Vehicles and Motorcycles",small,517,1239,853,386,4766,4765,1
2022,4,Qassim Region,"Wholesale and Retail Trade, Repair of Motor Vehicles and Motorcycles",micro,3709,688,453,235,8357,8351,6
2022,4,Qassim Region,"Wholesale and Retail Trade, Repair of Motor Vehicles and Motorcycles",medium,9,109,67,42,680,680,0
2022,4,Al Madinah Region,"Wholesale and Retail Trade, Repair of Motor Vehicles and Motorcycles",small,392,832,564,268,3011,3003,8
2022,4,Al Madinah Region,"Wholesale and Retail Trade, Repair of Motor Vehicles and Motorcycles",micro,3433,709,470,239,7884,7873,11
2022,4,Al Madinah Region,"Wholesale and Retail Trade, Repair of Motor Vehicles and Motorcycles",medium,3,62,45,17,246,246,0
2022,4,Tabuk Region,"Wholesale and Retail Trade, Repair of Motor Vehicles and Motorcycles",small,193,401,292,109,1537,1536,1
2022,4,Tabuk Region,"Wholesale and Retail Trade, Repair of Motor Vehicles and Motorcycles",micro,1722,312,187,125,4090,4083,7
2022,4,Tabuk Region,"Wholesale and Retail Trade, Repair of Motor Vehicles and Motorcycles",medium,1,31,23,8,60,60,0
2022,4,Jazan Region,"Wholesale and Retail Trade, Repair of Motor Vehicles and Motorcycles",small,183,419,284,135,1433,1429,4
2022,4,Jazan Region,"Wholesale and Retail Trade, Repair of Motor Vehicles and Motorcycles",micro,2720,398,271,127,6289,6279,10
2022,4,Jazan Region,"Wholesale and Retail Trade, Repair of Motor Vehicles and Motorcycles",medium,4,75,62,13,232,231,1
2022,4,Hail Region,"Wholesale and Retail Trade, Repair of Motor Vehicles and Motorcycles",small,221,434,265,169,1960,1959,1
2022,4,Hail Region,"Wholesale and Retail Trade, Repair of Motor Vehicles and Motorcycles",micro,1405,239,143,96,3209,3206,3
2022,4,Hail Region,"Wholesale and Retail Trade, Repair of Motor Vehicles and Motorcycles",medium,2,43,29,14,98,98,0
2022,4,Aseer Region,"Wholesale and Retail Trade, Repair of Motor Vehicles and Motorcycles",small,542,1174,769,405,4622,4620,2
2022,4,Aseer Region,"Wholesale and Retail Trade, Repair of Motor Vehicles and Motorcycles",micro,4166,822,540,282,9441,9419,22
2022,4,Aseer Region,"Wholesale and Retail Trade, Repair of Motor Vehicles and Motorcycles",medium,10,219,189,30,532,532,0
2022,4,Makkah Region,"Wholesale and Retail Trade, Repair of Motor Vehicles and Motorcycles",small,1651,4252,2712,1540,14637,14583,54
2022,4,Makkah Region,"Wholesale and Retail Trade, Repair of Motor Vehicles and Motorcycles",large,23,4261,3543,718,7498,7472,26
2022,4,Makkah Region,"Wholesale and Retail Trade, Repair of Motor Vehicles and Motorcycles",micro,11457,2455,1478,977,26677,26547,130
2022,4,Makkah Region,"Wholesale and Retail Trade, Repair of Motor Vehicles and Motorcycles",medium,71,2213,1753,460,4384,4368,16
2022,4,Najran Region,"Wholesale and Retail Trade, Repair of Motor Vehicles and Motorcycles",small,118,237,141,96,1003,1002,1
2022,4,Najran Region,"Wholesale and Retail Trade, Repair of Motor Vehicles and Motorcycles",micro,899,139,83,56,2103,2098,5
2022,4,Najran Region,"Wholesale and Retail Trade, Repair of Motor Vehicles and Motorcycles",medium,5,97,58,39,259,258,1
2022,4,Eastern Province,Wholesale Trade (Except of Motor Vehicles and Motorcycles),small,2305,9027,5103,3924,21992,21894,98
2022,4,Eastern Province,Wholesale Trade (Except of Motor Vehicles and Motorcycles),large,19,4200,2758,1442,5001,4986,15
2022,4,Eastern Province,Wholesale Trade (Except of Motor Vehicles and Motorcycles),micro,6722,3606,2047,1559,12898,12825,73
2022,4,Eastern Province,Wholesale Trade (Except of Motor Vehicles and Motorcycles),medium,168,5913,3804,2109,10560,10476,84
2022,4,Al Bahah Region,Wholesale Trade (Except of Motor Vehicles and Motorcycles),small,98,293,208,85,798,797,1
2022,4,Al Bahah Region,Wholesale Trade (Except of Motor Vehicles and Motorcycles),micro,429,171,120,51,791,785,6
2022,4,Al Bahah Region,Wholesale Trade (Except of Motor Vehicles and Motorcycles),medium,2,48,33,15,88,88,0
2022,4,Al Jawf Region,Wholesale Trade (Except of Motor Vehicles and Motorcycles),small,122,336,227,109,1026,1024,2
2022,4,Al Jawf Region,Wholesale Trade (Except of Motor Vehicles and Motorcycles),micro,645,199,139,60,1299,1293,6
2022,4,Al Jawf Region,Wholesale Trade (Except of Motor Vehicles and Motorcycles),medium,2,85,29,56,165,164,1
2022,4,Northern Borders Region,Wholesale Trade (Except of Motor Vehicles and Motorcycles),small,50,127,68,59,387,386,1
2022,4,Northern Borders Region,Wholesale Trade (Except of Motor Vehicles and Motorcycles),micro,400,109,67,42,874,873,1
2022,4,Northern Borders Region,Wholesale Trade (Except of Motor Vehicles and Motorcycles),medium,1,0,0,0,108,108,0
2022,4,Riyadh Region,Wholesale Trade (Except of Motor Vehicles and Motorcycles),small,5429,21410,9769,11641,54649,53968,681
2022,4,Riyadh Region,Wholesale Trade (Except of Motor Vehicles and Motorcycles),large,49,15794,11221,4573,15496,15277,219
2022,4,Riyadh Region,Wholesale Trade (Except of Motor Vehicles and Motorcycles),micro,17254,7097,3426,3671,34188,33679,509
2022,4,Riyadh Region,Wholesale Trade (Except of Motor Vehicles and Motorcycles),medium,409,14085,7493,6592,25373,24985,388
2022,4,Qassim Region,Wholesale Trade (Except of Motor Vehicles and Motorcycles),small,448,1568,997,571,4230,4213,17
2022,4,Qassim Region,Wholesale Trade (Except of Motor Vehicles and Motorcycles),large,1,304,90,214,3,3,0
2022,4,Qassim Region,Wholesale Trade (Except of Motor Vehicles and Motorcycles),micro,2263,799,534,265,4503,4482,21
2022,4,Qassim Region,Wholesale Trade (Except of Motor Vehicles and Motorcycles),medium,22,334,238,96,1615,1597,18
2022,4,Al Madinah Region,Wholesale Trade (Except of Motor Vehicles and Motorcycles),small,636,2089,1300,789,5270,5228,42
2022,4,Al Madinah Region,Wholesale Trade (Except of Motor Vehicles and Motorcycles),micro,3156,1071,675,396,6454,6398,56
2022,4,Al Madinah Region,Wholesale Trade (Except of Motor Vehicles and Motorcycles),medium,17,461,326,135,1034,1031,3
2022,4,Tabuk Region,Wholesale Trade (Except of Motor Vehicles and Motorcycles),small,152,557,300,257,1500,1495,5
2022,4,Tabuk Region,Wholesale Trade (Except of Motor Vehicles and Motorcycles),micro,937,358,192,166,1791,1783,8
2022,4,Tabuk Region,Wholesale Trade (Except of Motor Vehicles and Motorcycles),medium,9,193,124,69,496,494,2
2022,4,Jazan Region,Wholesale Trade (Except of Motor Vehicles and Motorcycles),small,260,796,443,353,2424,2421,3
2022,4,Jazan Region,Wholesale Trade (Except of Motor Vehicles and Motorcycles),micro,1824,467,295,172,3946,3925,21
2022,4,Jazan Region,Wholesale Trade (Except of Motor Vehicles and Motorcycles),medium,5,76,61,15,372,370,2
2022,4,Hail Region,Wholesale Trade (Except of Motor Vehicles and Motorcycles),small,167,554,292,262,1448,1440,8
2022,4,Hail Region,Wholesale Trade (Except of Motor Vehicles and Motorcycles),micro,772,243,141,102,1624,1619,5
2022,4,Hail Region,Wholesale Trade (Except of Motor Vehicles and Motorcycles),medium,4,81,50,31,194,194,0
2022,4,Aseer Region,Wholesale Trade (Except of Motor Vehicles and Motorcycles),small,549,1865,1211,654,4787,4780,7
2022,4,Aseer Region,Wholesale Trade (Except of Motor Vehicles and Motorcycles),micro,2279,899,584,315,4698,4677,21
2022,4,Aseer Region,Wholesale Trade (Except of Motor Vehicles and Motorcycles),medium,18,502,308,194,1004,999,5
2022,4,Makkah Region,Wholesale Trade (Except of Motor Vehicles and Motorcycles),small,4944,18294,8846,9448,48598,47966,632
2022,4,Makkah Region,Wholesale Trade (Except of Motor Vehicles and Motorcycles),large,38,7677,5455,2222,9611,9438,173
2022,4,Makkah Region,Wholesale Trade (Except of Motor Vehicles and Motorcycles),micro,15248,5724,2849,2875,31591,31017,574
2022,4,Makkah Region,Wholesale Trade (Except of Motor Vehicles and Motorcycles),medium,347,12048,6640,5408,21057,20785,272
2022,4,Najran Region,Wholesale Trade (Except of Motor Vehicles and Motorcycles),small,108,334,181,153,1007,996,11
2022,4,Najran Region,Wholesale Trade (Except of Motor Vehicles and Motorcycles),micro,623,197,119,78,1421,1411,10
2022,4,Najran Region,Wholesale Trade (Except of Motor Vehicles and Motorcycles),medium,6,155,93,62,287,287,0
2022,4,Eastern Province,Retail Trade (Except of Motor Vehicles and Motorcycles),small,3499,12431,6144,6287,30717,30497,220
2022,4,Eastern Province,Retail Trade (Except of Motor Vehicles and Motorcycles),large,28,7181,3669,3512,10560,9855,705
2022,4,Eastern Province,Retail Trade (Except of Motor Vehicles and Motorcycles),micro,17441,7740,4047,3693,33951,33761,190
2022,4,Eastern Province,Retail Trade (Except of Motor Vehicles and Motorcycles),medium,216,7354,3645,3709,14109,14011,98
2022,4,Al Bahah Region,Retail Trade (Except of Motor Vehicles and Motorcycles),small,229,702,440,262,1769,1767,2
2022,4,Al Bahah Region,Retail Trade (Except of Motor Vehicles and Motorcycles),micro,1590,652,421,231,2890,2872,18
2022,4,Al Bahah Region,Retail Trade (Except of Motor Vehicles and Motorcycles),medium,3,48,41,7,141,141,0
2022,4,Al Jawf Region,Retail Trade (Except of Motor Vehicles and Motorcycles),small,299,813,480,333,2354,2327,27
2022,4,Al Jawf Region,Retail Trade (Except of Motor Vehicles and Motorcycles),micro,2578,752,490,262,5005,4988,17
2022,4,Al Jawf Region,Retail Trade (Except of Motor Vehicles and Motorcycles),medium,6,166,64,102,346,346,0
2022,4,Northern Borders Region,Retail Trade (Except of Motor Vehicles and Motorcycles),small,170,470,257,213,1371,1359,12
2022,4,Northern Borders Region,Retail Trade (Except of Motor Vehicles and Motorcycles),micro,1930,461,250,211,3971,3952,19
2022,4,Northern Borders Region,Retail Trade (Except of Motor Vehicles and Motorcycles),medium,3,47,30,17,253,245,8
2022,4,Riyadh Region,Retail Trade (Except of Motor Vehicles and Motorcycles),small,7144,27345,11952,15393,70362,69394,968
2022,4,Riyadh Region,Retail Trade (Except of Motor Vehicles and Motorcycles),large,102,37431,19889,17542,54624,53868,756
2022,4,Riyadh Region,Retail Trade (Except of Motor Vehicles and Motorcycles),micro,33709,11940,5803,6137,69194,68287,907
2022,4,Riyadh Region,Retail Trade (Except of Motor Vehicles and Motorcycles),medium,612,19050,8875,10175,39191,38541,650
2022,4,Qassim Region,Retail Trade (Except of Motor Vehicles and Motorcycles),small,1082,3615,2288,1327,9800,9752,48
2022,4,Qassim Region,Retail Trade (Except of Motor Vehicles and Motorcycles),large,4,593,180,413,1232,1227,5
2022,4,Qassim Region,Retail Trade (Except of Motor Vehicles and Motorcycles),micro,6846,2272,1450,822,13601,13536,65
2022,4,Qassim Region,Retail Trade (Except of Motor Vehicles and Motorcycles),medium,60,1266,810,456,3685,3681,4
2022,4,Al Madinah Region,Retail Trade (Except of Motor Vehicles and Motorcycles),small,1360,4233,2409,1824,10901,10833,68
2022,4,Al Madinah Region,Retail Trade (Except of Motor Vehicles and Motorcycles),large,1,87,52,35,221,221,0
2022,4,Al Madinah Region,Retail Trade (Except of Motor Vehicles and Motorcycles),micro,10294,3284,2031,1253,21040,20843,197
2022,4,Al Madinah Region,Retail Trade (Except of Motor Vehicles and Motorcycles),medium,55,1736,759,977,3007,2967,40
2022,4,Tabuk Region,Retail Trade (Except of Motor Vehicles and Motorcycles),small,426,1268,613,655,3085,3076,9
2022,4,Tabuk Region,Retail Trade (Except of Motor Vehicles and Motorcycles),large,1,131,102,29,228,228,0
2022,4,Tabuk Region,Retail Trade (Except of Motor Vehicles and Motorcycles),micro,3923,1137,621,516,7759,7718,41
2022,4,Tabuk Region,Retail Trade (Except of Motor Vehicles and Motorcycles),medium,6,321,96,225,429,429,0
2022,4,Jazan Region,Retail Trade (Except of Motor Vehicles and Motorcycles),small,726,2161,1137,1024,5881,5859,22
2022,4,Jazan Region,Retail Trade (Except of Motor Vehicles and Motorcycles),large,1,112,102,10,230,230,0
2022,4,Jazan Region,Retail Trade (Except of Motor Vehicles and Motorcycles),micro,7312,1967,1144,823,15021,14914,107
2022,4,Jazan Region,Retail Trade (Except of Motor Vehicles and Motorcycles),medium,14,549,202,347,866,854,12
2022,4,Hail Region,Retail Trade (Except of Motor Vehicles and Motorcycles),small,413,1201,612,589,3427,3398,29
2022,4,Hail Region,Retail Trade (Except of Motor Vehicles and Motorcycles),large,1,178,73,105,217,217,0
2022,4,Hail Region,Retail Trade (Except of Motor Vehicles and Motorcycles),micro,3432,1038,535,503,6891,6857,34
2022,4,Hail Region,Retail Trade (Except of Motor Vehicles and Motorcycles),medium,14,302,114,188,643,642,1
2022,4,Aseer Region,Retail Trade (Except of Motor Vehicles and Motorcycles),small,1209,4112,2228,1884,9725,9674,51
2022,4,Aseer Region,Retail Trade (Except of Motor Vehicles and Motorcycles),large,2,451,189,262,474,471,3
2022,4,Aseer Region,Retail Trade (Except of Motor Vehicles and Motorcycles),micro,9406,3306,2051,1255,18301,18201,100
2022,4,Aseer Region,Retail Trade (Except of Motor Vehicles and Motorcycles),medium,33,876,378,498,1761,1721,40
2022,4,Makkah Region,Retail Trade (Except of Motor Vehicles and Motorcycles),small,6161,22657,10354,12303,55741,54971,770
2022,4,Makkah Region,Retail Trade (Except of Motor Vehicles and Motorcycles),large,44,11560,5779,5781,12736,12342,394
2022,4,Makkah Region,Retail Trade (Except of Motor Vehicles and Motorcycles),micro,33701,11166,5916,5250,70184,69121,1063
2022,4,Makkah Region,Retail Trade (Except of Motor Vehicles and Motorcycles),medium,378,12787,6368,6419,23265,22863,402
2022,4,Najran Region,Retail Trade (Except of Motor Vehicles and Motorcycles),small,325,985,481,504,2848,2826,22
2022,4,Najran Region,Retail Trade (Except of Motor Vehicles and Motorcycles),micro,2657,622,345,277,5523,5494,29
2022,4,Najran Region,Retail Trade (Except of Motor Vehicles and Motorcycles),medium,7,225,88,137,579,576,3
2022,4,Eastern Province,"Crop and Animal Production, Hunting and Related Services",small,287,348,187,161,3271,3266,5
2022,4,Eastern Province,"Crop and Animal Production, Hunting and Related Services",large,2,546,420,126,2212,2210,2
2022,4,Eastern Province,"Crop and Animal Production, Hunting and Related Services",micro,2002,246,127,119,3020,3014,6
2022,4,Eastern Province,"Crop and Animal Production, Hunting and Related Services",medium,21,250,160,90,1663,1662,1
2022,4,Al Bahah Region,"Crop and Animal Production, Hunting and Related Services",small,6,4,4,0,43,43,0
2022,4,Al Bahah Region,"Crop and Animal Production, Hunting and Related Services",micro,178,6,4,2,225,224,1
2022,4,Al Jawf Region,"Crop and Animal Production, Hunting and Related Services",small,26,41,24,17,233,233,0
2022,4,Al Jawf Region,"Crop and Animal Production, Hunting and Related Services",large,1,127,117,10,801,798,3
2022,4,Al Jawf Region,"Crop and Animal Production, Hunting and Related Services",micro,846,63,41,22,1212,1206,6
2022,4,Al Jawf Region,"Crop and Animal Production, Hunting and Related Services",medium,2,85,59,26,105,105,0
2022,4,Northern Borders Region,"Crop and Animal Production, Hunting and Related Services",small,2,1,1,0,16,16,0
2022,4,Northern Borders Region,"Crop and Animal Production, Hunting and Related Services",micro,98,6,3,3,124,124,0
2022,4,Riyadh Region,"Crop and Animal Production, Hunting and Related Services",small,495,993,439,554,6371,6347,24
2022,4,Riyadh Region,"Crop and Animal Production, Hunting and Related Services",large,18,2113,1849,264,15121,15104,17
2022,4,Riyadh Region,"Crop and Animal Production, Hunting and Related Services",micro,7717,611,283,328,13777,13718,59
2022,4,Riyadh Region,"Crop and Animal Production, Hunting and Related Services",medium,77,841,394,447,7182,7156,26
2022,4,Qassim Region,"Crop and Animal Production, Hunting and Related Services",small,99,160,91,69,1275,1272,3
2022,4,Qassim Region,"Crop and Animal Production, Hunting and Related Services",large,4,1545,1148,397,5913,5912,1
2022,4,Qassim Region,"Crop and Animal Production, Hunting and Related Services",micro,1326,149,98,51,2026,2015,11
2022,4,Qassim Region,"Crop and Animal Production, Hunting and Related Services",medium,14,178,125,53,1217,1215,2
2022,4,Al Madinah Region,"Crop and Animal Production, Hunting and Related Services",small,53,87,50,37,561,558,3
2022,4,Al Madinah Region,"Crop and Animal Production, Hunting and Related Services",micro,973,102,73,29,1367,1359,8
2022,4,Al Madinah Region,"Crop and Animal Production, Hunting and Related Services",medium,3,57,35,22,245,244,1
2022,4,Tabuk Region,"Crop and Animal Production, Hunting and Related Services",small,38,39,21,18,483,483,0
2022,4,Tabuk Region,"Crop and Animal Production, Hunting and Related Services",large,2,257,163,94,1229,1228,1
2022,4,Tabuk Region,"Crop and Animal Production, Hunting and Related Services",micro,966,47,26,21,1246,1246,0
2022,4,Tabuk Region,"Crop and Animal Production, Hunting and Related Services",medium,2,0,0,0,195,193,2
2022,4,Jazan Region,"Crop and Animal Production, Hunting and Related Services",small,41,38,22,16,442,440,2
2022,4,Jazan Region,"Crop and Animal Production, Hunting and Related Services",micro,776,28,20,8,1297,1294,3
2022,4,Jazan Region,"Crop and Animal Production, Hunting and Related Services",medium,1,6,4,2,52,52,0
2022,4,Hail Region,"Crop and Animal Production, Hunting and Related Services",small,48,39,21,18,533,530,3
2022,4,Hail Region,"Crop and Animal Production, Hunting and Related Services",large,2,702,686,16,2100,2099,1
2022,4,Hail Region,"Crop and Animal Production, Hunting and Related Services",micro,1551,91,42,49,2806,2801,5
2022,4,Hail Region,"Crop and Animal Production, Hunting and Related Services",medium,7,39,24,15,561,559,2
2022,4,Aseer Region,"Crop and Animal Production, Hunting and Related Services",small,63,93,62,31,731,730,1
2022,4,Aseer Region,"Crop and Animal Production, Hunting and Related Services",micro,1215,73,49,24,1540,1535,5
2022,4,Aseer Region,"Crop and Animal Production, Hunting and Related Services",medium,5,44,29,15,456,456,0
2022,4,Makkah Region,"Crop and Animal Production, Hunting and Related Services",small,111,152,73,79,1094,1088,6
2022,4,Makkah Region,"Crop and Animal Production, Hunting and Related Services",large,3,523,311,212,2576,2575,1
2022,4,Makkah Region,"Crop and Animal Production, Hunting and Related Services",micro,2269,141,71,70,3311,3300,11
2022,4,Makkah Region,"Crop and Animal Production, Hunting and Related Services",medium,7,77,34,43,610,534,76
2022,4,Najran Region,"Crop and Animal Production, Hunting and Related Services",small,22,19,9,10,224,224,0
2022,4,Najran Region,"Crop and Animal Production, Hunting and Related Services",micro,739,24,13,11,1120,1115,5
2022,4,Najran Region,"Crop and Animal Production, Hunting and Related Services",medium,3,12,10,2,268,268,0
2022,4,Eastern Province,Support Services to Mining,small,56,523,435,88,618,611,7
2022,4,Eastern Province,Support Services to Mining,large,27,26961,25984,977,10860,10841,19
2022,4,Eastern Province,Support Services to Mining,micro,71,83,60,23,94,93,1
2022,4,Eastern Province,Support Services to Mining,medium,23,1391,1239,152,1108,1102,6
2022,4,Al Bahah Region,Support Services to Mining,micro,3,0,0,0,7,7,0
2022,4,Al Jawf Region,Support Services to Mining,micro,6,0,0,0,13,13,0
2022,4,Northern Borders Region,Support Services to Mining,small,2,5,3,2,24,24,0
2022,4,Riyadh Region,Support Services to Mining,small,11,72,50,22,111,111,0
2022,4,Riyadh Region,Support Services to Mining,large,1,460,374,86,122,122,0
2022,4,Riyadh Region,Support Services to Mining,micro,44,56,41,15,36,36,0
2022,4,Riyadh Region,Support Services to Mining,medium,2,83,70,13,115,113,2
2022,4,Qassim Region,Support Services to Mining,micro,3,2,1,1,11,11,0
2022,4,Al Madinah Region,Support Services to Mining,micro,6,2,1,1,6,6,0
2022,4,Tabuk Region,Support Services to Mining,small,1,3,2,1,12,12,0
2022,4,Tabuk Region,Support Services to Mining,micro,1,0,0,0,1,1,0
2022,4,Jazan Region,Support Services to Mining,small,1,0,0,0,22,22,0
2022,4,Jazan Region,Support Services to Mining,micro,6,2,2,0,11,11,0
2022,4,Hail Region,Support Services to Mining,micro,4,0,0,0,8,8,0
2022,4,Aseer Region,Support Services to Mining,micro,15,2,1,1,28,28,0
2022,4,Makkah Region,Support Services to Mining,small,8,33,23,10,63,62,1
2022,4,Makkah Region,Support Services to Mining,large,2,234,140,94,502,501,1
2022,4,Makkah Region,Support Services to Mining,micro,30,15,10,5,51,51,0
2022,4,Makkah Region,Support Services to Mining,medium,3,245,212,33,172,169,3
2022,4,Najran Region,Support Services to Mining,micro,1,1,1,0,0,0,0
2022,4,Eastern Province,Information Service Activities,small,17,91,54,37,115,112,3
2022,4,Eastern Province,Information Service Activities,large,1,250,180,70,10,8,2
2022,4,Eastern Province,Information Service Activities,micro,43,47,20,27,54,54,0
2022,4,Eastern Province,Information Service Activities,medium,5,349,127,222,127,124,3
2022,4,Al Jawf Region,Information Service Activities,small,1,0,0,0,7,7,0
2022,4,Al Jawf Region,Information Service Activities,micro,7,3,2,1,9,9,0
2022,4,Northern Borders Region,Information Service Activities,micro,1,0,0,0,1,1,0
2022,4,Riyadh Region,Information Service Activities,small,161,1207,615,592,1442,1377,65
2022,4,Riyadh Region,Information Service Activities,large,9,8220,5077,3143,3072,2977,95
2022,4,Riyadh Region,Information Service Activities,micro,271,263,145,118,387,364,23
2022,4,Riyadh Region,Information Service Activities,medium,42,2470,1430,1040,2117,2038,79
2022,4,Qassim Region,Information Service Activities,small,2,4,2,2,22,22,0
2022,4,Qassim Region,Information Service Activities,micro,8,4,1,3,12,12,0
2022,4,Al Madinah Region,Information Service Activities,small,2,3,0,3,10,10,0
2022,4,Al Madinah Region,Information Service Activities,micro,14,7,4,3,22,21,1
2022,4,Al Madinah Region,Information Service Activities,medium,1,60,19,41,6,5,1
2022,4,Tabuk Region,Information Service Activities,micro,9,5,1,4,11,11,0
2022,4,Jazan Region,Information Service Activities,micro,4,1,0,1,9,9,0
2022,4,Hail Region,Information Service Activities,small,1,14,9,5,7,7,0
2022,4,Hail Region,Information Service Activities,micro,4,2,0,2,10,10,0
2022,4,Aseer Region,Information Service Activities,micro,8,5,2,3,10,9,1
2022,4,Makkah Region,Information Service Activities,small,46,283,117,166,387,376,11
2022,4,Makkah Region,Information Service Activities,micro,119,73,34,39,189,181,8
2022,4,Makkah Region,Information Service Activities,medium,5,281,117,164,207,186,21
2022,4,Najran Region,Information Service Activities,micro,1,0,0,0,1,1,0
2022,4,Eastern Province,Food and Beverage Service Activities,small,3720,10455,4909,5546,38265,38113,152
2022,4,Eastern Province,Food and Beverage Service Activities,large,16,2653,1841,812,6389,6313,76
2022,4,Eastern Province,Food and Beverage Service Activities,micro,9529,3445,1561,1884,21238,21145,93
2022,4,Eastern Province,Food and Beverage Service Activities,medium,207,4583,1952,2631,14236,14187,49
2022,4,Al Bahah Region,Food and Beverage Service Activities,small,224,534,363,171,2013,2004,9
2022,4,Al Bahah Region,Food and Beverage Service Activities,micro,893,296,184,112,1910,1898,12
2022,4,Al Bahah Region,Food and Beverage Service Activities,medium,2,68,42,26,193,192,1
2022,4,Al Jawf Region,Food and Beverage Service Activities,small,226,525,354,171,2230,2229,1
2022,4,Al Jawf Region,Food and Beverage Service Activities,large,1,73,22,51,196,195,1
2022,4,Al Jawf Region,Food and Beverage Service Activities,micro,1165,256,163,93,2585,2576,9
2022,4,Al Jawf Region,Food and Beverage Service Activities,medium,4,83,61,22,195,195,0
2022,4,Northern Borders Region,Food and Beverage Service Activities,small,152,299,166,133,1548,1542,6
2022,4,Northern Borders Region,Food and Beverage Service Activities,micro,1152,196,113,83,2821,2807,14
2022,4,Northern Borders Region,Food and Beverage Service Activities,medium,5,78,26,52,315,308,7
2022,4,Riyadh Region,Food and Beverage Service Activities,small,4751,14756,5996,8760,53958,53403,555
2022,4,Riyadh Region,Food and Beverage Service Activities,large,67,17434,11457,5977,37176,36432,744
2022,4,Riyadh Region,Food and Beverage Service Activities,micro,13779,4214,1888,2326,30179,29887,292
2022,4,Riyadh Region,Food and Beverage Service Activities,medium,479,10863,4515,6348,32867,32430,437
2022,4,Qassim Region,Food and Beverage Service Activities,small,933,2238,1387,851,9248,9226,22
2022,4,Qassim Region,Food and Beverage Service Activities,micro,4352,943,602,341,10893,10865,28
2022,4,Qassim Region,Food and Beverage Service Activities,medium,37,692,388,304,2357,2356,1
2022,4,Al Madinah Region,Food and Beverage Service Activities,small,1228,3036,1667,1369,11754,11708,46
2022,4,Al Madinah Region,Food and Beverage Service Activities,large,2,198,158,40,523,521,2
2022,4,Al Madinah Region,Food and Beverage Service Activities,micro,5608,1421,789,632,12343,12244,99
2022,4,Al Madinah Region,Food and Beverage Service Activities,medium,33,607,369,238,1818,1813,5
2022,4,Tabuk Region,Food and Beverage Service Activities,small,452,1096,506,590,4564,4549,15
2022,4,Tabuk Region,Food and Beverage Service Activities,large,2,172,54,118,497,455,42
2022,4,Tabuk Region,Food and Beverage Service Activities,micro,2473,509,253,256,5621,5602,19
2022,4,Tabuk Region,Food and Beverage Service Activities,medium,13,250,123,127,813,812,1
2022,4,Jazan Region,Food and Beverage Service Activities,small,687,1743,929,814,6469,6454,15
2022,4,Jazan Region,Food and Beverage Service Activities,micro,4677,915,490,425,10316,10270,46
2022,4,Jazan Region,Food and Beverage Service Activities,medium,13,178,97,81,663,663,0
2022,4,Hail Region,Food and Beverage Service Activities,small,340,738,415,323,3293,3275,18
2022,4,Hail Region,Food and Beverage Service Activities,large,2,158,64,94,476,469,7
2022,4,Hail Region,Food and Beverage Service Activities,micro,1965,380,214,166,4581,4557,24
2022,4,Hail Region,Food and Beverage Service Activities,medium,13,228,127,101,827,824,3
2022,4,Aseer Region,Food and Beverage Service Activities,small,1335,3308,1856,1452,13132,13105,27
2022,4,Aseer Region,Food and Beverage Service Activities,micro,6382,1643,858,785,14437,14363,74
2022,4,Aseer Region,Food and Beverage Service Activities,medium,50,843,450,393,2657,2644,13
2022,4,Makkah Region,Food and Beverage Service Activities,small,4484,12974,6065,6909,48083,47520,563
2022,4,Makkah Region,Food and Beverage Service Activities,large,25,7467,5282,2185,15679,15459,220
2022,4,Makkah Region,Food and Beverage Service Activities,micro,17477,4718,2240,2478,37949,37430,519
2022,4,Makkah Region,Food and Beverage Service Activities,medium,295,6366,3115,3251,18838,18565,273
2022,4,Najran Region,Food and Beverage Service Activities,small,231,523,228,295,2455,2449,6
2022,4,Najran Region,Food and Beverage Service Activities,large,1,140,73,67,403,401,2
2022,4,Najran Region,Food and Beverage Service Activities,micro,1646,294,126,168,3822,3803,19
2022,4,Najran Region,Food and Beverage Service Activities,medium,9,175,57,118,679,676,3
2022,4,Eastern Province,"Waste Collection, Treatment, and Disposal, Materials Recovery",small,47,158,88,70,629,628,1
2022,4,Eastern Province,"Waste Collection, Treatment, and Disposal, Materials Recovery",large,3,1546,924,622,5745,4364,1381
2022,4,Eastern Province,"Waste Collection, Treatment, and Disposal, Materials Recovery",micro,42,34,20,14,73,72,1
2022,4,Eastern Province,"Waste Collection, Treatment, and Disposal, Materials Recovery",medium,14,348,235,113,1223,1220,3
2022,4,Al Bahah Region,"Waste Collection, Treatment, and Disposal, Materials Recovery",micro,1,0,0,0,2,2,0
2022,4,Al Jawf Region,"Waste Collection, Treatment, and Disposal, Materials Recovery",small,1,2,0,2,15,15,0
2022,4,Al Jawf Region,"Waste Collection, Treatment, and Disposal, Materials Recovery",micro,3,0,0,0,3,3,0
2022,4,Northern Borders Region,"Waste Collection, Treatment, and Disposal, Materials Recovery",micro,1,1,1,0,0,0,0
2022,4,Riyadh Region,"Waste Collection, Treatment, and Disposal, Materials Recovery",small,49,173,78,95,686,682,4
2022,4,Riyadh Region,"Waste Collection, Treatment, and Disposal, Materials Recovery",large,11,6652,3964,2688,35485,33923,1562
2022,4,Riyadh Region,"Waste Collection, Treatment, and Disposal, Materials Recovery",micro,112,49,24,25,243,241,2
2022,4,Riyadh Region,"Waste Collection, Treatment, and Disposal, Materials Recovery",medium,15,423,315,108,1423,1421,2
2022,4,Qassim Region,"Waste Collection, Treatment, and Disposal, Materials Recovery",small,10,32,17,15,121,121,0
2022,4,Qassim Region,"Waste Collection, Treatment, and Disposal, Materials Recovery",micro,11,3,1,2,21,21,0
2022,4,Qassim Region,"Waste Collection, Treatment, and Disposal, Materials Recovery",medium,2,27,16,11,158,105,53
2022,4,Al Madinah Region,"Waste Collection, Treatment, and Disposal, Materials Recovery",small,5,52,29,23,69,69,0
2022,4,Al Madinah Region,"Waste Collection, Treatment, and Disposal, Materials Recovery",large,1,179,83,96,197,197,0
2022,4,Al Madinah Region,"Waste Collection, Treatment, and Disposal, Materials Recovery",micro,10,9,1,8,19,19,0
2022,4,Al Madinah Region,"Waste Collection, Treatment, and Disposal, Materials Recovery",medium,2,31,17,14,134,134,0
2022,4,Tabuk Region,"Waste Collection, Treatment, and Disposal, Materials Recovery",micro,4,3,2,1,7,7,0
2022,4,Jazan Region,"Waste Collection, Treatment, and Disposal, Materials Recovery",small,6,12,7,5,71,71,0
2022,4,Jazan Region,"Waste Collection, Treatment, and Disposal, Materials Recovery",micro,5,2,1,1,6,6,0
2022,4,Jazan Region,"Waste Collection, Treatment, and Disposal, Materials Recovery",medium,1,14,5,9,50,50,0
2022,4,Hail Region,"Waste Collection, Treatment, and Disposal, Materials Recovery",small,1,1,0,1,5,5,0
2022,4,Hail Region,"Waste Collection, Treatment, and Disposal, Materials Recovery",micro,6,2,1,1,13,13,0
2022,4,Aseer Region,"Waste Collection, Treatment, and Disposal, Materials Recovery",small,1,1,1,0,6,6,0
2022,4,Aseer Region,"Waste Collection, Treatment, and Disposal, Materials Recovery",micro,15,2,1,1,29,29,0
2022,4,Aseer Region,"Waste Collection, Treatment, and Disposal, Materials Recovery",medium,3,192,121,71,356,356,0
2022,4,Makkah Region,"Waste Collection, Treatment, and Disposal, Materials Recovery",small,52,172,94,78,619,613,6
2022,4,Makkah Region,"Waste Collection, Treatment, and Disposal, Materials Recovery",large,4,1357,650,707,5796,5740,56
2022,4,Makkah Region,"Waste Collection, Treatment, and Disposal, Materials Recovery",micro,85,49,24,25,158,156,2
2022,4,Makkah Region,"Waste Collection, Treatment, and Disposal, Materials Recovery",medium,6,75,48,27,342,342,0
2022,4,Najran Region,"Waste Collection, Treatment, and Disposal, Materials Recovery",small,3,5,2,3,15,15,0
2022,4,Najran Region,"Waste Collection, Treatment, and Disposal, Materials Recovery",micro,9,1,0,1,23,23,0
2022,4,Eastern Province,Services to Buildings and Landscape Activities,small,514,1583,823,760,6793,6706,87
2022,4,Eastern Province,Services to Buildings and Landscape Activities,large,77,14635,10500,4135,70607,69311,1296
2022,4,Eastern Province,Services to Buildings and Landscape Activities,micro,1206,372,201,171,2518,2500,18
2022,4,Eastern Province,Services to Buildings and Landscape Activities,medium,147,3461,2229,1232,13291,12957,334
2022,4,Al Bahah Region,Services to Buildings and Landscape Activities,small,9,30,20,10,94,94,0
2022,4,Al Bahah Region,Services to Buildings and Landscape Activities,large,1,109,55,54,613,558,55
2022,4,Al Bahah Region,Services to Buildings and Landscape Activities,micro,49,13,7,6,105,105,0
2022,4,Al Bahah Region,Services to Buildings and Landscape Activities,medium,3,123,84,39,330,329,1
2022,4,Al Jawf Region,Services to Buildings and Landscape Activities,small,29,84,36,48,279,277,2
2022,4,Al Jawf Region,Services to Buildings and Landscape Activities,large,1,78,25,53,261,261,0
2022,4,Al Jawf Region,Services to Buildings and Landscape Activities,micro,186,32,14,18,433,425,8
2022,4,Al Jawf Region,Services to Buildings and Landscape Activities,medium,4,58,39,19,197,197,0
2022,4,Northern Borders Region,Services to Buildings and Landscape Activities,small,10,42,18,24,103,103,0
2022,4,Northern Borders Region,Services to Buildings and Landscape Activities,large,1,272,150,122,626,514,112
2022,4,Northern Borders Region,Services to Buildings and Landscape Activities,micro,78,13,6,7,198,197,1
2022,4,Northern Borders Region,Services to Buildings and Landscape Activities,medium,2,59,46,13,137,137,0
2022,4,Riyadh Region,Services to Buildings and Landscape Activities,small,1386,4512,2119,2393,18853,18464,389
2022,4,Riyadh Region,Services to Buildings and Landscape Activities,large,194,39490,23228,16262,154541,143304,11237
2022,4,Riyadh Region,Services to Buildings and Landscape Activities,micro,3596,1125,547,578,7532,7440,92
2022,4,Riyadh Region,Services to Buildings and Landscape Activities,medium,473,8809,4117,4692,43396,41774,1622
2022,4,Qassim Region,Services to Buildings and Landscape Activities,small,200,459,251,208,3095,3078,17
2022,4,Qassim Region,Services to Buildings and Landscape Activities,large,38,1601,708,893,15532,15254,278
2022,4,Qassim Region,Services to Buildings and Landscape Activities,micro,1069,160,90,70,2672,2656,16
2022,4,Qassim Region,Services to Buildings and Landscape Activities,medium,130,1731,1031,700,14810,14648,162
2022,4,Al Madinah Region,Services to Buildings and Landscape Activities,small,151,482,274,208,1812,1778,34
2022,4,Al Madinah Region,Services to Buildings and Landscape Activities,large,5,360,128,232,1574,1521,53
2022,4,Al Madinah Region,Services to Buildings and Landscape Activities,micro,697,133,77,56,1616,1590,26
2022,4,Al Madinah Region,Services to Buildings and Landscape Activities,medium,34,748,520,228,2976,2885,91
2022,4,Tabuk Region,Services to Buildings and Landscape Activities,small,34,71,44,27,302,302,0
2022,4,Tabuk Region,Services to Buildings and Landscape Activities,micro,292,50,21,29,688,685,3
2022,4,Tabuk Region,Services to Buildings and Landscape Activities,medium,14,244,95,149,1137,1133,4
2022,4,Jazan Region,Services to Buildings and Landscape Activities,small,33,116,59,57,352,351,1
2022,4,Jazan Region,Services to Buildings and Landscape Activities,micro,306,49,27,22,767,766,1
2022,4,Jazan Region,Services to Buildings and Landscape Activities,medium,6,112,68,44,449,424,25
2022,4,Hail Region,Services to Buildings and Landscape Activities,small,40,90,39,51,475,471,4
2022,4,Hail Region,Services to Buildings and Landscape Activities,large,1,827,583,244,935,845,90
2022,4,Hail Region,Services to Buildings and Landscape Activities,micro,311,36,17,19,714,710,4
2022,4,Hail Region,Services to Buildings and Landscape Activities,medium,17,264,147,117,1323,1303,20
2022,4,Aseer Region,Services to Buildings and Landscape Activities,small,67,176,102,74,795,786,9
2022,4,Aseer Region,Services to Buildings and Landscape Activities,large,8,1640,1371,269,4270,4171,99
2022,4,Aseer Region,Services to Buildings and Landscape Activities,micro,461,90,52,38,1095,1087,8
2022,4,Aseer Region,Services to Buildings and Landscape Activities,medium,12,276,157,119,1231,1225,6
2022,4,Makkah Region,Services to Buildings and Landscape Activities,small,865,2773,1321,1452,11154,10851,303
2022,4,Makkah Region,Services to Buildings and Landscape Activities,large,58,10675,6717,3958,41783,40486,1297
2022,4,Makkah Region,Services to Buildings and Landscape Activities,micro,2819,837,412,425,6504,6384,120
2022,4,Makkah Region,Services to Buildings and Landscape Activities,medium,234,5111,2770,2341,20100,19360,740
2022,4,Najran Region,Services to Buildings and Landscape Activities,small,43,136,84,52,613,610,3
2022,4,Najran Region,Services to Buildings and Landscape Activities,large,8,1369,828,541,6765,6709,56
2022,4,Najran Region,Services to Buildings and Landscape Activities,micro,174,29,19,10,394,389,5
2022,4,Najran Region,Services to Buildings and Landscape Activities,medium,13,250,127,123,1060,1057,3
2022,4,Eastern Province,Publishing Activities,small,21,121,59,62,182,179,3
2022,4,Eastern Province,Publishing Activities,micro,66,49,19,30,120,117,3
2022,4,Eastern Province,Publishing Activities,medium,2,128,106,22,135,135,0
2022,4,Al Bahah Region,Publishing Activities,small,1,4,2,2,13,13,0
2022,4,Al Bahah Region,Publishing Activities,micro,6,2,2,0,11,11,0
2022,4,Al Jawf Region,Publishing Activities,micro,2,0,0,0,4,4,0
2022,4,Northern Borders Region,Publishing Activities,micro,2,0,0,0,3,3,0
2022,4,Riyadh Region,Publishing Activities,small,71,478,219,259,547,534,13
2022,4,Riyadh Region,Publishing Activities,large,3,1510,480,1030,1350,1238,112
2022,4,Riyadh Region,Publishing Activities,micro,184,140,58,82,256,251,5
2022,4,Riyadh Region,Publishing Activities,medium,8,416,215,201,409,393,16
2022,4,Qassim Region,Publishing Activities,small,1,0,0,0,45,45,0
2022,4,Qassim Region,Publishing Activities,micro,10,2,1,1,18,18,0
2022,4,Al Madinah Region,Publishing Activities,small,3,12,8,4,10,10,0
2022,4,Al Madinah Region,Publishing Activities,micro,12,5,1,4,24,24,0
2022,4,Tabuk Region,Publishing Activities,micro,2,1,1,0,6,6,0
2022,4,Jazan Region,Publishing Activities,micro,5,1,0,1,8,8,0
2022,4,Hail Region,Publishing Activities,small,2,3,0,3,13,13,0
2022,4,Hail Region,Publishing Activities,micro,23,1,0,1,76,76,0
2022,4,Aseer Region,Publishing Activities,micro,11,5,5,0,28,28,0
2022,4,Aseer Region,Publishing Activities,medium,1,17,10,7,54,54,0
2022,4,Makkah Region,Publishing Activities,small,16,74,32,42,130,127,3
2022,4,Makkah Region,Publishing Activities,micro,97,50,21,29,160,158,2
2022,4,Makkah Region,Publishing Activities,medium,4,94,76,18,180,176,4
2022,4,Najran Region,Publishing Activities,small,1,1,1,0,5,5,0
2022,4,Najran Region,Publishing Activities,micro,3,1,0,1,5,5,0
2022,4,Najran Region,Publishing Activities,medium,1,0,0,0,65,65,0
2022,4,Eastern Province,Activities of Membership Organizations,small,20,123,45,78,96,95,1
2022,4,Eastern Province,Activities of Membership Organizations,micro,69,60,39,21,78,74,4
2022,4,Al Bahah Region,Activities of Membership Organizations,micro,14,17,14,3,7,7,0
2022,4,Al Jawf Region,Activities of Membership Organizations,small,3,34,27,7,10,10,0
2022,4,Al Jawf Region,Activities of Membership Organizations,micro,22,20,14,6,28,28,0
2022,4,Northern Borders Region,Activities of Membership Organizations,small,1,1,1,0,14,14,0
2022,4,Northern Borders Region,Activities of Membership Organizations,micro,5,8,7,1,2,2,0
2022,4,Riyadh Region,Activities of Membership Organizations,small,77,405,203,202,525,508,17
2022,4,Riyadh Region,Activities of Membership Organizations,micro,2228,308,164,144,5060,4986,74
2022,4,Riyadh Region,Activities of Membership Organizations,medium,1,140,46,94,73,34,39
2022,4,Qassim Region,Activities of Membership Organizations,small,10,58,26,32,35,34,1
2022,4,Qassim Region,Activities of Membership Organizations,micro,69,45,35,10,113,113,0
2022,4,Al Madinah Region,Activities of Membership Organizations,small,8,53,40,13,52,52,0
2022,4,Al Madinah Region,Activities of Membership Organizations,micro,79,23,20,3,134,130,4
2022,4,Tabuk Region,Activities of Membership Organizations,small,5,55,14,41,13,12,1
2022,4,Tabuk Region,Activities of Membership Organizations,micro,14,12,6,6,15,14,1
2022,4,Tabuk Region,Activities of Membership Organizations,medium,1,69,17,52,0,0,0
2022,4,Jazan Region,Activities of Membership Organizations,small,8,147,76,71,36,34,2
2022,4,Jazan Region,Activities of Membership Organizations,micro,122,29,18,11,233,229,4
2022,4,Jazan Region,Activities of Membership Organizations,medium,1,50,2,48,0,0,0
2022,4,Hail Region,Activities of Membership Organizations,small,5,29,21,8,14,14,0
2022,4,Hail Region,Activities of Membership Organizations,micro,22,20,4,16,39,39,0
2022,4,Aseer Region,Activities of Membership Organizations,small,3,13,3,10,13,11,2
2022,4,Aseer Region,Activities of Membership Organizations,micro,33,29,22,7,36,33,3
2022,4,Aseer Region,Activities of Membership Organizations,medium,1,47,11,36,26,25,1
2022,4,Makkah Region,Activities of Membership Organizations,small,32,202,136,66,228,226,2
2022,4,Makkah Region,Activities of Membership Organizations,large,1,460,254,206,75,75,0
2022,4,Makkah Region,Activities of Membership Organizations,micro,258,158,107,51,396,384,12
2022,4,Makkah Region,Activities of Membership Organizations,medium,3,277,147,130,57,50,7
2022,4,Najran Region,Activities of Membership Organizations,small,2,54,47,7,4,4,0
2022,4,Najran Region,Activities of Membership Organizations,micro,31,20,14,6,42,41,1
2022,4,Eastern Province,"Libraries, Archives, Museums, and Other Cultural Activities",small,5,22,14,8,54,53,1
2022,4,Eastern Province,"Libraries, Archives, Museums, and Other Cultural Activities",micro,30,13,6,7,48,48,0
2022,4,Al Bahah Region,"Libraries, Archives, Museums, and Other Cultural Activities",micro,2,1,0,1,5,5,0
2022,4,Northern Borders Region,"Libraries, Archives, Museums, and Other Cultural Activities",micro,3,0,0,0,5,5,0
2022,4,Riyadh Region,"Libraries, Archives, Museums, and Other Cultural Activities",small,4,10,7,3,23,22,1
2022,4,Riyadh Region,"Libraries, Archives, Museums, and Other Cultural Activities",micro,22,11,4,7,41,40,1
2022,4,Qassim Region,"Libraries, Archives, Museums, and Other Cultural Activities",small,1,3,3,0,4,4,0
2022,4,Qassim Region,"Libraries, Archives, Museums, and Other Cultural Activities",micro,4,3,2,1,10,10,0
2022,4,Al Madinah Region,"Libraries, Archives, Museums, and Other Cultural Activities",small,2,5,5,0,12,12,0
2022,4,Al Madinah Region,"Libraries, Archives, Museums, and Other Cultural Activities",micro,28,12,7,5,44,44,0
2022,4,Tabuk Region,"Libraries, Archives, Museums, and Other Cultural Activities",micro,6,3,3,0,10,10,0
2022,4,Jazan Region,"Libraries, Archives, Museums, and Other Cultural Activities",micro,11,0,0,0,27,27,0
2022,4,Hail Region,"Libraries, Archives, Museums, and Other Cultural Activities",micro,4,0,0,0,5,5,0
2022,4,Aseer Region,"Libraries, Archives, Museums, and Other Cultural Activities",micro,12,5,4,1,18,18,0
2022,4,Makkah Region,"Libraries, Archives, Museums, and Other Cultural Activities",small,3,1,1,0,17,17,0
2022,4,Makkah Region,"Libraries, Archives, Museums, and Other Cultural Activities",micro,73,25,17,8,121,120,1
2022,4,Makkah Region,"Libraries, Archives, Museums, and Other Cultural Activities",medium,1,72,44,28,106,106,0
2022,4,Najran Region,"Libraries, Archives, Museums, and Other Cultural Activities",micro,6,0,0,0,13,13,0
2022,4,Eastern Province,"Head Office Activities, Management Consultancy Activities",small,41,271,156,115,342,332,10
2022,4,Eastern Province,"Head Office Activities, Management Consultancy Activities",micro,101,93,44,49,124,118,6
2022,4,Eastern Province,"Head Office Activities, Management Consultancy Activities",medium,7,245,147,98,309,302,7
2022,4,Al Bahah Region,"Head Office Activities, Management Consultancy Activities",micro,2,1,0,1,3,3,0
2022,4,Al Jawf Region,"Head Office Activities, Management Consultancy Activities",small,1,16,2,14,31,28,3
2022,4,Al Jawf Region,"Head Office Activities, Management Consultancy Activities",micro,1,1,1,0,1,1,0
2022,4,Northern Borders Region,"Head Office Activities, Management Consultancy Activities",micro,3,1,1,0,9,9,0
2022,4,Riyadh Region,"Head Office Activities, Management Consultancy Activities",small,241,1769,914,855,1775,1603,172
2022,4,Riyadh Region,"Head Office Activities, Management Consultancy Activities",large,9,10481,5532,4949,4098,3871,227
2022,4,Riyadh Region,"Head Office Activities, Management Consultancy Activities",micro,681,626,315,311,898,849,49
2022,4,Riyadh Region,"Head Office Activities, Management Consultancy Activities",medium,31,1792,1105,687,1723,1633,90
2022,4,Qassim Region,"Head Office Activities, Management Consultancy Activities",small,1,2,1,1,4,4,0
2022,4,Qassim Region,"Head Office Activities, Management Consultancy Activities",micro,15,13,5,8,27,25,2
2022,4,Qassim Region,"Head Office Activities, Management Consultancy Activities",medium,1,86,79,7,107,107,0
2022,4,Al Madinah Region,"Head Office Activities, Management Consultancy Activities",small,3,9,4,5,12,12,0
2022,4,Al Madinah Region,"Head Office Activities, Management Consultancy Activities",micro,33,19,7,12,49,48,1
2022,4,Al Madinah Region,"Head Office Activities, Management Consultancy Activities",medium,1,61,26,35,0,0,0
2022,4,Tabuk Region,"Head Office Activities, Management Consultancy Activities",micro,2,1,1,0,1,1,0
2022,4,Jazan Region,"Head Office Activities, Management Consultancy Activities",micro,6,7,1,6,10,9,1
2022,4,Hail Region,"Head Office Activities, Management Consultancy Activities",micro,6,2,2,0,12,12,0
2022,4,Aseer Region,"Head Office Activities, Management Consultancy Activities",micro,15,14,8,6,20,19,1
2022,4,Makkah Region,"Head Office Activities, Management Consultancy Activities",small,71,428,214,214,577,542,35
2022,4,Makkah Region,"Head Office Activities, Management Consultancy Activities",micro,244,195,99,96,352,331,21
2022,4,Makkah Region,"Head Office Activities, Management Consultancy Activities",medium,2,120,90,30,98,96,2
2022,4,Najran Region,"Head Office Activities, Management Consultancy Activities",micro,4,0,0,0,12,12,0
2022,4,Eastern Province,"Architectural and Engineering Activities, Technical Testing, and Analysis",small,258,1585,940,645,2338,2306,32
2022,4,Eastern Province,"Architectural and Engineering Activities, Technical Testing, and Analysis",large,24,5612,4512,1100,7198,7171,27
2022,4,Eastern Province,"Architectural and Engineering Activities, Technical Testing, and Analysis",micro,445,375,217,158,733,723,10
2022,4,Eastern Province,"Architectural and Engineering Activities, Technical Testing, and Analysis",medium,74,2957,2210,747,4083,4061,22
2022,4,Al Bahah Region,"Architectural and Engineering Activities, Technical Testing, and Analysis",small,19,77,44,33,149,149,0
2022,4,Al Bahah Region,"Architectural and Engineering Activities, Technical Testing, and Analysis",micro,98,16,8,8,204,204,0
2022,4,Al Jawf Region,"Architectural and Engineering Activities, Technical Testing, and Analysis",small,16,60,43,17,152,151,1
2022,4,Al Jawf Region,"Architectural and Engineering Activities, Technical Testing, and Analysis",micro,101,32,18,14,203,201,2
2022,4,Northern Borders Region,"Architectural and Engineering Activities, Technical Testing, and Analysis",small,6,27,16,11,32,32,0
2022,4,Northern Borders Region,"Architectural and Engineering Activities, Technical Testing, and Analysis",micro,57,21,12,9,119,117,2
2022,4,Riyadh Region,"Architectural and Engineering Activities, Technical Testing, and Analysis",small,515,2817,1607,1210,4484,4383,101
2022,4,Riyadh Region,"Architectural and Engineering Activities, Technical Testing, and Analysis",large,22,5046,3414,1632,6884,6780,104
2022,4,Riyadh Region,"Architectural and Engineering Activities, Technical Testing, and Analysis",micro,3322,906,486,420,7198,7136,62
2022,4,Riyadh Region,"Architectural and Engineering Activities, Technical Testing, and Analysis",medium,115,5546,3514,2032,7915,7734,181
2022,4,Qassim Region,"Architectural and Engineering Activities, Technical Testing, and Analysis",small,33,134,85,49,259,258,1
2022,4,Qassim Region,"Architectural and Engineering Activities, Technical Testing, and Analysis",micro,160,80,57,23,297,297,0
2022,4,Qassim Region,"Architectural and Engineering Activities, Technical Testing, and Analysis",medium,6,212,148,64,255,254,1
2022,4,Al Madinah Region,"Architectural and Engineering Activities, Technical Testing, and Analysis",small,70,361,193,168,658,654,4
2022,4,Al Madinah Region,"Architectural and Engineering Activities, Technical Testing, and Analysis",large,1,154,85,69,183,182,1
2022,4,Al Madinah Region,"Architectural and Engineering Activities, Technical Testing, and Analysis",micro,145,65,32,33,280,280,0
2022,4,Al Madinah Region,"Architectural and Engineering Activities, Technical Testing, and Analysis",medium,4,233,180,53,293,293,0
2022,4,Tabuk Region,"Architectural and Engineering Activities, Technical Testing, and Analysis",small,21,96,66,30,163,163,0
2022,4,Tabuk Region,"Architectural and Engineering Activities, Technical Testing, and Analysis",micro,78,42,25,17,141,137,4
2022,4,Tabuk Region,"Architectural and Engineering Activities, Technical Testing, and Analysis",medium,1,45,20,25,29,29,0
2022,4,Jazan Region,"Architectural and Engineering Activities, Technical Testing, and Analysis",small,17,87,53,34,127,127,0
2022,4,Jazan Region,"Architectural and Engineering Activities, Technical Testing, and Analysis",micro,140,73,39,34,240,234,6
2022,4,Jazan Region,"Architectural and Engineering Activities, Technical Testing, and Analysis",medium,2,55,27,28,71,71,0
2022,4,Hail Region,"Architectural and Engineering Activities, Technical Testing, and Analysis",small,16,93,39,54,192,188,4
2022,4,Hail Region,"Architectural and Engineering Activities, Technical Testing, and Analysis",micro,164,31,17,14,377,376,1
2022,4,Hail Region,"Architectural and Engineering Activities, Technical Testing, and Analysis",medium,1,56,46,10,63,63,0
2022,4,Aseer Region,"Architectural and Engineering Activities, Technical Testing, and Analysis",small,58,241,166,75,386,383,3
2022,4,Aseer Region,"Architectural and Engineering Activities, Technical Testing, and Analysis",micro,256,139,83,56,466,464,2
2022,4,Aseer Region,"Architectural and Engineering Activities, Technical Testing, and Analysis",medium,2,52,47,5,77,76,1
2022,4,Makkah Region,"Architectural and Engineering Activities, Technical Testing, and Analysis",small,389,1860,1075,785,3366,3314,52
2022,4,Makkah Region,"Architectural and Engineering Activities, Technical Testing, and Analysis",large,6,979,679,300,1655,1647,8
2022,4,Makkah Region,"Architectural and Engineering Activities, Technical Testing, and Analysis",micro,965,620,337,283,1658,1624,34
2022,4,Makkah Region,"Architectural and Engineering Activities, Technical Testing, and Analysis",medium,30,1359,836,523,1818,1798,20
2022,4,Najran Region,"Architectural and Engineering Activities, Technical Testing, and Analysis",small,16,73,48,25,160,160,0
2022,4,Najran Region,"Architectural and Engineering Activities, Technical Testing, and Analysis",micro,154,28,17,11,346,344,2
2022,4,Eastern Province,"Treatment and Disposal of Non-Hazardous Waste, Other Waste Management Services",small,4,14,5,9,66,66,0
2022,4,Eastern Province,"Treatment and Disposal of Non-Hazardous Waste, Other Waste Management Services",micro,3,2,2,0,3,3,0
2022,4,Eastern Province,"Treatment and Disposal of Non-Hazardous Waste, Other Waste Management Services",medium,1,27,26,1,58,58,0
2022,4,Riyadh Region,"Treatment and Disposal of Non-Hazardous Waste, Other Waste Management Services",small,2,30,26,4,23,23,0
2022,4,Riyadh Region,"Treatment and Disposal of Non-Hazardous Waste, Other Waste Management Services",large,1,1702,1340,362,13000,12660,340
2022,4,Riyadh Region,"Treatment and Disposal of Non-Hazardous Waste, Other Waste Management Services",micro,3,2,1,1,7,7,0
2022,4,Jazan Region,"Treatment and Disposal of Non-Hazardous Waste, Other Waste Management Services",micro,1,1,1,0,2,2,0
2022,4,Makkah Region,"Treatment and Disposal of Non-Hazardous Waste, Other Waste Management Services",small,2,9,7,2,38,38,0
2022,4,Makkah Region,"Treatment and Disposal of Non-Hazardous Waste, Other Waste Management Services",micro,1,1,0,1,2,2,0
2022,4,Najran Region,"Treatment and Disposal of Non-Hazardous Waste, Other Waste Management Services",micro,1,1,0,1,1,1,0
2022,4,Eastern Province,Social Work Activities Without Accommodation,small,197,2243,363,1880,443,368,75
2022,4,Eastern Province,Social Work Activities Without Accommodation,large,2,315,142,173,394,282,112
2022,4,Eastern Province,Social Work Activities Without Accommodation,micro,193,360,63,297,137,111,26
2022,4,Eastern Province,Social Work Activities Without Accommodation,medium,18,1383,347,1036,423,284,139
2022,4,Al Bahah Region,Social Work Activities Without Accommodation,small,28,257,135,122,88,81,7
2022,4,Al Bahah Region,Social Work Activities Without Accommodation,micro,42,80,72,8,35,35,0
2022,4,Al Bahah Region,Social Work Activities Without Accommodation,medium,1,50,12,38,0,0,0
2022,4,Al Jawf Region,Social Work Activities Without Accommodation,small,23,240,130,110,105,101,4
2022,4,Al Jawf Region,Social Work Activities Without Accommodation,micro,23,48,28,20,12,12,0
2022,4,Northern Borders Region,Social Work Activities Without Accommodation,small,14,106,42,64,35,32,3
2022,4,Northern Borders Region,Social Work Activities Without Accommodation,micro,23,45,28,17,17,17,0
2022,4,Riyadh Region,Social Work Activities Without Accommodation,small,296,3070,777,2293,1497,1253,244
2022,4,Riyadh Region,Social Work Activities Without Accommodation,large,7,1705,907,798,831,750,81
2022,4,Riyadh Region,Social Work Activities Without Accommodation,micro,421,587,233,354,445,402,43
2022,4,Riyadh Region,Social Work Activities Without Accommodation,medium,33,2278,1054,1224,890,759,131
2022,4,Qassim Region,Social Work Activities Without Accommodation,small,79,818,371,447,343,320,23
2022,4,Qassim Region,Social Work Activities Without Accommodation,micro,99,150,86,64,98,93,5
2022,4,Qassim Region,Social Work Activities Without Accommodation,medium,5,371,126,245,254,186,68
2022,4,Al Madinah Region,Social Work Activities Without Accommodation,small,74,742,334,408,239,202,37
2022,4,Al Madinah Region,Social Work Activities Without Accommodation,micro,162,312,171,141,108,96,12
2022,4,Al Madinah Region,Social Work Activities Without Accommodation,medium,13,694,294,400,279,208,71
2022,4,Tabuk Region,Social Work Activities Without Accommodation,small,15,151,73,78,38,38,0
2022,4,Tabuk Region,Social Work Activities Without Accommodation,micro,37,87,55,32,16,15,1
2022,4,Tabuk Region,Social Work Activities Without Accommodation,medium,1,60,1,59,12,6,6
2022,4,Jazan Region,Social Work Activities Without Accommodation,small,33,302,161,141,108,104,4
2022,4,Jazan Region,Social Work Activities Without Accommodation,micro,66,120,75,45,46,45,1
2022,4,Jazan Region,Social Work Activities Without Accommodation,medium,2,115,33,82,17,12,5
2022,4,Hail Region,Social Work Activities Without Accommodation,small,20,243,123,120,54,50,4
2022,4,Hail Region,Social Work Activities Without Accommodation,micro,67,96,58,38,56,56,0
2022,4,Hail Region,Social Work Activities Without Accommodation,medium,1,54,2,52,4,2,2
2022,4,Aseer Region,Social Work Activities Without Accommodation,small,70,598,292,306,312,298,14
2022,4,Aseer Region,Social Work Activities Without Accommodation,micro,115,244,184,60,55,55,0
2022,4,Aseer Region,Social Work Activities Without Accommodation,medium,4,191,46,145,86,62,24
2022,4,Makkah Region,Social Work Activities Without Accommodation,small,271,2743,801,1942,1151,879,272
2022,4,Makkah Region,Social Work Activities Without Accommodation,micro,415,661,247,414,335,285,50
2022,4,Makkah Region,Social Work Activities Without Accommodation,medium,20,1171,641,530,785,719,66
2022,4,Najran Region,Social Work Activities Without Accommodation,small,11,72,29,43,74,72,2
2022,4,Najran Region,Social Work Activities Without Accommodation,micro,33,55,31,24,39,38,1
2022,4,Eastern Province,"Financial Service Activities, Except Insurance and Pension Funding",small,77,541,321,220,789,781,8
2022,4,Eastern Province,"Financial Service Activities, Except Insurance and Pension Funding",large,2,703,397,306,150,135,15
2022,4,Eastern Province,"Financial Service Activities, Except Insurance and Pension Funding",micro,180,125,78,47,288,280,8
2022,4,Eastern Province,"Financial Service Activities, Except Insurance and Pension Funding",medium,20,1190,791,399,744,726,18
2022,4,Al Bahah Region,"Financial Service Activities, Except Insurance and Pension Funding",small,1,2,1,1,6,6,0
2022,4,Al Bahah Region,"Financial Service Activities, Except Insurance and Pension Funding",micro,5,2,2,0,6,6,0
2022,4,Al Jawf Region,"Financial Service Activities, Except Insurance and Pension Funding",small,1,6,6,0,0,0,0
2022,4,Al Jawf Region,"Financial Service Activities, Except Insurance and Pension Funding",micro,9,2,2,0,10,10,0
2022,4,Northern Borders Region,"Financial Service Activities, Except Insurance and Pension Funding",micro,5,0,0,0,14,14,0
2022,4,Northern Borders Region,"Financial Service Activities, Except Insurance and Pension Funding",medium,1,0,0,0,72,72,0
2022,4,Riyadh Region,"Financial Service Activities, Except Insurance and Pension Funding",small,176,1556,949,607,1229,1178,51
2022,4,Riyadh Region,"Financial Service Activities, Except Insurance and Pension Funding",large,13,21280,17207,4073,1357,1335,22
2022,4,Riyadh Region,"Financial Service Activities, Except Insurance and Pension Funding",micro,480,497,324,173,664,647,17
2022,4,Riyadh Region,"Financial Service Activities, Except Insurance and Pension Funding",medium,39,2727,1870,857,1519,1421,98
2022,4,Qassim Region,"Financial Service Activities, Except Insurance and Pension Funding",small,6,23,19,4,62,62,0
2022,4,Qassim Region,"Financial Service Activities, Except Insurance and Pension Funding",micro,26,6,4,2,45,45,0
2022,4,Al Madinah Region,"Financial Service Activities, Except Insurance and Pension Funding",small,3,24,23,1,20,20,0
2022,4,Al Madinah Region,"Financial Service Activities, Except Insurance and Pension Funding",micro,44,36,25,11,73,71,2
2022,4,Al Madinah Region,"Financial Service Activities, Except Insurance and Pension Funding",medium,1,159,131,28,82,81,1
2022,4,Tabuk Region,"Financial Service Activities, Except Insurance and Pension Funding",micro,14,3,2,1,28,28,0
2022,4,Jazan Region,"Financial Service Activities, Except Insurance and Pension Funding",micro,15,1,1,0,36,36,0
2022,4,Hail Region,"Financial Service Activities, Except Insurance and Pension Funding",micro,19,6,5,1,49,49,0
2022,4,Aseer Region,"Financial Service Activities, Except Insurance and Pension Funding",small,4,45,21,24,27,27,0
2022,4,Aseer Region,"Financial Service Activities, Except Insurance and Pension Funding",micro,25,11,6,5,35,35,0
2022,4,Makkah Region,"Financial Service Activities, Except Insurance and Pension Funding",small,124,704,415,289,1028,987,41
2022,4,Makkah Region,"Financial Service Activities, Except Insurance and Pension Funding",large,2,2927,2401,526,267,265,2
2022,4,Makkah Region,"Financial Service Activities, Except Insurance and Pension Funding",micro,337,189,117,72,594,575,19
2022,4,Makkah Region,"Financial Service Activities, Except Insurance and Pension Funding",medium,19,1020,707,313,615,604,11
2022,4,Najran Region,"Financial Service Activities, Except Insurance and Pension Funding",small,1,2,2,0,5,5,0
2022,4,Najran Region,"Financial Service Activities, Except Insurance and Pension Funding",micro,11,3,1,2,22,22,0
2022,4,Eastern Province,Other Personal Service Activities,small,715,1407,324,1083,5389,3572,1817
2022,4,Eastern Province,Other Personal Service Activities,large,4,287,120,167,2085,2085,0
2022,4,Eastern Province,Other Personal Service Activities,micro,6592,1420,508,912,14194,12903,1291
2022,4,Eastern Province,Other Personal Service Activities,medium,11,233,82,151,860,784,76
2022,4,Al Bahah Region,Other Personal Service Activities,small,8,8,6,2,45,45,0
2022,4,Al Bahah Region,Other Personal Service Activities,micro,491,76,39,37,970,915,55
2022,4,Al Jawf Region,Other Personal Service Activities,small,36,63,29,34,314,272,42
2022,4,Al Jawf Region,Other Personal Service Activities,micro,834,88,54,34,1690,1580,110
2022,4,Northern Borders Region,Other Personal Service Activities,small,26,37,8,29,178,118,60
2022,4,Northern Borders Region,Other Personal Service Activities,micro,617,61,26,35,1378,1303,75
2022,4,Riyadh Region,Other Personal Service Activities,small,1388,3235,699,2536,11845,7757,4088
2022,4,Riyadh Region,Other Personal Service Activities,large,3,1078,541,537,1487,1040,447
2022,4,Riyadh Region,Other Personal Service Activities,micro,10466,2261,783,1478,22331,19863,2468
2022,4,Riyadh Region,Other Personal Service Activities,medium,31,711,129,582,2042,1426,616
2022,4,Qassim Region,Other Personal Service Activities,small,125,237,60,177,1033,638,395
2022,4,Qassim Region,Other Personal Service Activities,micro,2240,271,133,138,4770,4444,326
2022,4,Qassim Region,Other Personal Service Activities,medium,4,70,34,36,266,209,57
2022,4,Al Madinah Region,Other Personal Service Activities,small,149,325,82,243,1178,739,439
2022,4,Al Madinah Region,Other Personal Service Activities,micro,2960,382,164,218,5930,5527,403
2022,4,Al Madinah Region,Other Personal Service Activities,medium,1,44,4,40,93,5,88
2022,4,Tabuk Region,Other Personal Service Activities,small,49,92,27,65,388,320,68
2022,4,Tabuk Region,Other Personal Service Activities,micro,1497,161,67,94,3052,2895,157
2022,4,Tabuk Region,Other Personal Service Activities,medium,1,15,6,9,57,57,0
2022,4,Jazan Region,Other Personal Service Activities,small,44,113,16,97,317,186,131
2022,4,Jazan Region,Other Personal Service Activities,micro,2090,206,102,104,4408,4211,197
2022,4,Hail Region,Other Personal Service Activities,small,56,121,28,93,475,297,178
2022,4,Hail Region,Other Personal Service Activities,micro,1210,142,57,85,2604,2412,192
2022,4,Hail Region,Other Personal Service Activities,medium,1,42,3,39,57,7,50
2022,4,Aseer Region,Other Personal Service Activities,small,111,172,73,99,810,666,144
2022,4,Aseer Region,Other Personal Service Activities,micro,2935,395,164,231,5946,5610,336
2022,4,Makkah Region,Other Personal Service Activities,small,735,1770,403,1367,6254,3807,2447
2022,4,Makkah Region,Other Personal Service Activities,micro,9272,1675,666,1009,19388,17597,1791
2022,4,Makkah Region,Other Personal Service Activities,medium,16,369,49,320,961,289,672
2022,4,Najran Region,Other Personal Service Activities,small,27,44,15,29,177,138,39
2022,4,Najran Region,Other Personal Service Activities,micro,913,98,32,66,1956,1816,140
2022,4,Eastern Province,Specialized Construction Activities,small,1967,5010,2552,2458,24114,24040,74
2022,4,Eastern Province,Specialized Construction Activities,large,91,16795,13768,3027,64714,64557,157
2022,4,Eastern Province,Specialized Construction Activities,micro,7034,1830,874,956,17079,17036,43
2022,4,Eastern Province,Specialized Construction Activities,medium,252,5016,3145,1871,22143,22086,57
2022,4,Al Bahah Region,Specialized Construction Activities,small,50,79,53,26,439,439,0
2022,4,Al Bahah Region,Specialized Construction Activities,micro,541,95,61,34,1192,1192,0
2022,4,Al Bahah Region,Specialized Construction Activities,medium,4,86,49,37,367,367,0
2022,4,Al Jawf Region,Specialized Construction Activities,small,62,117,81,36,645,633,12
2022,4,Al Jawf Region,Specialized Construction Activities,micro,717,112,79,33,1662,1658,4
2022,4,Al Jawf Region,Specialized Construction Activities,medium,5,58,40,18,342,341,1
2022,4,Northern Borders Region,Specialized Construction Activities,small,37,64,46,18,300,298,2
2022,4,Northern Borders Region,Specialized Construction Activities,micro,486,61,31,30,1288,1285,3
2022,4,Northern Borders Region,Specialized Construction Activities,medium,2,40,39,1,247,247,0
2022,4,Riyadh Region,Specialized Construction Activities,small,3162,8946,3937,5009,40180,39880,300
2022,4,Riyadh Region,Specialized Construction Activities,large,164,30456,22482,7974,111230,109553,1677
2022,4,Riyadh Region,Specialized Construction Activities,micro,12166,3003,1321,1682,28222,27993,229
2022,4,Riyadh Region,Specialized Construction Activities,medium,515,9310,5049,4261,42770,42512,258
2022,4,Qassim Region,Specialized Construction Activities,small,384,683,368,315,4598,4585,13
2022,4,Qassim Region,Specialized Construction Activities,large,11,858,578,280,6280,6005,275
2022,4,Qassim Region,Specialized Construction Activities,micro,2876,398,235,163,7004,6983,21
2022,4,Qassim Region,Specialized Construction Activities,medium,47,312,196,116,4734,4732,2
2022,4,Al Madinah Region,Specialized Construction Activities,small,370,805,450,355,3865,3850,15
2022,4,Al Madinah Region,Specialized Construction Activities,large,8,1390,838,552,5147,5008,139
2022,4,Al Madinah Region,Specialized Construction Activities,micro,3193,501,294,207,8002,7956,46
2022,4,Al Madinah Region,Specialized Construction Activities,medium,23,328,192,136,1661,1653,8
2022,4,Tabuk Region,Specialized Construction Activities,small,86,174,81,93,834,830,4
2022,4,Tabuk Region,Specialized Construction Activities,large,1,89,80,9,617,617,0
2022,4,Tabuk Region,Specialized Construction Activities,micro,1399,212,117,95,3393,3389,4
2022,4,Tabuk Region,Specialized Construction Activities,medium,3,32,11,21,166,166,0
2022,4,Jazan Region,Specialized Construction Activities,small,106,187,92,95,829,827,2
2022,4,Jazan Region,Specialized Construction Activities,micro,2355,297,166,131,5853,5832,21
2022,4,Jazan Region,Specialized Construction Activities,medium,2,49,40,9,196,196,0
2022,4,Hail Region,Specialized Construction Activities,small,107,157,73,84,1003,1002,1
2022,4,Hail Region,Specialized Construction Activities,large,2,202,147,55,787,783,4
2022,4,Hail Region,Specialized Construction Activities,micro,1162,152,78,74,2867,2857,10
2022,4,Hail Region,Specialized Construction Activities,medium,9,117,87,30,802,791,11
2022,4,Aseer Region,Specialized Construction Activities,small,329,640,361,279,3131,3118,13
2022,4,Aseer Region,Specialized Construction Activities,large,5,596,267,329,2982,2981,1
2022,4,Aseer Region,Specialized Construction Activities,micro,3108,461,252,209,7141,7127,14
2022,4,Aseer Region,Specialized Construction Activities,medium,13,235,188,47,931,930,1
2022,4,Makkah Region,Specialized Construction Activities,small,2015,4913,2435,2478,22896,22709,187
2022,4,Makkah Region,Specialized Construction Activities,large,51,5700,3744,1956,26866,26730,136
2022,4,Makkah Region,Specialized Construction Activities,micro,11322,2361,1129,1232,26335,26061,274
2022,4,Makkah Region,Specialized Construction Activities,medium,222,4430,2762,1668,18076,18001,75
2022,4,Najran Region,Specialized Construction Activities,small,108,160,90,70,1106,1106,0
2022,4,Najran Region,Specialized Construction Activities,large,4,245,184,61,2432,2432,0
2022,4,Najran Region,Specialized Construction Activities,micro,1094,114,53,61,2412,2402,10
2022,4,Najran Region,Specialized Construction Activities,medium,9,250,152,98,887,887,0
2022,4,Eastern Province,Postal and Courier Activities,small,12,78,32,46,109,109,0
2022,4,Eastern Province,Postal and Courier Activities,large,1,287,223,64,312,308,4
2022,4,Eastern Province,Postal and Courier Activities,micro,25,15,6,9,31,31,0
2022,4,Eastern Province,Postal and Courier Activities,medium,3,50,20,30,238,238,0
2022,4,Al Jawf Region,Postal and Courier Activities,micro,1,0,0,0,4,4,0
2022,4,Northern Borders Region,Postal and Courier Activities,micro,1,0,0,0,4,4,0
2022,4,Riyadh Region,Postal and Courier Activities,small,105,464,193,271,1184,1157,27
2022,4,Riyadh Region,Postal and Courier Activities,large,6,1079,604,475,4765,4738,27
2022,4,Riyadh Region,Postal and Courier Activities,micro,257,142,74,68,498,487,11
2022,4,Riyadh Region,Postal and Courier Activities,medium,16,559,301,258,1321,1297,24
2022,4,Qassim Region,Postal and Courier Activities,micro,11,2,1,1,26,26,0
2022,4,Al Madinah Region,Postal and Courier Activities,small,1,2,1,1,5,5,0
2022,4,Al Madinah Region,Postal and Courier Activities,micro,14,3,3,0,33,33,0
2022,4,Al Madinah Region,Postal and Courier Activities,medium,1,80,80,0,127,127,0
2022,4,Tabuk Region,Postal and Courier Activities,micro,9,1,1,0,22,21,1
2022,4,Jazan Region,Postal and Courier Activities,small,1,7,6,1,25,25,0
2022,4,Jazan Region,Postal and Courier Activities,micro,6,1,1,0,13,13,0
2022,4,Hail Region,Postal and Courier Activities,small,1,0,0,0,6,6,0
2022,4,Hail Region,Postal and Courier Activities,micro,3,0,0,0,7,7,0
2022,4,Aseer Region,Postal and Courier Activities,small,2,5,3,2,10,10,0
2022,4,Aseer Region,Postal and Courier Activities,micro,10,5,4,1,27,27,0
2022,4,Makkah Region,Postal and Courier Activities,small,22,97,49,48,188,186,2
2022,4,Makkah Region,Postal and Courier Activities,large,2,221,212,9,682,682,0
2022,4,Makkah Region,Postal and Courier Activities,micro,91,53,28,25,144,140,4
2022,4,Makkah Region,Postal and Courier Activities,medium,5,80,28,52,222,222,0
2022,4,Najran Region,Postal and Courier Activities,micro,3,0,0,0,5,5,0
2022,4,Eastern Province,Programming and Broadcasting Activities,small,3,12,7,5,16,16,0
2022,4,Eastern Province,Programming and Broadcasting Activities,micro,12,3,0,3,26,25,1
2022,4,Al Jawf Region,Programming and Broadcasting Activities,micro,1,0,0,0,1,1,0
2022,4,Riyadh Region,Programming and Broadcasting Activities,small,13,40,21,19,80,78,2
2022,4,Riyadh Region,Programming and Broadcasting Activities,micro,59,31,15,16,106,104,2
2022,4,Riyadh Region,Programming and Broadcasting Activities,medium,4,182,111,71,171,151,20
2022,4,Qassim Region,Programming and Broadcasting Activities,micro,2,0,0,0,3,3,0
2022,4,Al Madinah Region,Programming and Broadcasting Activities,micro,4,1,0,1,9,9,0
2022,4,Tabuk Region,Programming and Broadcasting Activities,micro,3,0,0,0,6,6,0
2022,4,Jazan Region,Programming and Broadcasting Activities,micro,1,1,0,1,3,3,0
2022,4,Hail Region,Programming and Broadcasting Activities,small,1,2,1,1,5,5,0
2022,4,Aseer Region,Programming and Broadcasting Activities,micro,7,2,1,1,12,12,0
2022,4,Makkah Region,Programming and Broadcasting Activities,small,11,74,47,27,91,90,1
2022,4,Makkah Region,Programming and Broadcasting Activities,micro,21,5,2,3,47,44,3
2022,4,Makkah Region,Programming and Broadcasting Activities,medium,1,53,27,26,68,68,0
2022,4,Najran Region,Programming and Broadcasting Activities,micro,2,2,1,1,3,3,0
2022,4,Eastern Province,"Computer Programming, Consultancy, and Related Activities",small,101,720,397,323,889,869,20
2022,4,Eastern Province,"Computer Programming, Consultancy, and Related Activities",large,2,615,554,61,290,290,0
2022,4,Eastern Province,"Computer Programming, Consultancy, and Related Activities",micro,283,240,108,132,421,412,9
2022,4,Eastern Province,"Computer Programming, Consultancy, and Related Activities",medium,11,638,286,352,410,402,8
2022,4,Al Bahah Region,"Computer Programming, Consultancy, and Related Activities",micro,5,3,2,1,7,7,0
2022,4,Al Jawf Region,"Computer Programming, Consultancy, and Related Activities",micro,12,10,6,4,25,25,0
2022,4,Northern Borders Region,"Computer Programming, Consultancy, and Related Activities",micro,8,4,2,2,14,14,0
2022,4,Riyadh Region,"Computer Programming, Consultancy, and Related Activities",small,621,4484,2185,2299,5531,5290,241
2022,4,Riyadh Region,"Computer Programming, Consultancy, and Related Activities",large,24,14531,8950,5581,6177,5844,333
2022,4,Riyadh Region,"Computer Programming, Consultancy, and Related Activities",micro,1445,1122,528,594,2110,2028,82
2022,4,Riyadh Region,"Computer Programming, Consultancy, and Related Activities",medium,99,4906,2918,1988,4806,4677,129
2022,4,Qassim Region,"Computer Programming, Consultancy, and Related Activities",small,13,78,42,36,124,124,0
2022,4,Qassim Region,"Computer Programming, Consultancy, and Related Activities",micro,68,24,9,15,126,126,0
2022,4,Al Madinah Region,"Computer Programming, Consultancy, and Related Activities",small,10,41,17,24,52,51,1
2022,4,Al Madinah Region,"Computer Programming, Consultancy, and Related Activities",micro,84,48,16,32,140,135,5
2022,4,Al Madinah Region,"Computer Programming, Consultancy, and Related Activities",medium,1,39,37,2,18,18,0
2022,4,Tabuk Region,"Computer Programming, Consultancy, and Related Activities",micro,21,6,2,4,43,42,1
2022,4,Jazan Region,"Computer Programming, Consultancy, and Related Activities",small,1,2,2,0,7,7,0
2022,4,Jazan Region,"Computer Programming, Consultancy, and Related Activities",micro,30,8,5,3,61,61,0
2022,4,Hail Region,"Computer Programming, Consultancy, and Related Activities",small,2,5,1,4,18,18,0
2022,4,Hail Region,"Computer Programming, Consultancy, and Related Activities",micro,15,7,3,4,29,29,0
2022,4,Aseer Region,"Computer Programming, Consultancy, and Related Activities",small,8,40,26,14,68,67,1
2022,4,Aseer Region,"Computer Programming, Consultancy, and Related Activities",micro,58,30,18,12,108,107,1
2022,4,Makkah Region,"Computer Programming, Consultancy, and Related Activities",small,142,659,305,354,1162,1107,55
2022,4,Makkah Region,"Computer Programming, Consultancy, and Related Activities",large,1,910,890,20,42,39,3
2022,4,Makkah Region,"Computer Programming, Consultancy, and Related Activities",micro,596,367,180,187,945,905,40
2022,4,Makkah Region,"Computer Programming, Consultancy, and Related Activities",medium,12,504,274,230,566,545,21
2022,4,Najran Region,"Computer Programming, Consultancy, and Related Activities",small,1,9,0,9,0,0,0
2022,4,Najran Region,"Computer Programming, Consultancy, and Related Activities",micro,11,1,0,1,25,25,0
2022,4,Eastern Province,Public Order and Safety Activities,small,26,397,353,44,67,63,4
2022,4,Eastern Province,Public Order and Safety Activities,large,8,4792,4362,430,1,1,0
2022,4,Eastern Province,Public Order and Safety Activities,micro,51,70,52,18,59,59,0
2022,4,Eastern Province,Public Order and Safety Activities,medium,16,1351,1293,58,36,36,0
2022,4,Al Jawf Region,Public Order and Safety Activities,small,2,59,44,15,0,0,0
2022,4,Al Jawf Region,Public Order and Safety Activities,micro,7,9,8,1,3,3,0
2022,4,Northern Borders Region,Public Order and Safety Activities,small,1,16,12,4,0,0,0
2022,4,Northern Borders Region,Public Order and Safety Activities,large,1,0,0,0,333,333,0
2022,4,Northern Borders Region,Public Order and Safety Activities,micro,3,3,3,0,2,1,1
2022,4,Riyadh Region,Public Order and Safety Activities,small,58,870,757,113,190,189,1
2022,4,Riyadh Region,Public Order and Safety Activities,large,18,20078,18193,1885,111,109,2
2022,4,Riyadh Region,Public Order and Safety Activities,micro,108,125,86,39,135,134,1
2022,4,Riyadh Region,Public Order and Safety Activities,medium,19,2477,2198,279,98,95,3
2022,4,Qassim Region,Public Order and Safety Activities,small,4,89,84,5,5,5,0
2022,4,Qassim Region,Public Order and Safety Activities,micro,10,5,4,1,15,15,0
2022,4,Qassim Region,Public Order and Safety Activities,medium,1,51,46,5,34,8,26
2022,4,Al Madinah Region,Public Order and Safety Activities,small,3,30,28,2,7,7,0
2022,4,Al Madinah Region,Public Order and Safety Activities,micro,13,11,9,2,15,15,0
2022,4,Al Madinah Region,Public Order and Safety Activities,medium,2,211,208,3,0,0,0
2022,4,Tabuk Region,Public Order and Safety Activities,micro,7,5,4,1,7,7,0
2022,4,Jazan Region,Public Order and Safety Activities,small,2,31,29,2,7,7,0
2022,4,Jazan Region,Public Order and Safety Activities,micro,10,8,8,0,16,16,0
2022,4,Jazan Region,Public Order and Safety Activities,medium,1,185,183,2,0,0,0
2022,4,Hail Region,Public Order and Safety Activities,small,1,9,9,0,0,0,0
2022,4,Hail Region,Public Order and Safety Activities,micro,3,4,2,2,10,10,0
2022,4,Hail Region,Public Order and Safety Activities,medium,1,70,67,3,0,0,0
2022,4,Aseer Region,Public Order and Safety Activities,small,5,88,82,6,5,5,0
2022,4,Aseer Region,Public Order and Safety Activities,large,2,1197,1170,27,0,0,0
2022,4,Aseer Region,Public Order and Safety Activities,micro,5,7,3,4,2,2,0
2022,4,Makkah Region,Public Order and Safety Activities,small,36,496,432,64,48,44,4
2022,4,Makkah Region,Public Order and Safety Activities,large,5,2265,2096,169,0,0,0
2022,4,Makkah Region,Public Order and Safety Activities,micro,69,71,50,21,85,82,3
2022,4,Makkah Region,Public Order and Safety Activities,medium,9,1173,1010,163,70,70,0
2022,4,Najran Region,Public Order and Safety Activities,large,1,259,231,28,1,1,0
2022,4,Najran Region,Public Order and Safety Activities,micro,2,1,0,1,3,3,0
2022,4,Eastern Province,Activities of Households as Employers of Domestic Personnel,small,1,2,0,2,6,6,0
2022,4,Eastern Province,Activities of Households as Employers of Domestic Personnel,micro,7,1,1,0,10,9,1
2022,4,Al Bahah Region,Activities of Households as Employers of Domestic Personnel,micro,1,0,0,0,1,1,0
2022,4,Riyadh Region,Activities of Households as Employers of Domestic Personnel,micro,9,1,1,0,12,11,1
2022,4,Qassim Region,Activities of Households as Employers of Domestic Personnel,small,1,0,0,0,7,7,0
2022,4,Qassim Region,Activities of Households as Employers of Domestic Personnel,micro,5,1,1,0,10,10,0
2022,4,Al Madinah Region,Activities of Households as Employers of Domestic Personnel,micro,1,0,0,0,3,3,0
2022,4,Jazan Region,Activities of Households as Employers of Domestic Personnel,micro,1,1,0,1,1,0,1
2022,4,Hail Region,Activities of Households as Employers of Domestic Personnel,micro,4,0,0,0,7,7,0
2022,4,Aseer Region,Activities of Households as Employers of Domestic Personnel,small,1,0,0,0,7,7,0
2022,4,Makkah Region,Activities of Households as Employers of Domestic Personnel,micro,1,0,0,0,1,1,0
2022,4,Najran Region,Activities of Households as Employers of Domestic Personnel,micro,1,0,0,0,1,1,0
2022,4,Eastern Province,Extraction of Natural Gas,small,45,252,129,123,289,243,46
2022,4,Eastern Province,Extraction of Natural Gas,large,21,94,65,29,49930,37654,12276
2022,4,Eastern Province,Extraction of Natural Gas,micro,300,334,180,154,376,351,25
2022,4,Eastern Province,Extraction of Natural Gas,medium,9,468,341,127,630,468,162
2022,4,Al Bahah Region,Extraction of Natural Gas,small,1,3,2,1,3,3,0
2022,4,Al Bahah Region,Extraction of Natural Gas,micro,14,10,4,6,10,10,0
2022,4,Al Jawf Region,Extraction of Natural Gas,small,2,12,8,4,5,5,0
2022,4,Al Jawf Region,Extraction of Natural Gas,micro,29,36,16,20,28,28,0
2022,4,Northern Borders Region,Extraction of Natural Gas,small,5,11,1,10,80,9,71
2022,4,Northern Borders Region,Extraction of Natural Gas,micro,19,16,10,6,22,21,1
2022,4,Riyadh Region,Extraction of Natural Gas,small,181,1210,431,779,1186,944,242
2022,4,Riyadh Region,Extraction of Natural Gas,large,50,12342,3362,8980,191860,111059,80801
2022,4,Riyadh Region,Extraction of Natural Gas,micro,762,680,353,327,1077,1029,48
2022,4,Riyadh Region,Extraction of Natural Gas,medium,21,1580,874,706,1292,808,484
2022,4,Qassim Region,Extraction of Natural Gas,small,19,116,33,83,211,155,56
2022,4,Qassim Region,Extraction of Natural Gas,micro,84,83,54,29,117,113,4
2022,4,Qassim Region,Extraction of Natural Gas,medium,1,9,9,0,42,42,0
2022,4,Al Madinah Region,Extraction of Natural Gas,small,7,44,21,23,23,23,0
2022,4,Al Madinah Region,Extraction of Natural Gas,micro,104,85,60,25,157,147,10
2022,4,Tabuk Region,Extraction of Natural Gas,small,2,8,3,5,8,8,0
2022,4,Tabuk Region,Extraction of Natural Gas,micro,55,41,19,22,85,82,3
2022,4,Jazan Region,Extraction of Natural Gas,small,3,6,1,5,51,51,0
2022,4,Jazan Region,Extraction of Natural Gas,micro,35,17,11,6,61,61,0
2022,4,Hail Region,Extraction of Natural Gas,small,8,41,17,24,33,32,1
2022,4,Hail Region,Extraction of Natural Gas,micro,45,34,19,15,62,60,2
2022,4,Hail Region,Extraction of Natural Gas,medium,1,1,1,0,67,0,67
2022,4,Aseer Region,Extraction of Natural Gas,small,11,19,4,15,94,15,79
2022,4,Aseer Region,Extraction of Natural Gas,large,2,0,0,0,15076,10418,4658
2022,4,Aseer Region,Extraction of Natural Gas,micro,123,92,58,34,177,176,1
2022,4,Aseer Region,Extraction of Natural Gas,medium,1,127,43,84,33,29,4
2022,4,Makkah Region,Extraction of Natural Gas,small,42,198,90,108,258,231,27
2022,4,Makkah Region,Extraction of Natural Gas,large,8,117,18,99,15207,12317,2890
2022,4,Makkah Region,Extraction of Natural Gas,micro,380,290,171,119,546,529,17
2022,4,Makkah Region,Extraction of Natural Gas,medium,5,71,22,49,397,142,255
2022,4,Najran Region,Extraction of Natural Gas,small,10,22,10,12,59,52,7
2022,4,Najran Region,Extraction of Natural Gas,micro,49,23,11,12,78,64,14
2022,4,Eastern Province,Civil Engineering,small,425,1573,883,690,6159,6139,20
2022,4,Eastern Province,Civil Engineering,large,97,25893,21302,4591,108288,108149,139
2022,4,Eastern Province,Civil Engineering,micro,554,317,166,151,1165,1159,6
2022,4,Eastern Province,Civil Engineering,medium,174,3932,2813,1119,16405,16382,23
2022,4,Al Bahah Region,Civil Engineering,small,7,12,11,1,52,52,0
2022,4,Al Bahah Region,Civil Engineering,large,1,52,46,6,256,256,0
2022,4,Al Bahah Region,Civil Engineering,micro,24,4,1,3,56,55,1
2022,4,Al Bahah Region,Civil Engineering,medium,2,41,32,9,84,84,0
2022,4,Al Jawf Region,Civil Engineering,small,19,53,37,16,229,228,1
2022,4,Al Jawf Region,Civil Engineering,large,1,122,79,43,290,270,20
2022,4,Al Jawf Region,Civil Engineering,micro,44,8,6,2,98,98,0
2022,4,Al Jawf Region,Civil Engineering,medium,5,124,91,33,407,406,1
2022,4,Northern Borders Region,Civil Engineering,small,7,25,17,8,121,121,0
2022,4,Northern Borders Region,Civil Engineering,micro,37,9,3,6,91,91,0
2022,4,Northern Borders Region,Civil Engineering,medium,1,39,20,19,132,132,0
2022,4,Riyadh Region,Civil Engineering,small,691,2255,1102,1153,9671,9613,58
2022,4,Riyadh Region,Civil Engineering,large,128,28242,19045,9197,129951,129513,438
2022,4,Riyadh Region,Civil Engineering,micro,1230,475,215,260,2657,2632,25
2022,4,Riyadh Region,Civil Engineering,medium,229,4834,3025,1809,22276,22195,81
2022,4,Qassim Region,Civil Engineering,small,75,236,151,85,1029,1027,2
2022,4,Qassim Region,Civil Engineering,large,9,1477,969,508,7951,7950,1
2022,4,Qassim Region,Civil Engineering,micro,149,39,28,11,362,360,2
2022,4,Qassim Region,Civil Engineering,medium,28,581,430,151,2572,2567,5
2022,4,Al Madinah Region,Civil Engineering,small,72,258,165,93,1030,1028,2
2022,4,Al Madinah Region,Civil Engineering,large,9,963,659,304,3592,3577,15
2022,4,Al Madinah Region,Civil Engineering,micro,185,53,28,25,424,421,3
2022,4,Al Madinah Region,Civil Engineering,medium,21,482,374,108,1742,1741,1
2022,4,Tabuk Region,Civil Engineering,small,18,62,32,30,242,242,0
2022,4,Tabuk Region,Civil Engineering,large,1,98,51,47,299,299,0
2022,4,Tabuk Region,Civil Engineering,micro,76,27,13,14,158,157,1
2022,4,Tabuk Region,Civil Engineering,medium,4,90,57,33,316,316,0
2022,4,Jazan Region,Civil Engineering,small,23,61,29,32,284,282,2
2022,4,Jazan Region,Civil Engineering,large,1,68,54,14,416,416,0
2022,4,Jazan Region,Civil Engineering,micro,100,26,10,16,246,246,0
2022,4,Jazan Region,Civil Engineering,medium,7,162,101,61,713,713,0
2022,4,Hail Region,Civil Engineering,small,24,66,36,30,273,272,1
2022,4,Hail Region,Civil Engineering,large,1,109,73,36,642,642,0
2022,4,Hail Region,Civil Engineering,micro,66,11,5,6,157,155,2
2022,4,Hail Region,Civil Engineering,medium,7,141,110,31,552,549,3
2022,4,Aseer Region,Civil Engineering,small,60,182,117,65,663,661,2
2022,4,Aseer Region,Civil Engineering,large,8,737,605,132,3490,3490,0
2022,4,Aseer Region,Civil Engineering,micro,146,49,33,16,328,328,0
2022,4,Aseer Region,Civil Engineering,medium,24,595,451,144,2253,2252,1
2022,4,Makkah Region,Civil Engineering,small,354,1168,623,545,4768,4739,29
2022,4,Makkah Region,Civil Engineering,large,39,7435,5429,2006,35146,35097,49
2022,4,Makkah Region,Civil Engineering,micro,671,264,147,117,1483,1462,21
2022,4,Makkah Region,Civil Engineering,medium,98,1918,1254,664,8501,8470,31
2022,4,Najran Region,Civil Engineering,small,23,102,47,55,363,363,0
2022,4,Najran Region,Civil Engineering,large,6,738,535,203,3265,3265,0
2022,4,Najran Region,Civil Engineering,micro,63,23,11,12,146,145,1
2022,4,Najran Region,Civil Engineering,medium,7,126,79,47,629,626,3
2022,4,Eastern Province,Water Transport,small,31,211,156,55,231,226,5
2022,4,Eastern Province,Water Transport,micro,45,29,24,5,65,65,0
2022,4,Eastern Province,Water Transport,medium,12,729,587,142,319,312,7
2022,4,Al Bahah Region,Water Transport,micro,1,0,0,0,2,2,0
2022,4,Northern Borders Region,Water Transport,micro,1,0,0,0,1,1,0
2022,4,Riyadh Region,Water Transport,small,18,116,56,60,176,175,1
2022,4,Riyadh Region,Water Transport,micro,115,38,21,17,278,274,4
2022,4,Riyadh Region,Water Transport,medium,3,163,124,39,89,88,1
2022,4,Qassim Region,Water Transport,small,1,0,0,0,8,8,0
2022,4,Qassim Region,Water Transport,micro,6,1,1,0,11,11,0
2022,4,Al Madinah Region,Water Transport,small,5,36,29,7,46,46,0
2022,4,Al Madinah Region,Water Transport,micro,23,11,8,3,38,38,0
2022,4,Al Madinah Region,Water Transport,medium,2,54,44,10,65,63,2
2022,4,Tabuk Region,Water Transport,small,3,32,22,10,41,29,12
2022,4,Tabuk Region,Water Transport,micro,13,8,4,4,19,19,0
2022,4,Jazan Region,Water Transport,small,4,58,39,19,27,27,0
2022,4,Jazan Region,Water Transport,micro,10,3,2,1,19,19,0
2022,4,Hail Region,Water Transport,micro,2,1,0,1,2,2,0
2022,4,Aseer Region,Water Transport,micro,13,1,1,0,34,34,0
2022,4,Makkah Region,Water Transport,small,34,212,149,63,291,286,5
2022,4,Makkah Region,Water Transport,micro,130,51,27,24,222,217,5
2022,4,Makkah Region,Water Transport,medium,5,195,125,70,246,245,1
2022,4,Najran Region,Water Transport,small,1,0,0,0,6,6,0
2022,4,Najran Region,Water Transport,micro,6,0,0,0,12,12,0
2022,4,Eastern Province,Air Transport,small,14,96,68,28,125,124,1
2022,4,Eastern Province,Air Transport,micro,66,29,17,12,116,116,0
2022,4,Al Jawf Region,Air Transport,small,1,0,0,0,15,15,0
2022,4,Al Jawf Region,Air Transport,micro,6,1,1,0,15,15,0
2022,4,Northern Borders Region,Air Transport,small,2,12,9,3,25,25,0
2022,4,Riyadh Region,Air Transport,small,20,90,55,35,235,235,0
2022,4,Riyadh Region,Air Transport,large,3,2139,1953,186,1598,1034,564
2022,4,Riyadh Region,Air Transport,micro,236,58,34,24,589,584,5
2022,4,Riyadh Region,Air Transport,medium,7,355,290,65,310,270,40
2022,4,Qassim Region,Air Transport,small,1,1,0,1,5,5,0
2022,4,Qassim Region,Air Transport,micro,9,4,1,3,17,17,0
2022,4,Al Madinah Region,Air Transport,small,1,4,3,1,6,6,0
2022,4,Al Madinah Region,Air Transport,micro,10,3,2,1,22,22,0
2022,4,Tabuk Region,Air Transport,small,2,13,11,2,30,30,0
2022,4,Tabuk Region,Air Transport,micro,7,2,1,1,11,11,0
2022,4,Jazan Region,Air Transport,micro,11,1,1,0,26,26,0
2022,4,Hail Region,Air Transport,small,1,7,7,0,15,15,0
2022,4,Hail Region,Air Transport,micro,16,2,1,1,48,47,1
2022,4,Aseer Region,Air Transport,small,1,0,0,0,7,7,0
2022,4,Aseer Region,Air Transport,micro,13,4,3,1,28,28,0
2022,4,Makkah Region,Air Transport,small,26,138,93,45,238,235,3
2022,4,Makkah Region,Air Transport,large,2,5733,5152,581,251,131,120
2022,4,Makkah Region,Air Transport,micro,88,53,36,17,152,150,2
2022,4,Makkah Region,Air Transport,medium,3,127,98,29,105,105,0
2022,4,Najran Region,Air Transport,micro,2,0,0,0,6,6,0
2022,4,Eastern Province,Land Transport and Transport Via Pipelines,small,812,2847,1553,1294,11869,11861,8
2022,4,Eastern Province,Land Transport and Transport Via Pipelines,large,51,9056,7447,1609,22982,22974,8
2022,4,Eastern Province,Land Transport and Transport Via Pipelines,micro,2018,565,274,291,4035,4025,10
2022,4,Eastern Province,Land Transport and Transport Via Pipelines,medium,214,4857,3187,1670,15519,15497,22
2022,4,Al Bahah Region,Land Transport and Transport Via Pipelines,small,10,28,15,13,143,143,0
2022,4,Al Bahah Region,Land Transport and Transport Via Pipelines,micro,190,32,23,9,390,389,1
2022,4,Al Jawf Region,Land Transport and Transport Via Pipelines,small,93,197,120,77,1090,1090,0
2022,4,Al Jawf Region,Land Transport and Transport Via Pipelines,micro,578,55,27,28,1239,1236,3
2022,4,Al Jawf Region,Land Transport and Transport Via Pipelines,medium,7,119,55,64,459,459,0
2022,4,Northern Borders Region,Land Transport and Transport Via Pipelines,small,66,142,74,68,703,703,0
2022,4,Northern Borders Region,Land Transport and Transport Via Pipelines,micro,320,39,26,13,631,631,0
2022,4,Northern Borders Region,Land Transport and Transport Via Pipelines,medium,1,46,35,11,147,147,0
2022,4,Riyadh Region,Land Transport and Transport Via Pipelines,small,1263,3517,1473,2044,15842,15798,44
2022,4,Riyadh Region,Land Transport and Transport Via Pipelines,large,57,17697,15138,2559,31489,31462,27
2022,4,Riyadh Region,Land Transport and Transport Via Pipelines,micro,13411,1594,736,858,36106,35937,169
2022,4,Riyadh Region,Land Transport and Transport Via Pipelines,medium,232,5260,2797,2463,18946,18920,26
2022,4,Qassim Region,Land Transport and Transport Via Pipelines,small,253,754,394,360,3039,3038,1
2022,4,Qassim Region,Land Transport and Transport Via Pipelines,large,7,640,555,85,2187,2187,0
2022,4,Qassim Region,Land Transport and Transport Via Pipelines,micro,1157,220,116,104,2616,2614,2
2022,4,Qassim Region,Land Transport and Transport Via Pipelines,medium,30,595,385,210,2221,2205,16
2022,4,Al Madinah Region,Land Transport and Transport Via Pipelines,small,167,446,253,193,2002,2002,0
2022,4,Al Madinah Region,Land Transport and Transport Via Pipelines,large,1,104,44,60,324,324,0
2022,4,Al Madinah Region,Land Transport and Transport Via Pipelines,micro,1036,143,74,69,2075,2073,2
2022,4,Al Madinah Region,Land Transport and Transport Via Pipelines,medium,24,430,297,133,1502,1502,0
2022,4,Tabuk Region,Land Transport and Transport Via Pipelines,small,66,118,56,62,614,613,1
2022,4,Tabuk Region,Land Transport and Transport Via Pipelines,micro,609,93,46,47,1213,1209,4
2022,4,Tabuk Region,Land Transport and Transport Via Pipelines,medium,8,207,158,49,415,415,0
2022,4,Jazan Region,Land Transport and Transport Via Pipelines,small,40,75,42,33,397,397,0
2022,4,Jazan Region,Land Transport and Transport Via Pipelines,large,1,702,530,172,244,233,11
2022,4,Jazan Region,Land Transport and Transport Via Pipelines,micro,579,69,36,33,1278,1271,7
2022,4,Jazan Region,Land Transport and Transport Via Pipelines,medium,7,230,155,75,470,466,4
2022,4,Hail Region,Land Transport and Transport Via Pipelines,small,59,108,44,64,577,577,0
2022,4,Hail Region,Land Transport and Transport Via Pipelines,micro,662,71,33,38,1678,1674,4
2022,4,Hail Region,Land Transport and Transport Via Pipelines,medium,4,44,24,20,172,172,0
2022,4,Aseer Region,Land Transport and Transport Via Pipelines,small,292,719,439,280,3030,3018,12
2022,4,Aseer Region,Land Transport and Transport Via Pipelines,large,2,137,108,29,413,413,0
2022,4,Aseer Region,Land Transport and Transport Via Pipelines,micro,1854,284,152,132,3657,3651,6
2022,4,Aseer Region,Land Transport and Transport Via Pipelines,medium,16,391,250,141,1222,1222,0
2022,4,Makkah Region,Land Transport and Transport Via Pipelines,small,977,3188,1534,1654,12457,12398,59
2022,4,Makkah Region,Land Transport and Transport Via Pipelines,large,24,3579,2647,932,11483,11437,46
2022,4,Makkah Region,Land Transport and Transport Via Pipelines,micro,3741,726,382,344,8079,7996,83
2022,4,Makkah Region,Land Transport and Transport Via Pipelines,medium,142,3106,1879,1227,10370,10318,52
2022,4,Najran Region,Land Transport and Transport Via Pipelines,small,106,226,109,117,1230,1229,1
2022,4,Najran Region,Land Transport and Transport Via Pipelines,micro,997,95,53,42,2477,2472,5
2022,4,Najran Region,Land Transport and Transport Via Pipelines,medium,4,97,75,22,295,295,0
2022,4,Eastern Province,Printing and Reproduction of Recorded Media,small,53,250,112,138,560,560,0
2022,4,Eastern Province,Printing and Reproduction of Recorded Media,large,1,484,333,151,358,352,6
2022,4,Eastern Province,Printing and Reproduction of Recorded Media,micro,83,64,28,36,131,130,1
2022,4,Eastern Province,Printing and Reproduction of Recorded Media,medium,3,84,46,38,209,209,0
2022,4,Al Bahah Region,Printing and Reproduction of Recorded Media,small,2,6,2,4,10,10,0
2022,4,Al Bahah Region,Printing and Reproduction of Recorded Media,micro,8,7,3,4,17,17,0
2022,4,Al Jawf Region,Printing and Reproduction of Recorded Media,micro,9,2,2,0,19,19,0
2022,4,Northern Borders Region,Printing and Reproduction of Recorded Media,small,2,2,0,2,11,11,0
2022,4,Northern Borders Region,Printing and Reproduction of Recorded Media,micro,6,2,1,1,12,12,0
2022,4,Riyadh Region,Printing and Reproduction of Recorded Media,small,159,895,344,551,1737,1724,13
2022,4,Riyadh Region,Printing and Reproduction of Recorded Media,micro,273,157,60,97,473,469,4
2022,4,Riyadh Region,Printing and Reproduction of Recorded Media,medium,11,398,221,177,702,698,4
2022,4,Qassim Region,Printing and Reproduction of Recorded Media,small,10,74,30,44,118,118,0
2022,4,Qassim Region,Printing and Reproduction of Recorded Media,micro,29,15,10,5,52,52,0
2022,4,Qassim Region,Printing and Reproduction of Recorded Media,medium,1,18,7,11,51,51,0
2022,4,Al Madinah Region,Printing and Reproduction of Recorded Media,small,14,31,12,19,101,100,1
2022,4,Al Madinah Region,Printing and Reproduction of Recorded Media,micro,41,13,7,6,83,83,0
2022,4,Tabuk Region,Printing and Reproduction of Recorded Media,small,4,14,7,7,43,43,0
2022,4,Tabuk Region,Printing and Reproduction of Recorded Media,micro,20,10,3,7,37,36,1
2022,4,Jazan Region,Printing and Reproduction of Recorded Media,small,2,8,4,4,14,14,0
2022,4,Jazan Region,Printing and Reproduction of Recorded Media,micro,13,4,2,2,34,34,0
2022,4,Hail Region,Printing and Reproduction of Recorded Media,small,3,9,5,4,20,20,0
2022,4,Hail Region,Printing and Reproduction of Recorded Media,micro,20,6,3,3,37,37,0
2022,4,Aseer Region,Printing and Reproduction of Recorded Media,small,10,43,14,29,85,83,2
2022,4,Aseer Region,Printing and Reproduction of Recorded Media,micro,27,11,8,3,52,52,0
2022,4,Makkah Region,Printing and Reproduction of Recorded Media,small,79,389,167,222,837,831,6
2022,4,Makkah Region,Printing and Reproduction of Recorded Media,micro,208,70,39,31,394,384,10
2022,4,Makkah Region,Printing and Reproduction of Recorded Media,medium,8,223,81,142,356,351,5
2022,4,Najran Region,Printing and Reproduction of Recorded Media,small,1,6,3,3,15,15,0
2022,4,Najran Region,Printing and Reproduction of Recorded Media,micro,9,5,2,3,21,21,0
2022,4,Eastern Province,Other Manufacturing,small,86,406,294,112,1207,1202,5
2022,4,Eastern Province,Other Manufacturing,large,6,966,909,57,1563,1559,4
2022,4,Eastern Province,Other Manufacturing,micro,99,69,50,19,178,174,4
2022,4,Eastern Province,Other Manufacturing,medium,22,498,345,153,1277,1274,3
2022,4,Al Bahah Region,Other Manufacturing,micro,10,4,3,1,21,20,1
2022,4,Al Jawf Region,Other Manufacturing,small,1,0,0,0,7,7,0
2022,4,Al Jawf Region,Other Manufacturing,micro,7,2,1,1,9,9,0
2022,4,Northern Borders Region,Other Manufacturing,micro,4,0,0,0,8,8,0
2022,4,Riyadh Region,Other Manufacturing,small,173,689,297,392,2805,2657,148
2022,4,Riyadh Region,Other Manufacturing,large,6,672,221,451,2186,2164,22
2022,4,Riyadh Region,Other Manufacturing,micro,198,102,56,46,437,424,13
2022,4,Riyadh Region,Other Manufacturing,medium,59,1280,789,491,4278,4223,55
2022,4,Qassim Region,Other Manufacturing,small,7,41,34,7,116,116,0
2022,4,Qassim Region,Other Manufacturing,micro,20,14,13,1,39,39,0
2022,4,Qassim Region,Other Manufacturing,medium,4,114,29,85,324,324,0
2022,4,Al Madinah Region,Other Manufacturing,small,7,31,20,11,91,90,1
2022,4,Al Madinah Region,Other Manufacturing,micro,34,16,11,5,56,55,1
2022,4,Tabuk Region,Other Manufacturing,small,2,7,5,2,14,14,0
2022,4,Tabuk Region,Other Manufacturing,micro,11,2,2,0,26,23,3
2022,4,Jazan Region,Other Manufacturing,small,2,1,1,0,20,20,0
2022,4,Jazan Region,Other Manufacturing,micro,19,3,3,0,47,46,1
2022,4,Hail Region,Other Manufacturing,small,2,5,5,0,9,9,0
2022,4,Hail Region,Other Manufacturing,micro,15,6,2,4,35,34,1
2022,4,Aseer Region,Other Manufacturing,small,17,43,26,17,185,180,5
2022,4,Aseer Region,Other Manufacturing,micro,32,14,10,4,65,62,3
2022,4,Makkah Region,Other Manufacturing,small,109,466,214,252,1533,1514,19
2022,4,Makkah Region,Other Manufacturing,large,7,848,605,243,2646,2633,13
2022,4,Makkah Region,Other Manufacturing,micro,165,77,42,35,316,302,14
2022,4,Makkah Region,Other Manufacturing,medium,25,564,331,233,1807,1803,4
2022,4,Najran Region,Other Manufacturing,small,2,10,4,6,19,14,5
2022,4,Najran Region,Other Manufacturing,micro,5,6,4,2,10,10,0
2022,4,Najran Region,Other Manufacturing,medium,1,33,33,0,117,117,0
2022,4,Eastern Province,Sewerage,small,20,61,30,31,216,216,0
2022,4,Eastern Province,Sewerage,large,2,243,203,40,1578,1578,0
2022,4,Eastern Province,Sewerage,micro,31,13,7,6,75,74,1
2022,4,Eastern Province,Sewerage,medium,4,46,17,29,180,178,2
2022,4,Al Bahah Region,Sewerage,micro,4,2,0,2,16,16,0
2022,4,Al Jawf Region,Sewerage,micro,8,0,0,0,14,14,0
2022,4,Northern Borders Region,Sewerage,micro,3,0,0,0,8,8,0
2022,4,Riyadh Region,Sewerage,small,27,58,28,30,354,353,1
2022,4,Riyadh Region,Sewerage,large,1,944,594,350,7220,7205,15
2022,4,Riyadh Region,Sewerage,micro,110,18,10,8,249,248,1
2022,4,Riyadh Region,Sewerage,medium,5,112,77,35,600,600,0
2022,4,Qassim Region,Sewerage,small,4,14,7,7,53,52,1
2022,4,Qassim Region,Sewerage,micro,26,8,7,1,66,66,0
2022,4,Al Madinah Region,Sewerage,small,11,19,11,8,128,128,0
2022,4,Al Madinah Region,Sewerage,micro,13,3,3,0,29,29,0
2022,4,Al Madinah Region,Sewerage,medium,1,103,103,0,24,24,0
2022,4,Tabuk Region,Sewerage,small,1,1,0,1,8,8,0
2022,4,Tabuk Region,Sewerage,micro,7,4,2,2,16,15,1
2022,4,Jazan Region,Sewerage,small,1,1,1,0,6,6,0
2022,4,Jazan Region,Sewerage,micro,24,4,4,0,54,54,0
2022,4,Hail Region,Sewerage,small,4,16,13,3,61,61,0
2022,4,Hail Region,Sewerage,micro,11,2,2,0,27,27,0
2022,4,Hail Region,Sewerage,medium,1,12,9,3,58,58,0
2022,4,Aseer Region,Sewerage,small,2,4,3,1,45,45,0
2022,4,Aseer Region,Sewerage,micro,9,2,1,1,21,21,0
2022,4,Aseer Region,Sewerage,medium,1,21,15,6,67,67,0
2022,4,Makkah Region,Sewerage,small,28,52,32,20,365,363,2
2022,4,Makkah Region,Sewerage,large,1,255,229,26,1223,1223,0
2022,4,Makkah Region,Sewerage,micro,70,28,17,11,154,153,1
2022,4,Makkah Region,Sewerage,medium,2,18,12,6,109,109,0
2022,4,Najran Region,Sewerage,micro,3,0,0,0,4,4,0
2022,4,Eastern Province,Human Health Activities,small,341,2580,597,1983,4444,2161,2283
2022,4,Eastern Province,Human Health Activities,large,32,9417,3346,6071,14809,6703,8106
2022,4,Eastern Province,Human Health Activities,micro,197,211,61,150,322,236,86
2022,4,Eastern Province,Human Health Activities,medium,108,4099,1001,3098,7185,3928,3257
2022,4,Al Bahah Region,Human Health Activities,small,35,215,78,137,396,160,236
2022,4,Al Bahah Region,Human Health Activities,micro,20,18,8,10,32,25,7
2022,4,Al Bahah Region,Human Health Activities,medium,2,37,15,22,69,28,41
2022,4,Al Jawf Region,Human Health Activities,small,44,284,92,192,491,260,231
2022,4,Al Jawf Region,Human Health Activities,micro,25,23,7,16,34,25,9
2022,4,Al Jawf Region,Human Health Activities,medium,7,178,44,134,319,175,144
2022,4,Northern Borders Region,Human Health Activities,small,35,184,35,149,403,231,172
2022,4,Northern Borders Region,Human Health Activities,micro,18,22,6,16,36,26,10
2022,4,Northern Borders Region,Human Health Activities,medium,5,112,35,77,220,110,110
2022,4,Riyadh Region,Human Health Activities,small,932,6630,1907,4723,12399,5856,6543
2022,4,Riyadh Region,Human Health Activities,large,81,12440,4875,7565,58565,45866,12699
2022,4,Riyadh Region,Human Health Activities,micro,635,474,173,301,1020,689,331
2022,4,Riyadh Region,Human Health Activities,medium,286,8439,2472,5967,18222,9655,8567
2022,4,Qassim Region,Human Health Activities,small,113,871,288,583,1456,582,874
2022,4,Qassim Region,Human Health Activities,large,6,716,348,368,2880,2026,854
2022,4,Qassim Region,Human Health Activities,micro,63,39,25,14,107,82,25
2022,4,Qassim Region,Human Health Activities,medium,32,797,317,480,2026,1098,928
2022,4,Al Madinah Region,Human Health Activities,small,168,1274,386,888,2156,966,1190
2022,4,Al Madinah Region,Human Health Activities,large,10,1490,609,881,2849,1518,1331
2022,4,Al Madinah Region,Human Health Activities,micro,78,76,37,39,145,92,53
2022,4,Al Madinah Region,Human Health Activities,medium,30,698,227,471,1446,639,807
2022,4,Tabuk Region,Human Health Activities,small,64,432,108,324,752,371,381
2022,4,Tabuk Region,Human Health Activities,large,1,114,57,57,226,135,91
2022,4,Tabuk Region,Human Health Activities,micro,35,25,5,20,61,48,13
2022,4,Tabuk Region,Human Health Activities,medium,13,422,94,328,636,339,297
2022,4,Jazan Region,Human Health Activities,small,103,880,196,684,1210,565,645
2022,4,Jazan Region,Human Health Activities,large,2,321,128,193,717,250,467
2022,4,Jazan Region,Human Health Activities,micro,72,44,13,31,134,107,27
2022,4,Jazan Region,Human Health Activities,medium,18,590,156,434,991,512,479
2022,4,Hail Region,Human Health Activities,small,62,369,104,265,702,344,358
2022,4,Hail Region,Human Health Activities,large,2,298,105,193,589,249,340
2022,4,Hail Region,Human Health Activities,micro,52,38,14,24,97,83,14
2022,4,Hail Region,Human Health Activities,medium,16,561,182,379,1053,528,525
2022,4,Aseer Region,Human Health Activities,small,201,1506,421,1085,2445,1079,1366
2022,4,Aseer Region,Human Health Activities,large,5,1096,487,609,3536,2444,1092
2022,4,Aseer Region,Human Health Activities,micro,103,85,31,54,161,129,32
2022,4,Aseer Region,Human Health Activities,medium,41,1362,382,980,2609,1202,1407
2022,4,Makkah Region,Human Health Activities,small,734,5644,1443,4201,8996,4291,4705
2022,4,Makkah Region,Human Health Activities,large,30,6733,2475,4258,12921,6390,6531
2022,4,Makkah Region,Human Health Activities,micro,442,378,144,234,657,481,176
2022,4,Makkah Region,Human Health Activities,medium,176,6117,1702,4415,11479,5803,5676
2022,4,Najran Region,Human Health Activities,small,61,372,159,213,740,366,374
2022,4,Najran Region,Human Health Activities,large,2,90,72,18,502,423,79
2022,4,Najran Region,Human Health Activities,micro,37,29,16,13,72,45,27
2022,4,Najran Region,Human Health Activities,medium,9,335,158,177,664,350,314
2022,4,Eastern Province,Residential Care Activities,small,14,211,11,200,77,39,38
2022,4,Eastern Province,Residential Care Activities,micro,2,3,0,3,0,0,0
2022,4,Eastern Province,Residential Care Activities,medium,1,55,14,41,71,52,19
2022,4,Al Jawf Region,Residential Care Activities,small,2,51,0,51,0,0,0
2022,4,Al Jawf Region,Residential Care Activities,micro,2,1,1,0,1,1,0
2022,4,Riyadh Region,Residential Care Activities,small,28,565,64,501,132,65,67
2022,4,Riyadh Region,Residential Care Activities,micro,16,14,5,9,18,15,3
2022,4,Riyadh Region,Residential Care Activities,medium,5,343,54,289,192,120,72
2022,4,Qassim Region,Residential Care Activities,small,2,54,6,48,7,3,4
2022,4,Qassim Region,Residential Care Activities,micro,1,1,0,1,0,0,0
2022,4,Qassim Region,Residential Care Activities,medium,3,134,59,75,74,51,23
2022,4,Al Madinah Region,Residential Care Activities,small,4,55,32,23,32,24,8
2022,4,Al Madinah Region,Residential Care Activities,micro,6,11,9,2,5,3,2
2022,4,Tabuk Region,Residential Care Activities,small,2,54,2,52,5,4,1
2022,4,Tabuk Region,Residential Care Activities,micro,1,4,1,3,1,1,0
2022,4,Tabuk Region,Residential Care Activities,medium,1,46,1,45,10,5,5
2022,4,Jazan Region,Residential Care Activities,small,3,50,4,46,5,1,4
2022,4,Jazan Region,Residential Care Activities,micro,1,1,1,0,0,0,0
2022,4,Jazan Region,Residential Care Activities,medium,1,62,1,61,12,5,7
2022,4,Hail Region,Residential Care Activities,small,2,27,8,19,2,0,2
2022,4,Hail Region,Residential Care Activities,micro,1,1,0,1,0,0,0
2022,4,Aseer Region,Residential Care Activities,small,4,68,10,58,26,14,12
2022,4,Aseer Region,Residential Care Activities,micro,3,3,0,3,3,3,0
2022,4,Aseer Region,Residential Care Activities,medium,2,116,2,114,7,0,7
2022,4,Makkah Region,Residential Care Activities,small,21,369,59,310,118,74,44
2022,4,Makkah Region,Residential Care Activities,micro,10,11,3,8,9,8,1
2022,4,Makkah Region,Residential Care Activities,medium,5,235,30,205,96,61,35
2022,4,Najran Region,Residential Care Activities,small,1,11,4,7,4,0,4
2022,4,Eastern Province,Forestry and Logging,micro,4,2,2,0,9,9,0
2022,4,Al Jawf Region,Forestry and Logging,micro,1,0,0,0,2,2,0
2022,4,Riyadh Region,Forestry and Logging,small,1,3,2,1,20,20,0
2022,4,Riyadh Region,Forestry and Logging,micro,6,1,0,1,13,13,0
2022,4,Qassim Region,Forestry and Logging,micro,1,0,0,0,1,1,0
2022,4,Al Madinah Region,Forestry and Logging,micro,1,1,0,1,1,1,0
2022,4,Jazan Region,Forestry and Logging,micro,1,1,0,1,0,0,0
2022,4,Hail Region,Forestry and Logging,micro,1,0,0,0,2,2,0
2022,4,Makkah Region,Forestry and Logging,micro,3,1,0,1,6,6,0
2022,4,Eastern Province,Education,small,309,4022,1077,2945,2095,1827,268
2022,4,Eastern Province,Education,large,12,3976,1837,2139,1013,860,153
2022,4,Eastern Province,Education,micro,362,380,152,228,483,433,50
2022,4,Eastern Province,Education,medium,94,5849,1747,4102,4524,3764,760
2022,4,Al Bahah Region,Education,small,8,95,46,49,87,81,6
2022,4,Al Bahah Region,Education,micro,16,13,5,8,24,21,3
2022,4,Al Jawf Region,Education,small,33,466,221,245,255,234,21
2022,4,Al Jawf Region,Education,micro,57,42,19,23,93,88,5
2022,4,Al Jawf Region,Education,medium,10,521,188,333,302,273,29
2022,4,Northern Borders Region,Education,small,18,196,136,60,154,148,6
2022,4,Northern Borders Region,Education,micro,23,22,3,19,34,34,0
2022,4,Northern Borders Region,Education,medium,3,191,58,133,82,65,17
2022,4,Riyadh Region,Education,small,672,6455,1538,4917,4978,4137,841
2022,4,Riyadh Region,Education,large,48,16859,7880,8979,10053,8235,1818
2022,4,Riyadh Region,Education,micro,5685,1035,394,641,13224,12999,225
2022,4,Riyadh Region,Education,medium,205,13014,3865,9149,9519,8033,1486
2022,4,Qassim Region,Education,small,68,954,248,706,376,337,39
2022,4,Qassim Region,Education,large,2,354,121,233,303,213,90
2022,4,Qassim Region,Education,micro,120,51,20,31,251,235,16
2022,4,Qassim Region,Education,medium,18,947,437,510,642,474,168
2022,4,Al Madinah Region,Education,small,122,1651,324,1327,682,586,96
2022,4,Al Madinah Region,Education,large,3,588,268,320,237,175,62
2022,4,Al Madinah Region,Education,micro,146,135,33,102,208,195,13
2022,4,Al Madinah Region,Education,medium,34,2036,599,1437,1226,958,268
2022,4,Tabuk Region,Education,small,58,850,308,542,477,430,47
2022,4,Tabuk Region,Education,micro,33,34,4,30,39,37,2
2022,4,Tabuk Region,Education,medium,18,1113,474,639,696,644,52
2022,4,Jazan Region,Education,small,51,355,91,264,305,273,32
2022,4,Jazan Region,Education,micro,97,77,14,63,162,153,9
2022,4,Jazan Region,Education,medium,6,273,127,146,170,108,62
2022,4,Hail Region,Education,small,30,321,73,248,116,99,17
2022,4,Hail Region,Education,micro,113,45,11,34,248,247,1
2022,4,Hail Region,Education,medium,6,407,219,188,228,226,2
2022,4,Aseer Region,Education,small,74,1046,227,819,423,362,61
2022,4,Aseer Region,Education,micro,110,101,27,74,149,141,8
2022,4,Aseer Region,Education,medium,20,936,557,379,679,620,59
2022,4,Makkah Region,Education,small,405,5064,1002,4062,2562,1920,642
2022,4,Makkah Region,Education,large,17,4607,1914,2693,2205,1386,819
2022,4,Makkah Region,Education,micro,614,451,125,326,965,852,113
2022,4,Makkah Region,Education,medium,146,8647,3565,5082,6399,5162,1237
2022,4,Najran Region,Education,small,21,251,52,199,137,128,9
2022,4,Najran Region,Education,micro,81,25,8,17,160,158,2
2022,4,Najran Region,Education,medium,5,326,172,154,127,124,3
2022,4,Eastern Province,Warehousing and Support Activities for Transportation,small,326,1582,1110,472,3365,3352,13
2022,4,Eastern Province,Warehousing and Support Activities for Transportation,large,13,3850,3237,613,6241,6191,50
2022,4,Eastern Province,Warehousing and Support Activities for Transportation,micro,716,518,396,122,1236,1231,5
2022,4,Eastern Province,Warehousing and Support Activities for Transportation,medium,61,2269,1767,502,3126,3113,13
2022,4,Al Bahah Region,Warehousing and Support Activities for Transportation,small,2,2,1,1,15,15,0
2022,4,Al Bahah Region,Warehousing and Support Activities for Transportation,micro,26,10,6,4,51,51,0
2022,4,Al Jawf Region,Warehousing and Support Activities for Transportation,small,26,87,72,15,238,237,1
2022,4,Al Jawf Region,Warehousing and Support Activities for Transportation,micro,97,29,26,3,176,176,0
2022,4,Northern Borders Region,Warehousing and Support Activities for Transportation,small,3,6,6,0,19,19,0
2022,4,Northern Borders Region,Warehousing and Support Activities for Transportation,micro,32,10,5,5,58,58,0
2022,4,Northern Borders Region,Warehousing and Support Activities for Transportation,medium,1,27,26,1,29,29,0
2022,4,Riyadh Region,Warehousing and Support Activities for Transportation,small,506,2392,1253,1139,6271,6224,47
2022,4,Riyadh Region,Warehousing and Support Activities for Transportation,large,26,9905,7469,2436,8353,8263,90
2022,4,Riyadh Region,Warehousing and Support Activities for Transportation,micro,1650,598,358,240,3705,3686,19
2022,4,Riyadh Region,Warehousing and Support Activities for Transportation,medium,110,3191,1769,1422,8136,8079,57
2022,4,Qassim Region,Warehousing and Support Activities for Transportation,small,33,94,67,27,407,407,0
2022,4,Qassim Region,Warehousing and Support Activities for Transportation,large,1,52,46,6,250,250,0
2022,4,Qassim Region,Warehousing and Support Activities for Transportation,micro,150,49,27,22,307,305,2
2022,4,Qassim Region,Warehousing and Support Activities for Transportation,medium,7,124,81,43,507,507,0
2022,4,Al Madinah Region,Warehousing and Support Activities for Transportation,small,39,173,124,49,423,422,1
2022,4,Al Madinah Region,Warehousing and Support Activities for Transportation,large,2,989,895,94,321,321,0
2022,4,Al Madinah Region,Warehousing and Support Activities for Transportation,micro,209,71,47,24,382,381,1
2022,4,Al Madinah Region,Warehousing and Support Activities for Transportation,medium,6,239,222,17,253,253,0
2022,4,Tabuk Region,Warehousing and Support Activities for Transportation,small,23,61,40,21,218,218,0
2022,4,Tabuk Region,Warehousing and Support Activities for Transportation,micro,83,28,20,8,168,168,0
2022,4,Tabuk Region,Warehousing and Support Activities for Transportation,medium,2,81,43,38,228,228,0
2022,4,Jazan Region,Warehousing and Support Activities for Transportation,small,16,66,53,13,131,130,1
2022,4,Jazan Region,Warehousing and Support Activities for Transportation,micro,81,16,11,5,192,192,0
2022,4,Jazan Region,Warehousing and Support Activities for Transportation,medium,3,66,42,24,169,169,0
2022,4,Hail Region,Warehousing and Support Activities for Transportation,small,12,12,7,5,90,90,0
2022,4,Hail Region,Warehousing and Support Activities for Transportation,micro,66,21,13,8,150,150,0
2022,4,Aseer Region,Warehousing and Support Activities for Transportation,small,41,164,128,36,529,528,1
2022,4,Aseer Region,Warehousing and Support Activities for Transportation,large,1,62,35,27,308,308,0
2022,4,Aseer Region,Warehousing and Support Activities for Transportation,micro,136,49,30,19,283,283,0
2022,4,Aseer Region,Warehousing and Support Activities for Transportation,medium,3,54,53,1,164,164,0
2022,4,Makkah Region,Warehousing and Support Activities for Transportation,small,464,2065,1348,717,5263,5213,50
2022,4,Makkah Region,Warehousing and Support Activities for Transportation,large,20,6209,5357,852,9238,9217,21
2022,4,Makkah Region,Warehousing and Support Activities for Transportation,micro,937,552,352,200,1726,1693,33
2022,4,Makkah Region,Warehousing and Support Activities for Transportation,medium,93,3525,2584,941,6447,6398,49
2022,4,Najran Region,Warehousing and Support Activities for Transportation,small,61,54,25,29,578,578,0
2022,4,Najran Region,Warehousing and Support Activities for Transportation,micro,506,52,31,21,1408,1403,5
2022,4,Eastern Province,"Research and Development in the Physical, Engineering, and Life Sciences",small,8,54,39,15,36,35,1
2022,4,Eastern Province,"Research and Development in the Physical, Engineering, and Life Sciences",micro,17,22,9,13,16,16,0
2022,4,Eastern Province,"Research and Development in the Physical, Engineering, and Life Sciences",medium,2,136,84,52,124,120,4
2022,4,Northern Borders Region,"Research and Development in the Physical, Engineering, and Life Sciences",micro,1,1,1,0,0,0,0
2022,4,Riyadh Region,"Research and Development in the Physical, Engineering, and Life Sciences",small,37,323,179,144,248,221,27
2022,4,Riyadh Region,"Research and Development in the Physical, Engineering, and Life Sciences",micro,77,71,46,25,97,89,8
2022,4,Riyadh Region,"Research and Development in the Physical, Engineering, and Life Sciences",medium,4,206,105,101,189,178,11
2022,4,Qassim Region,"Research and Development in the Physical, Engineering, and Life Sciences",micro,3,0,0,0,5,5,0
2022,4,Al Madinah Region,"Research and Development in the Physical, Engineering, and Life Sciences",small,2,6,6,0,7,5,2
2022,4,Al Madinah Region,"Research and Development in the Physical, Engineering, and Life Sciences",micro,10,8,4,4,11,11,0
2022,4,Tabuk Region,"Research and Development in the Physical, Engineering, and Life Sciences",micro,1,0,0,0,1,1,0
2022,4,Jazan Region,"Research and Development in the Physical, Engineering, and Life Sciences",small,1,9,6,3,1,1,0
2022,4,Jazan Region,"Research and Development in the Physical, Engineering, and Life Sciences",micro,1,0,0,0,1,1,0
2022,4,Hail Region,"Research and Development in the Physical, Engineering, and Life Sciences",micro,1,4,0,4,0,0,0
2022,4,Aseer Region,"Research and Development in the Physical, Engineering, and Life Sciences",small,2,20,2,18,2,2,0
2022,4,Aseer Region,"Research and Development in the Physical, Engineering, and Life Sciences",micro,3,2,0,2,6,5,1
2022,4,Makkah Region,"Research and Development in the Physical, Engineering, and Life Sciences",small,11,68,38,30,120,115,5
2022,4,Makkah Region,"Research and Development in the Physical, Engineering, and Life Sciences",large,1,1081,1074,7,46,46,0
2022,4,Makkah Region,"Research and Development in the Physical, Engineering, and Life Sciences",micro,42,47,11,36,66,59,7
2022,4,Makkah Region,"Research and Development in the Physical, Engineering, and Life Sciences",medium,2,105,101,4,118,118,0
2022,4,Eastern Province,Undifferentiated Goods-Producing Activities of Private Households for Own Use,small,1,0,0,0,12,12,0
2022,4,Eastern Province,Undifferentiated Goods-Producing Activities of Private Households for Own Use,micro,2,0,0,0,2,2,0
2022,4,Riyadh Region,Undifferentiated Goods-Producing Activities of Private Households for Own Use,small,1,0,0,0,6,6,0
2022,4,Qassim Region,Undifferentiated Goods-Producing Activities of Private Households for Own Use,micro,1,0,0,0,1,1,0
2022,4,Makkah Region,Undifferentiated Goods-Producing Activities of Private Households for Own Use,micro,2,0,0,0,2,0,2
2022,4,Eastern Province,"Other Professional, Scientific, and Technical Activities",small,29,147,74,73,217,188,29
2022,4,Eastern Province,"Other Professional, Scientific, and Technical Activities",large,1,252,212,40,329,327,2
2022,4,Eastern Province,"Other Professional, Scientific, and Technical Activities",micro,218,166,68,98,313,270,43
2022,4,Al Bahah Region,"Other Professional, Scientific, and Technical Activities",micro,14,6,4,2,32,28,4
2022,4,Al Jawf Region,"Other Professional, Scientific, and Technical Activities",small,2,3,1,2,9,9,0
2022,4,Al Jawf Region,"Other Professional, Scientific, and Technical Activities",micro,19,4,2,2,36,27,9
2022,4,Northern Borders Region,"Other Professional, Scientific, and Technical Activities",micro,12,3,0,3,23,20,3
2022,4,Riyadh Region,"Other Professional, Scientific, and Technical Activities",small,142,857,367,490,1119,944,175
2022,4,Riyadh Region,"Other Professional, Scientific, and Technical Activities",large,2,252,185,67,355,355,0
2022,4,Riyadh Region,"Other Professional, Scientific, and Technical Activities",micro,577,328,118,210,950,821,129
2022,4,Riyadh Region,"Other Professional, Scientific, and Technical Activities",medium,8,542,301,241,365,345,20
2022,4,Qassim Region,"Other Professional, Scientific, and Technical Activities",small,11,69,52,17,154,153,1
2022,4,Qassim Region,"Other Professional, Scientific, and Technical Activities",micro,40,21,11,10,70,63,7
2022,4,Al Madinah Region,"Other Professional, Scientific, and Technical Activities",small,10,32,19,13,61,44,17
2022,4,Al Madinah Region,"Other Professional, Scientific, and Technical Activities",micro,109,50,22,28,183,161,22
2022,4,Tabuk Region,"Other Professional, Scientific, and Technical Activities",small,2,4,4,0,10,10,0
2022,4,Tabuk Region,"Other Professional, Scientific, and Technical Activities",micro,46,11,6,5,82,78,4
2022,4,Jazan Region,"Other Professional, Scientific, and Technical Activities",small,2,8,1,7,6,6,0
2022,4,Jazan Region,"Other Professional, Scientific, and Technical Activities",micro,47,12,3,9,76,73,3
2022,4,Hail Region,"Other Professional, Scientific, and Technical Activities",micro,30,6,0,6,53,49,4
2022,4,Aseer Region,"Other Professional, Scientific, and Technical Activities",small,5,33,16,17,26,26,0
2022,4,Aseer Region,"Other Professional, Scientific, and Technical Activities",micro,56,19,6,13,107,100,7
2022,4,Aseer Region,"Other Professional, Scientific, and Technical Activities",medium,1,20,19,1,61,61,0
2022,4,Makkah Region,"Other Professional, Scientific, and Technical Activities",small,76,346,177,169,602,551,51
2022,4,Makkah Region,"Other Professional, Scientific, and Technical Activities",micro,456,224,70,154,777,653,124
2022,4,Makkah Region,"Other Professional, Scientific, and Technical Activities",medium,3,125,102,23,95,95,0
2022,4,Najran Region,"Other Professional, Scientific, and Technical Activities",micro,31,1,0,1,63,59,4
2022,4,Eastern Province,Activities Auxiliary to Financial Services and Insurance Activities,small,30,363,190,173,145,142,3
2022,4,Eastern Province,Activities Auxiliary to Financial Services and Insurance Activities,large,1,247,100,147,92,87,5
2022,4,Eastern Province,Activities Auxiliary to Financial Services and Insurance Activities,micro,37,50,37,13,44,41,3
2022,4,Eastern Province,Activities Auxiliary to Financial Services and Insurance Activities,medium,5,323,177,146,93,84,9
2022,4,Al Jawf Region,Activities Auxiliary to Financial Services and Insurance Activities,micro,1,0,0,0,2,2,0
2022,4,Riyadh Region,Activities Auxiliary to Financial Services and Insurance Activities,small,153,1997,1240,757,798,751,47
2022,4,Riyadh Region,Activities Auxiliary to Financial Services and Insurance Activities,large,11,23618,18796,4822,1346,1324,22
2022,4,Riyadh Region,Activities Auxiliary to Financial Services and Insurance Activities,micro,184,249,149,100,166,160,6
2022,4,Riyadh Region,Activities Auxiliary to Financial Services and Insurance Activities,medium,38,4020,2793,1227,841,783,58
2022,4,Qassim Region,Activities Auxiliary to Financial Services and Insurance Activities,small,1,0,0,0,6,6,0
2022,4,Qassim Region,Activities Auxiliary to Financial Services and Insurance Activities,micro,6,6,3,3,5,5,0
2022,4,Al Madinah Region,Activities Auxiliary to Financial Services and Insurance Activities,small,5,26,19,7,7,7,0
2022,4,Al Madinah Region,Activities Auxiliary to Financial Services and Insurance Activities,micro,10,24,22,2,7,7,0
2022,4,Tabuk Region,Activities Auxiliary to Financial Services and Insurance Activities,micro,2,2,2,0,3,3,0
2022,4,Jazan Region,Activities Auxiliary to Financial Services and Insurance Activities,small,1,2,2,0,5,5,0
2022,4,Hail Region,Activities Auxiliary to Financial Services and Insurance Activities,micro,1,1,0,1,1,1,0
2022,4,Aseer Region,Activities Auxiliary to Financial Services and Insurance Activities,micro,6,2,1,1,6,6,0
2022,4,Makkah Region,Activities Auxiliary to Financial Services and Insurance Activities,small,52,587,357,230,285,275,10
2022,4,Makkah Region,Activities Auxiliary to Financial Services and Insurance Activities,micro,70,78,48,30,91,89,2
2022,4,Makkah Region,Activities Auxiliary to Financial Services and Insurance Activities,medium,11,792,517,275,254,246,8
2022,4,Najran Region,Activities Auxiliary to Financial Services and Insurance Activities,small,1,20,19,1,9,9,0
2022,4,Najran Region,Activities Auxiliary to Financial Services and Insurance Activities,micro,2,0,0,0,2,2,0
2022,4,Eastern Province,Legal and Accounting Activities,small,122,826,520,306,541,531,10
2022,4,Eastern Province,Legal and Accounting Activities,micro,278,398,246,152,266,259,7
2022,4,Eastern Province,Legal and Accounting Activities,medium,8,431,244,187,318,316,2
2022,4,Al Bahah Region,Legal and Accounting Activities,small,1,6,0,6,4,0,4
2022,4,Al Bahah Region,Legal and Accounting Activities,micro,12,14,7,7,13,13,0
2022,4,Al Jawf Region,Legal and Accounting Activities,small,8,57,39,18,7,7,0
2022,4,Al Jawf Region,Legal and Accounting Activities,micro,30,33,20,13,25,25,0
2022,4,Northern Borders Region,Legal and Accounting Activities,small,1,6,4,2,5,5,0
2022,4,Northern Borders Region,Legal and Accounting Activities,micro,7,9,7,2,6,6,0
2022,4,Riyadh Region,Legal and Accounting Activities,small,491,3717,2250,1467,2577,2474,103
2022,4,Riyadh Region,Legal and Accounting Activities,large,2,593,316,277,558,508,50
2022,4,Riyadh Region,Legal and Accounting Activities,micro,1534,1520,983,537,2065,2032,33
2022,4,Riyadh Region,Legal and Accounting Activities,medium,28,1189,682,507,1295,1233,62
2022,4,Qassim Region,Legal and Accounting Activities,small,17,119,63,56,23,23,0
2022,4,Qassim Region,Legal and Accounting Activities,micro,81,108,61,47,66,65,1
2022,4,Al Madinah Region,Legal and Accounting Activities,small,32,246,147,99,115,114,1
2022,4,Al Madinah Region,Legal and Accounting Activities,micro,86,117,76,41,86,80,6
2022,4,Tabuk Region,Legal and Accounting Activities,small,6,52,23,29,6,6,0
2022,4,Tabuk Region,Legal and Accounting Activities,micro,28,26,11,15,16,16,0
2022,4,Jazan Region,Legal and Accounting Activities,small,7,74,48,26,21,21,0
2022,4,Jazan Region,Legal and Accounting Activities,micro,36,40,29,11,44,43,1
2022,4,Hail Region,Legal and Accounting Activities,small,4,30,27,3,12,12,0
2022,4,Hail Region,Legal and Accounting Activities,micro,32,33,23,10,30,28,2
2022,4,Aseer Region,Legal and Accounting Activities,small,7,49,45,4,51,51,0
2022,4,Aseer Region,Legal and Accounting Activities,micro,77,78,57,21,77,77,0
2022,4,Aseer Region,Legal and Accounting Activities,medium,2,75,40,35,84,84,0
2022,4,Makkah Region,Legal and Accounting Activities,small,286,2231,1408,823,1220,1147,73
2022,4,Makkah Region,Legal and Accounting Activities,micro,753,1074,652,422,736,697,39
2022,4,Makkah Region,Legal and Accounting Activities,medium,13,859,503,356,819,799,20
2022,4,Najran Region,Legal and Accounting Activities,small,4,13,9,4,26,26,0
2022,4,Najran Region,Legal and Accounting Activities,micro,37,9,7,2,75,73,2
2022,4,Eastern Province,Real Estate Activities,small,216,1274,802,472,1776,1758,18
2022,4,Eastern Province,Real Estate Activities,large,2,150,50,100,468,468,0
2022,4,Eastern Province,Real Estate Activities,micro,723,550,325,225,1005,993,12
2022,4,Eastern Province,Real Estate Activities,medium,17,981,626,355,932,916,16
2022,4,Al Bahah Region,Real Estate Activities,small,5,28,24,4,49,49,0
2022,4,Al Bahah Region,Real Estate Activities,micro,28,9,5,4,47,47,0
2022,4,Al Jawf Region,Real Estate Activities,small,9,46,27,19,78,78,0
2022,4,Al Jawf Region,Real Estate Activities,micro,54,28,17,11,85,83,2
2022,4,Northern Borders Region,Real Estate Activities,small,4,21,16,5,31,31,0
2022,4,Northern Borders Region,Real Estate Activities,micro,41,8,5,3,77,76,1
2022,4,Riyadh Region,Real Estate Activities,small,750,4715,2824,1891,6211,6077,134
2022,4,Riyadh Region,Real Estate Activities,large,9,2804,1947,857,2244,2196,48
2022,4,Riyadh Region,Real Estate Activities,micro,2256,1883,1132,751,3006,2968,38
2022,4,Riyadh Region,Real Estate Activities,medium,61,2970,2145,825,2749,2705,44
2022,4,Qassim Region,Real Estate Activities,small,30,185,119,66,201,200,1
2022,4,Qassim Region,Real Estate Activities,large,1,42,28,14,211,211,0
2022,4,Qassim Region,Real Estate Activities,micro,196,121,75,46,299,294,5
2022,4,Qassim Region,Real Estate Activities,medium,7,225,121,104,612,612,0
2022,4,Al Madinah Region,Real Estate Activities,small,45,220,143,77,355,353,2
2022,4,Al Madinah Region,Real Estate Activities,micro,304,133,80,53,493,488,5
2022,4,Al Madinah Region,Real Estate Activities,medium,3,122,93,29,217,211,6
2022,4,Tabuk Region,Real Estate Activities,small,11,52,41,11,100,99,1
2022,4,Tabuk Region,Real Estate Activities,micro,127,50,29,21,199,199,0
2022,4,Jazan Region,Real Estate Activities,small,18,50,22,28,155,155,0
2022,4,Jazan Region,Real Estate Activities,micro,160,55,33,22,271,269,2
2022,4,Jazan Region,Real Estate Activities,medium,1,24,12,12,31,31,0
2022,4,Hail Region,Real Estate Activities,small,9,36,23,13,62,62,0
2022,4,Hail Region,Real Estate Activities,micro,92,42,24,18,145,144,1
2022,4,Hail Region,Real Estate Activities,medium,1,0,0,0,64,64,0
2022,4,Aseer Region,Real Estate Activities,small,36,144,95,49,235,235,0
2022,4,Aseer Region,Real Estate Activities,micro,276,113,60,53,444,441,3
2022,4,Aseer Region,Real Estate Activities,medium,4,89,47,42,230,229,1
2022,4,Makkah Region,Real Estate Activities,small,456,2350,1363,987,3858,3747,111
2022,4,Makkah Region,Real Estate Activities,large,4,825,486,339,816,796,20
2022,4,Makkah Region,Real Estate Activities,micro,1874,1178,684,494,2922,2849,73
2022,4,Makkah Region,Real Estate Activities,medium,44,1652,1171,481,2372,2295,77
2022,4,Najran Region,Real Estate Activities,small,5,11,5,6,29,29,0
2022,4,Najran Region,Real Estate Activities,micro,65,14,6,8,115,115,0
2022,4,Najran Region,Real Estate Activities,medium,1,14,8,6,36,36,0
2022,4,Eastern Province,"Sports, Entertainment, and Recreation Activities",small,134,547,228,319,1140,976,164
2022,4,Eastern Province,"Sports, Entertainment, and Recreation Activities",micro,312,260,90,170,457,403,54
2022,4,Eastern Province,"Sports, Entertainment, and Recreation Activities",medium,9,262,84,178,470,448,22
2022,4,Al Bahah Region,"Sports, Entertainment, and Recreation Activities",small,3,13,10,3,14,13,1
2022,4,Al Bahah Region,"Sports, Entertainment, and Recreation Activities",micro,26,14,5,9,57,51,6
2022,4,Al Jawf Region,"Sports, Entertainment, and Recreation Activities",small,10,38,21,17,64,64,0
2022,4,Al Jawf Region,"Sports, Entertainment, and Recreation Activities",micro,41,17,10,7,75,67,8
2022,4,Northern Borders Region,"Sports, Entertainment, and Recreation Activities",small,7,16,4,12,62,57,5
2022,4,Northern Borders Region,"Sports, Entertainment, and Recreation Activities",micro,46,22,10,12,98,84,14
2022,4,Riyadh Region,"Sports, Entertainment, and Recreation Activities",small,272,1422,536,886,2635,2304,331
2022,4,Riyadh Region,"Sports, Entertainment, and Recreation Activities",large,6,1336,802,534,1736,1393,343
2022,4,Riyadh Region,"Sports, Entertainment, and Recreation Activities",micro,744,482,174,308,1311,1199,112
2022,4,Riyadh Region,"Sports, Entertainment, and Recreation Activities",medium,27,1240,488,752,1349,1113,236
2022,4,Qassim Region,"Sports, Entertainment, and Recreation Activities",small,46,236,110,126,386,363,23
2022,4,Qassim Region,"Sports, Entertainment, and Recreation Activities",micro,81,73,25,48,114,95,19
2022,4,Qassim Region,"Sports, Entertainment, and Recreation Activities",medium,1,81,12,69,138,138,0
2022,4,Al Madinah Region,"Sports, Entertainment, and Recreation Activities",small,36,184,62,122,303,279,24
2022,4,Al Madinah Region,"Sports, Entertainment, and Recreation Activities",micro,102,76,34,42,172,150,22
2022,4,Al Madinah Region,"Sports, Entertainment, and Recreation Activities",medium,1,66,29,37,81,71,10
2022,4,Tabuk Region,"Sports, Entertainment, and Recreation Activities",small,21,84,29,55,141,124,17
2022,4,Tabuk Region,"Sports, Entertainment, and Recreation Activities",micro,76,37,16,21,124,116,8
2022,4,Jazan Region,"Sports, Entertainment, and Recreation Activities",small,13,40,8,32,184,167,17
2022,4,Jazan Region,"Sports, Entertainment, and Recreation Activities",micro,64,42,14,28,91,83,8
2022,4,Jazan Region,"Sports, Entertainment, and Recreation Activities",medium,3,32,17,15,200,200,0
2022,4,Hail Region,"Sports, Entertainment, and Recreation Activities",small,22,98,42,56,202,200,2
2022,4,Hail Region,"Sports, Entertainment, and Recreation Activities",micro,60,44,23,21,109,103,6
2022,4,Aseer Region,"Sports, Entertainment, and Recreation Activities",small,63,288,92,196,558,499,59
2022,4,Aseer Region,"Sports, Entertainment, and Recreation Activities",micro,134,94,37,57,229,212,17
2022,4,Makkah Region,"Sports, Entertainment, and Recreation Activities",small,206,1099,447,652,1533,1335,198
2022,4,Makkah Region,"Sports, Entertainment, and Recreation Activities",micro,597,375,160,215,1004,909,95
2022,4,Makkah Region,"Sports, Entertainment, and Recreation Activities",medium,24,1268,511,757,1222,1075,147
2022,4,Najran Region,"Sports, Entertainment, and Recreation Activities",small,18,72,43,29,139,135,4
2022,4,Najran Region,"Sports, Entertainment, and Recreation Activities",micro,37,16,5,11,76,68,8
2022,4,Eastern Province,Veterinary Activities,small,14,74,28,46,137,129,8
2022,4,Eastern Province,Veterinary Activities,micro,48,25,15,10,81,76,5
2022,4,Eastern Province,Veterinary Activities,medium,1,28,28,0,34,34,0
2022,4,Al Bahah Region,Veterinary Activities,micro,1,0,0,0,2,2,0
2022,4,Al Jawf Region,Veterinary Activities,micro,1,0,0,0,4,4,0
2022,4,Northern Borders Region,Veterinary Activities,micro,5,2,2,0,10,10,0
2022,4,Riyadh Region,Veterinary Activities,small,36,183,87,96,304,267,37
2022,4,Riyadh Region,Veterinary Activities,micro,76,36,11,25,122,118,4
2022,4,Riyadh Region,Veterinary Activities,medium,3,89,41,48,130,120,10
2022,4,Qassim Region,Veterinary Activities,small,3,9,5,4,12,12,0
2022,4,Qassim Region,Veterinary Activities,micro,19,8,6,2,34,33,1
2022,4,Qassim Region,Veterinary Activities,medium,1,79,79,0,48,48,0
2022,4,Al Madinah Region,Veterinary Activities,small,2,5,1,4,13,10,3
2022,4,Al Madinah Region,Veterinary Activities,micro,18,2,1,1,34,32,2
2022,4,Tabuk Region,Veterinary Activities,small,2,6,1,5,14,13,1
2022,4,Tabuk Region,Veterinary Activities,micro,8,3,3,0,14,14,0
2022,4,Jazan Region,Veterinary Activities,micro,7,2,2,0,14,14,0
2022,4,Hail Region,Veterinary Activities,small,1,1,0,1,6,6,0
2022,4,Hail Region,Veterinary Activities,micro,6,0,0,0,11,11,0
2022,4,Aseer Region,Veterinary Activities,small,4,10,5,5,32,29,3
2022,4,Aseer Region,Veterinary Activities,micro,30,6,3,3,48,47,1
2022,4,Makkah Region,Veterinary Activities,small,18,93,24,69,171,149,22
2022,4,Makkah Region,Veterinary Activities,micro,52,22,10,12,107,102,5
2022,4,Makkah Region,Veterinary Activities,medium,1,20,7,13,40,33,7
2022,4,Najran Region,Veterinary Activities,small,1,1,1,0,5,5,0
2022,4,Najran Region,Veterinary Activities,micro,9,0,0,0,12,12,0
2022,4,Eastern Province,Rental and Leasing Activities,small,327,1134,743,391,3682,3672,10
2022,4,Eastern Province,Rental and Leasing Activities,large,11,1311,977,334,3137,3134,3
2022,4,Eastern Province,Rental and Leasing Activities,micro,2014,465,260,205,4157,4146,11
2022,4,Eastern Province,Rental and Leasing Activities,medium,38,879,638,241,2999,2994,5
2022,4,Al Bahah Region,Rental and Leasing Activities,small,8,9,4,5,50,50,0
2022,4,Al Bahah Region,Rental and Leasing Activities,micro,148,19,13,6,276,274,2
2022,4,Al Jawf Region,Rental and Leasing Activities,small,31,24,17,7,195,195,0
2022,4,Al Jawf Region,Rental and Leasing Activities,micro,611,40,28,12,1228,1217,11
2022,4,Al Jawf Region,Rental and Leasing Activities,medium,1,10,10,0,45,45,0
2022,4,Northern Borders Region,Rental and Leasing Activities,small,11,40,29,11,94,94,0
2022,4,Northern Borders Region,Rental and Leasing Activities,micro,208,17,14,3,435,431,4
2022,4,Riyadh Region,Rental and Leasing Activities,small,1090,1479,861,618,8518,8464,54
2022,4,Riyadh Region,Rental and Leasing Activities,large,6,1537,1276,261,2436,2433,3
2022,4,Riyadh Region,Rental and Leasing Activities,micro,50369,3093,1497,1596,127831,127258,573
2022,4,Riyadh Region,Rental and Leasing Activities,medium,39,1440,1099,341,2947,2940,7
2022,4,Qassim Region,Rental and Leasing Activities,small,66,148,111,37,525,524,1
2022,4,Qassim Region,Rental and Leasing Activities,large,1,62,53,9,263,263,0
2022,4,Qassim Region,Rental and Leasing Activities,micro,1170,157,91,66,2704,2684,20
2022,4,Qassim Region,Rental and Leasing Activities,medium,4,136,109,27,444,444,0
2022,4,Al Madinah Region,Rental and Leasing Activities,small,85,251,162,89,861,859,2
2022,4,Al Madinah Region,Rental and Leasing Activities,micro,1028,140,86,54,2082,2068,14
2022,4,Al Madinah Region,Rental and Leasing Activities,medium,4,148,143,5,351,351,0
2022,4,Tabuk Region,Rental and Leasing Activities,small,20,104,96,8,212,212,0
2022,4,Tabuk Region,Rental and Leasing Activities,micro,436,42,23,19,795,792,3
2022,4,Tabuk Region,Rental and Leasing Activities,medium,2,39,26,13,127,127,0
2022,4,Jazan Region,Rental and Leasing Activities,small,25,36,24,12,257,249,8
2022,4,Jazan Region,Rental and Leasing Activities,micro,1145,89,54,35,2598,2590,8
2022,4,Jazan Region,Rental and Leasing Activities,medium,1,38,38,0,28,28,0
2022,4,Hail Region,Rental and Leasing Activities,small,48,38,26,12,344,341,3
2022,4,Hail Region,Rental and Leasing Activities,micro,909,72,40,32,2339,2327,12
2022,4,Hail Region,Rental and Leasing Activities,medium,1,0,0,0,76,76,0
2022,4,Aseer Region,Rental and Leasing Activities,small,61,163,106,57,516,514,2
2022,4,Aseer Region,Rental and Leasing Activities,micro,1427,176,111,65,2820,2813,7
2022,4,Aseer Region,Rental and Leasing Activities,medium,1,64,64,0,61,60,1
2022,4,Makkah Region,Rental and Leasing Activities,small,233,771,517,254,2220,2198,22
2022,4,Makkah Region,Rental and Leasing Activities,large,4,475,364,111,1029,1028,1
2022,4,Makkah Region,Rental and Leasing Activities,micro,3277,461,285,176,7014,6922,92
2022,4,Makkah Region,Rental and Leasing Activities,medium,22,684,567,117,1192,1191,1
2022,4,Najran Region,Rental and Leasing Activities,small,43,50,31,19,369,369,0
2022,4,Najran Region,Rental and Leasing Activities,micro,1268,68,37,31,3051,3033,18
2022,4,Eastern Province,"Office Administrative, Office Support, and Other Business Support Activities",small,137,775,367,408,1100,1079,21
2022,4,Eastern Province,"Office Administrative, Office Support, and Other Business Support Activities",large,1,501,392,109,570,570,0
2022,4,Eastern Province,"Office Administrative, Office Support, and Other Business Support Activities",micro,757,429,198,231,1257,1224,33
2022,4,Eastern Province,"Office Administrative, Office Support, and Other Business Support Activities",medium,14,834,598,236,923,908,15
2022,4,Al Bahah Region,"Office Administrative, Office Support, and Other Business Support Activities",small,6,26,21,5,35,35,0
2022,4,Al Bahah Region,"Office Administrative, Office Support, and Other Business Support Activities",micro,45,22,15,7,77,77,0
2022,4,Al Jawf Region,"Office Administrative, Office Support, and Other Business Support Activities",small,3,5,2,3,29,29,0
2022,4,Al Jawf Region,"Office Administrative, Office Support, and Other Business Support Activities",micro,84,22,13,9,167,166,1
2022,4,Northern Borders Region,"Office Administrative, Office Support, and Other Business Support Activities",small,3,4,1,3,19,19,0
2022,4,Northern Borders Region,"Office Administrative, Office Support, and Other Business Support Activities",micro,48,14,7,7,90,90,0
2022,4,Riyadh Region,"Office Administrative, Office Support, and Other Business Support Activities",small,537,3203,1413,1790,4379,4103,276
2022,4,Riyadh Region,"Office Administrative, Office Support, and Other Business Support Activities",large,12,4619,2670,1949,2867,2596,271
2022,4,Riyadh Region,"Office Administrative, Office Support, and Other Business Support Activities",micro,2279,1322,604,718,3819,3671,148
2022,4,Riyadh Region,"Office Administrative, Office Support, and Other Business Support Activities",medium,48,2411,1093,1318,2314,2137,177
2022,4,Qassim Region,"Office Administrative, Office Support, and Other Business Support Activities",small,19,73,41,32,197,197,0
2022,4,Qassim Region,"Office Administrative, Office Support, and Other Business Support Activities",micro,230,73,46,27,371,370,1
2022,4,Qassim Region,"Office Administrative, Office Support, and Other Business Support Activities",medium,3,24,5,19,152,151,1
2022,4,Al Madinah Region,"Office Administrative, Office Support, and Other Business Support Activities",small,32,189,110,79,255,244,11
2022,4,Al Madinah Region,"Office Administrative, Office Support, and Other Business Support Activities",micro,304,102,54,48,565,539,26
2022,4,Al Madinah Region,"Office Administrative, Office Support, and Other Business Support Activities",medium,1,70,46,24,111,99,12
2022,4,Tabuk Region,"Office Administrative, Office Support, and Other Business Support Activities",small,7,34,25,9,51,51,0
2022,4,Tabuk Region,"Office Administrative, Office Support, and Other Business Support Activities",micro,139,54,22,32,217,215,2
2022,4,Tabuk Region,"Office Administrative, Office Support, and Other Business Support Activities",medium,1,31,16,15,40,34,6
2022,4,Jazan Region,"Office Administrative, Office Support, and Other Business Support Activities",small,5,15,7,8,34,34,0
2022,4,Jazan Region,"Office Administrative, Office Support, and Other Business Support Activities",micro,135,43,26,17,260,257,3
2022,4,Hail Region,"Office Administrative, Office Support, and Other Business Support Activities",small,6,13,11,2,71,71,0
2022,4,Hail Region,"Office Administrative, Office Support, and Other Business Support Activities",micro,172,43,18,25,292,284,8
2022,4,Aseer Region,"Office Administrative, Office Support, and Other Business Support Activities",small,22,70,36,34,133,131,2
2022,4,Aseer Region,"Office Administrative, Office Support, and Other Business Support Activities",micro,309,105,59,46,526,524,2
2022,4,Aseer Region,"Office Administrative, Office Support, and Other Business Support Activities",medium,1,25,16,9,30,30,0
2022,4,Makkah Region,"Office Administrative, Office Support, and Other Business Support Activities",small,292,1458,719,739,2223,2074,149
2022,4,Makkah Region,"Office Administrative, Office Support, and Other Business Support Activities",large,5,2867,1805,1062,1186,1128,58
2022,4,Makkah Region,"Office Administrative, Office Support, and Other Business Support Activities",micro,1512,666,320,346,2722,2577,145
2022,4,Makkah Region,"Office Administrative, Office Support, and Other Business Support Activities",medium,28,1175,664,511,1413,1362,51
2022,4,Najran Region,"Office Administrative, Office Support, and Other Business Support Activities",small,4,14,9,5,17,17,0
2022,4,Najran Region,"Office Administrative, Office Support, and Other Business Support Activities",micro,101,23,7,16,180,179,1
2022,4,Eastern Province,Other Mining and Quarrying Activities,small,56,216,120,96,818,817,1
2022,4,Eastern Province,Other Mining and Quarrying Activities,large,3,1068,833,235,2003,2000,3
2022,4,Eastern Province,Other Mining and Quarrying Activities,micro,93,64,40,24,166,165,1
2022,4,Eastern Province,Other Mining and Quarrying Activities,medium,9,251,206,45,505,505,0
2022,4,Al Bahah Region,Other Mining and Quarrying Activities,small,2,10,2,8,32,32,0
2022,4,Al Bahah Region,Other Mining and Quarrying Activities,micro,6,4,2,2,12,12,0
2022,4,Al Jawf Region,Other Mining and Quarrying Activities,small,2,15,12,3,56,56,0
2022,4,Al Jawf Region,Other Mining and Quarrying Activities,micro,12,6,5,1,19,19,0
2022,4,Northern Borders Region,Other Mining and Quarrying Activities,small,5,8,4,4,29,29,0
2022,4,Northern Borders Region,Other Mining and Quarrying Activities,micro,5,5,3,2,11,11,0
2022,4,Northern Borders Region,Other Mining and Quarrying Activities,medium,2,127,117,10,90,90,0
2022,4,Riyadh Region,Other Mining and Quarrying Activities,small,150,585,314,271,1752,1745,7
2022,4,Riyadh Region,Other Mining and Quarrying Activities,large,4,342,277,65,1216,1216,0
2022,4,Riyadh Region,Other Mining and Quarrying Activities,micro,275,200,109,91,486,483,3
2022,4,Riyadh Region,Other Mining and Quarrying Activities,medium,27,760,379,381,1779,1777,2
2022,4,Qassim Region,Other Mining and Quarrying Activities,small,11,76,47,29,168,168,0
2022,4,Qassim Region,Other Mining and Quarrying Activities,micro,28,16,15,1,45,45,0
2022,4,Qassim Region,Other Mining and Quarrying Activities,medium,2,41,18,23,198,198,0
2022,4,Al Madinah Region,Other Mining and Quarrying Activities,small,28,139,94,45,361,361,0
2022,4,Al Madinah Region,Other Mining and Quarrying Activities,large,2,314,299,15,344,344,0
2022,4,Al Madinah Region,Other Mining and Quarrying Activities,micro,52,37,25,12,84,84,0
2022,4,Al Madinah Region,Other Mining and Quarrying Activities,medium,2,30,25,5,255,255,0
2022,4,Tabuk Region,Other Mining and Quarrying Activities,small,6,32,18,14,64,64,0
2022,4,Tabuk Region,Other Mining and Quarrying Activities,micro,16,11,7,4,19,19,0
2022,4,Tabuk Region,Other Mining and Quarrying Activities,medium,1,15,9,6,98,98,0
2022,4,Jazan Region,Other Mining and Quarrying Activities,small,20,88,46,42,256,256,0
2022,4,Jazan Region,Other Mining and Quarrying Activities,micro,25,13,6,7,42,42,0
2022,4,Hail Region,Other Mining and Quarrying Activities,small,1,1,0,1,10,10,0
2022,4,Hail Region,Other Mining and Quarrying Activities,micro,12,3,1,2,16,16,0
2022,4,Aseer Region,Other Mining and Quarrying Activities,small,23,93,62,31,253,253,0
2022,4,Aseer Region,Other Mining and Quarrying Activities,micro,56,28,20,8,103,102,1
2022,4,Aseer Region,Other Mining and Quarrying Activities,medium,1,14,14,0,42,42,0
2022,4,Makkah Region,Other Mining and Quarrying Activities,small,71,254,116,138,812,809,3
2022,4,Makkah Region,Other Mining and Quarrying Activities,large,1,166,100,66,297,297,0
2022,4,Makkah Region,Other Mining and Quarrying Activities,micro,134,93,54,39,239,238,1
2022,4,Makkah Region,Other Mining and Quarrying Activities,medium,10,374,328,46,733,733,0
2022,4,Najran Region,Other Mining and Quarrying Activities,small,6,32,19,13,98,98,0
2022,4,Najran Region,Other Mining and Quarrying Activities,micro,16,10,3,7,37,36,1
2022,4,Eastern Province,"Creative, Arts, and Entertainment Activities",small,3,13,8,5,23,23,0
2022,4,Eastern Province,"Creative, Arts, and Entertainment Activities",micro,29,18,5,13,40,35,5
2022,4,Al Bahah Region,"Creative, Arts, and Entertainment Activities",micro,2,1,0,1,5,5,0
2022,4,Northern Borders Region,"Creative, Arts, and Entertainment Activities",micro,1,0,0,0,3,3,0
2022,4,Riyadh Region,"Creative, Arts, and Entertainment Activities",small,14,77,25,52,81,69,12
2022,4,Riyadh Region,"Creative, Arts, and Entertainment Activities",large,2,255,191,64,327,322,5
2022,4,Riyadh Region,"Creative, Arts, and Entertainment Activities",micro,95,65,35,30,138,124,14
2022,4,Riyadh Region,"Creative, Arts, and Entertainment Activities",medium,2,55,27,28,217,214,3
2022,4,Qassim Region,"Creative, Arts, and Entertainment Activities",micro,4,2,1,1,11,11,0
2022,4,Al Madinah Region,"Creative, Arts, and Entertainment Activities",small,1,5,0,5,6,6,0
2022,4,Al Madinah Region,"Creative, Arts, and Entertainment Activities",micro,13,6,3,3,20,18,2
2022,4,Tabuk Region,"Creative, Arts, and Entertainment Activities",micro,3,1,1,0,6,6,0
2022,4,Jazan Region,"Creative, Arts, and Entertainment Activities",micro,1,1,1,0,2,2,0
2022,4,Hail Region,"Creative, Arts, and Entertainment Activities",micro,2,0,0,0,2,2,0
2022,4,Aseer Region,"Creative, Arts, and Entertainment Activities",small,2,3,2,1,11,11,0
2022,4,Aseer Region,"Creative, Arts, and Entertainment Activities",micro,9,1,1,0,20,20,0
2022,4,Aseer Region,"Creative, Arts, and Entertainment Activities",medium,1,22,4,18,28,28,0
2022,4,Makkah Region,"Creative, Arts, and Entertainment Activities",small,8,33,13,20,56,54,2
2022,4,Makkah Region,"Creative, Arts, and Entertainment Activities",micro,100,59,22,37,141,125,16
2022,4,Najran Region,"Creative, Arts, and Entertainment Activities",micro,2,0,0,0,5,5,0
2022,4,Eastern Province,Accommodation,small,275,1287,695,592,2484,2463,21
2022,4,Eastern Province,Accommodation,large,1,95,67,28,168,168,0
2022,4,Eastern Province,Accommodation,micro,304,254,134,120,525,518,7
2022,4,Eastern Province,Accommodation,medium,36,1255,712,543,2082,2003,79
2022,4,Al Bahah Region,Accommodation,small,19,71,43,28,150,150,0
2022,4,Al Bahah Region,Accommodation,micro,79,54,40,14,129,128,1
2022,4,Al Bahah Region,Accommodation,medium,1,22,13,9,42,42,0
2022,4,Al Jawf Region,Accommodation,small,10,25,13,12,63,63,0
2022,4,Al Jawf Region,Accommodation,micro,61,39,22,17,119,118,1
2022,4,Al Jawf Region,Accommodation,medium,1,15,6,9,37,37,0
2022,4,Northern Borders Region,Accommodation,small,14,52,24,28,113,113,0
2022,4,Northern Borders Region,Accommodation,micro,36,19,14,5,73,73,0
2022,4,Northern Borders Region,Accommodation,medium,1,19,9,10,38,38,0
2022,4,Riyadh Region,Accommodation,small,413,2236,1166,1070,4207,4150,57
2022,4,Riyadh Region,Accommodation,large,8,1296,856,440,1686,1591,95
2022,4,Riyadh Region,Accommodation,micro,737,526,260,266,1452,1431,21
2022,4,Riyadh Region,Accommodation,medium,71,2606,1557,1049,4194,4129,65
2022,4,Qassim Region,Accommodation,small,53,260,166,94,451,451,0
2022,4,Qassim Region,Accommodation,large,1,0,0,0,321,315,6
2022,4,Qassim Region,Accommodation,micro,107,85,60,25,217,217,0
2022,4,Qassim Region,Accommodation,medium,3,70,43,27,135,135,0
2022,4,Al Madinah Region,Accommodation,small,180,1165,800,365,1580,1565,15
2022,4,Al Madinah Region,Accommodation,large,4,560,379,181,775,768,7
2022,4,Al Madinah Region,Accommodation,micro,403,297,190,107,725,712,13
2022,4,Al Madinah Region,Accommodation,medium,33,1374,963,411,1943,1920,23
2022,4,Tabuk Region,Accommodation,small,44,240,123,117,356,356,0
2022,4,Tabuk Region,Accommodation,micro,100,72,39,33,177,175,2
2022,4,Tabuk Region,Accommodation,medium,5,196,114,82,346,331,15
2022,4,Jazan Region,Accommodation,small,54,223,108,115,433,407,26
2022,4,Jazan Region,Accommodation,micro,261,139,64,75,432,431,1
2022,4,Jazan Region,Accommodation,medium,5,110,51,59,289,288,1
2022,4,Hail Region,Accommodation,small,26,101,74,27,184,184,0
2022,4,Hail Region,Accommodation,micro,64,50,31,19,122,122,0
2022,4,Hail Region,Accommodation,medium,1,19,13,6,50,50,0
2022,4,Aseer Region,Accommodation,small,109,371,200,171,807,796,11
2022,4,Aseer Region,Accommodation,micro,418,289,161,128,814,804,10
2022,4,Aseer Region,Accommodation,medium,7,200,117,83,367,364,3
2022,4,Makkah Region,Accommodation,small,626,2788,1696,1092,5530,5387,143
2022,4,Makkah Region,Accommodation,large,15,2095,1492,603,2879,2849,30
2022,4,Makkah Region,Accommodation,micro,1128,800,504,296,1997,1951,46
2022,4,Makkah Region,Accommodation,medium,78,3244,2175,1069,4648,4519,129
2022,4,Najran Region,Accommodation,small,24,86,35,51,212,209,3
2022,4,Najran Region,Accommodation,micro,103,42,22,20,232,231,1
2022,4,Najran Region,Accommodation,medium,1,27,8,19,36,33,3
2022,4,Eastern Province,Public Administration and Defense; Compulsory Social Security,small,19,203,136,67,149,141,8
2022,4,Eastern Province,Public Administration and Defense; Compulsory Social Security,large,2,704,525,179,181,177,4
2022,4,Eastern Province,Public Administration and Defense; Compulsory Social Security,micro,92,57,33,24,124,124,0
2022,4,Eastern Province,Public Administration and Defense; Compulsory Social Security,medium,3,156,111,45,129,124,5
2022,4,Al Bahah Region,Public Administration and Defense; Compulsory Social Security,small,2,23,10,13,17,1,16
2022,4,Al Bahah Region,Public Administration and Defense; Compulsory Social Security,micro,8,1,1,0,21,21,0
2022,4,Al Jawf Region,Public Administration and Defense; Compulsory Social Security,micro,7,1,0,1,16,15,1
2022,4,Northern Borders Region,Public Administration and Defense; Compulsory Social Security,small,1,1,0,1,5,5,0
2022,4,Northern Borders Region,Public Administration and Defense; Compulsory Social Security,micro,2,0,0,0,5,5,0
2022,4,Riyadh Region,Public Administration and Defense; Compulsory Social Security,small,47,399,209,190,418,379,39
2022,4,Riyadh Region,Public Administration and Defense; Compulsory Social Security,large,2,1236,801,435,191,183,8
2022,4,Riyadh Region,Public Administration and Defense; Compulsory Social Security,micro,206,101,49,52,329,317,12
2022,4,Riyadh Region,Public Administration and Defense; Compulsory Social Security,medium,5,406,307,99,115,102,13
2022,4,Qassim Region,Public Administration and Defense; Compulsory Social Security,small,6,60,32,28,32,32,0
2022,4,Qassim Region,Public Administration and Defense; Compulsory Social Security,micro,22,5,5,0,50,48,2
2022,4,Qassim Region,Public Administration and Defense; Compulsory Social Security,medium,1,33,11,22,17,13,4
2022,4,Al Madinah Region,Public Administration and Defense; Compulsory Social Security,small,4,24,17,7,15,14,1
2022,4,Al Madinah Region,Public Administration and Defense; Compulsory Social Security,micro,33,8,7,1,71,70,1
2022,4,Tabuk Region,Public Administration and Defense; Compulsory Social Security,small,2,17,6,11,8,7,1
2022,4,Tabuk Region,Public Administration and Defense; Compulsory Social Security,micro,15,0,0,0,36,35,1
2022,4,Tabuk Region,Public Administration and Defense; Compulsory Social Security,medium,1,38,20,18,14,14,0
2022,4,Jazan Region,Public Administration and Defense; Compulsory Social Security,small,1,2,0,2,4,1,3
2022,4,Jazan Region,Public Administration and Defense; Compulsory Social Security,micro,38,5,2,3,113,113,0
2022,4,Hail Region,Public Administration and Defense; Compulsory Social Security,micro,11,7,5,2,18,18,0
2022,4,Aseer Region,Public Administration and Defense; Compulsory Social Security,small,2,6,2,4,12,12,0
2022,4,Aseer Region,Public Administration and Defense; Compulsory Social Security,micro,23,2,0,2,57,57,0
2022,4,Makkah Region,Public Administration and Defense; Compulsory Social Security,small,44,256,154,102,297,286,11
2022,4,Makkah Region,Public Administration and Defense; Compulsory Social Security,large,1,170,105,65,80,79,1
2022,4,Makkah Region,Public Administration and Defense; Compulsory Social Security,micro,218,103,67,36,344,333,11
2022,4,Makkah Region,Public Administration and Defense; Compulsory Social Security,medium,2,316,168,148,87,82,5
2022,4,Najran Region,Public Administration and Defense; Compulsory Social Security,micro,14,5,5,0,29,29,0
2022,4,Eastern Province,Telecommunications,small,26,169,120,49,193,187,6
2022,4,Eastern Province,Telecommunications,micro,96,66,40,26,158,157,1
2022,4,Eastern Province,Telecommunications,medium,4,133,119,14,109,109,0
2022,4,Al Bahah Region,Telecommunications,small,1,3,1,2,8,8,0
2022,4,Al Bahah Region,Telecommunications,micro,3,1,1,0,3,3,0
2022,4,Al Jawf Region,Telecommunications,micro,12,7,3,4,19,19,0
2022,4,Northern Borders Region,Telecommunications,small,1,3,1,2,4,4,0
2022,4,Northern Borders Region,Telecommunications,micro,12,3,0,3,24,23,1
2022,4,Riyadh Region,Telecommunications,small,127,836,393,443,1447,1381,66
2022,4,Riyadh Region,Telecommunications,large,14,20189,15698,4491,3181,3109,72
2022,4,Riyadh Region,Telecommunications,micro,362,195,110,85,668,660,8
2022,4,Riyadh Region,Telecommunications,medium,33,2242,1556,686,1305,1275,30
2022,4,Qassim Region,Telecommunications,small,9,19,8,11,75,75,0
2022,4,Qassim Region,Telecommunications,micro,53,19,11,8,101,101,0
2022,4,Al Madinah Region,Telecommunications,small,2,14,5,9,2,2,0
2022,4,Al Madinah Region,Telecommunications,micro,33,15,10,5,59,59,0
2022,4,Tabuk Region,Telecommunications,small,1,1,1,0,5,5,0
2022,4,Tabuk Region,Telecommunications,micro,16,6,4,2,18,18,0
2022,4,Jazan Region,Telecommunications,small,1,2,2,0,6,6,0
2022,4,Jazan Region,Telecommunications,micro,20,5,4,1,36,36,0
2022,4,Hail Region,Telecommunications,small,1,0,0,0,10,10,0
2022,4,Hail Region,Telecommunications,micro,16,7,0,7,30,28,2
2022,4,Aseer Region,Telecommunications,small,1,1,0,1,6,6,0
2022,4,Aseer Region,Telecommunications,micro,49,21,15,6,79,78,1
2022,4,Makkah Region,Telecommunications,small,30,213,98,115,267,259,8
2022,4,Makkah Region,Telecommunications,micro,241,105,65,40,386,378,8
2022,4,Makkah Region,Telecommunications,medium,2,91,78,13,61,61,0
2022,4,Najran Region,Telecommunications,small,1,0,0,0,12,12,0
2022,4,Najran Region,Telecommunications,micro,12,1,1,0,27,27,0
2022,4,Eastern Province,Repair and Installation of Machinery and Equipment,small,298,1075,759,316,3167,3161,6
2022,4,Eastern Province,Repair and Installation of Machinery and Equipment,large,17,2816,2306,510,7027,7012,15
2022,4,Eastern Province,Repair and Installation of Machinery and Equipment,micro,884,310,168,142,1915,1912,3
2022,4,Eastern Province,Repair and Installation of Machinery and Equipment,medium,68,2039,1506,533,4944,4942,2
2022,4,Al Bahah Region,Repair and Installation of Machinery and Equipment,small,2,2,1,1,14,14,0
2022,4,Al Bahah Region,Repair and Installation of Machinery and Equipment,micro,51,9,7,2,78,78,0
2022,4,Al Jawf Region,Repair and Installation of Machinery and Equipment,small,5,5,4,1,39,39,0
2022,4,Al Jawf Region,Repair and Installation of Machinery and Equipment,micro,68,9,5,4,151,151,0
2022,4,Northern Borders Region,Repair and Installation of Machinery and Equipment,small,1,0,0,0,6,6,0
2022,4,Northern Borders Region,Repair and Installation of Machinery and Equipment,micro,69,4,1,3,181,181,0
2022,4,Northern Borders Region,Repair and Installation of Machinery and Equipment,medium,2,52,48,4,208,208,0
2022,4,Riyadh Region,Repair and Installation of Machinery and Equipment,small,251,925,534,391,2958,2941,17
2022,4,Riyadh Region,Repair and Installation of Machinery and Equipment,large,14,4808,4324,484,5161,5053,108
2022,4,Riyadh Region,Repair and Installation of Machinery and Equipment,micro,1173,298,151,147,2734,2717,17
2022,4,Riyadh Region,Repair and Installation of Machinery and Equipment,medium,77,2432,1822,610,5512,5447,65
2022,4,Qassim Region,Repair and Installation of Machinery and Equipment,small,30,56,22,34,316,316,0
2022,4,Qassim Region,Repair and Installation of Machinery and Equipment,micro,229,33,24,9,551,550,1
2022,4,Qassim Region,Repair and Installation of Machinery and Equipment,medium,6,115,92,23,502,502,0
2022,4,Al Madinah Region,Repair and Installation of Machinery and Equipment,small,21,112,90,22,198,198,0
2022,4,Al Madinah Region,Repair and Installation of Machinery and Equipment,micro,305,54,28,26,623,620,3
2022,4,Al Madinah Region,Repair and Installation of Machinery and Equipment,medium,2,30,20,10,97,97,0
2022,4,Tabuk Region,Repair and Installation of Machinery and Equipment,small,2,5,0,5,16,16,0
2022,4,Tabuk Region,Repair and Installation of Machinery and Equipment,micro,137,17,10,7,292,290,2
2022,4,Tabuk Region,Repair and Installation of Machinery and Equipment,medium,1,34,34,0,20,20,0
2022,4,Jazan Region,Repair and Installation of Machinery and Equipment,small,9,11,6,5,68,68,0
2022,4,Jazan Region,Repair and Installation of Machinery and Equipment,micro,351,28,19,9,850,850,0
2022,4,Jazan Region,Repair and Installation of Machinery and Equipment,medium,1,25,7,18,139,139,0
2022,4,Hail Region,Repair and Installation of Machinery and Equipment,small,5,6,1,5,74,74,0
2022,4,Hail Region,Repair and Installation of Machinery and Equipment,micro,78,13,9,4,161,161,0
2022,4,Aseer Region,Repair and Installation of Machinery and Equipment,small,16,36,22,14,134,132,2
2022,4,Aseer Region,Repair and Installation of Machinery and Equipment,large,1,71,45,26,293,293,0
2022,4,Aseer Region,Repair and Installation of Machinery and Equipment,micro,226,29,14,15,479,479,0
2022,4,Aseer Region,Repair and Installation of Machinery and Equipment,medium,1,13,12,1,44,44,0
2022,4,Makkah Region,Repair and Installation of Machinery and Equipment,small,151,506,265,241,1668,1660,8
2022,4,Makkah Region,Repair and Installation of Machinery and Equipment,large,2,633,626,7,105,105,0
2022,4,Makkah Region,Repair and Installation of Machinery and Equipment,micro,1027,219,117,102,2345,2335,10
2022,4,Makkah Region,Repair and Installation of Machinery and Equipment,medium,30,1079,845,234,2245,2230,15
2022,4,Najran Region,Repair and Installation of Machinery and Equipment,small,5,5,1,4,50,50,0
2022,4,Najran Region,Repair and Installation of Machinery and Equipment,micro,53,9,5,4,136,136,0
2022,4,Eastern Province,Repair of Computers and Personal and Household Goods,small,93,149,100,49,936,915,21
2022,4,Eastern Province,Repair of Computers and Personal and Household Goods,large,2,0,0,0,577,577,0
2022,4,Eastern Province,Repair of Computers and Personal and Household Goods,micro,914,196,118,78,1943,1940,3
2022,4,Eastern Province,Repair of Computers and Personal and Household Goods,medium,13,422,314,108,1042,1042,0
2022,4,Al Bahah Region,Repair of Computers and Personal and Household Goods,small,2,2,1,1,17,17,0
2022,4,Al Bahah Region,Repair of Computers and Personal and Household Goods,micro,68,12,12,0,118,118,0
2022,4,Al Jawf Region,Repair of Computers and Personal and Household Goods,small,10,5,3,2,129,129,0
2022,4,Al Jawf Region,Repair of Computers and Personal and Household Goods,micro,148,23,16,7,324,324,0
2022,4,Northern Borders Region,Repair of Computers and Personal and Household Goods,small,2,3,1,2,9,9,0
2022,4,Northern Borders Region,Repair of Computers and Personal and Household Goods,micro,76,12,6,6,166,166,0
2022,4,Riyadh Region,Repair of Computers and Personal and Household Goods,small,359,352,199,153,5710,5687,23
2022,4,Riyadh Region,Repair of Computers and Personal and Household Goods,large,26,228,100,128,13547,13541,6
2022,4,Riyadh Region,Repair of Computers and Personal and Household Goods,micro,1925,271,151,120,4290,4264,26
2022,4,Riyadh Region,Repair of Computers and Personal and Household Goods,medium,143,199,93,106,15550,15451,99
2022,4,Qassim Region,Repair of Computers and Personal and Household Goods,small,186,44,25,19,2833,2823,10
2022,4,Qassim Region,Repair of Computers and Personal and Household Goods,large,4,0,0,0,3223,3218,5
2022,4,Qassim Region,Repair of Computers and Personal and Household Goods,micro,652,71,50,21,1480,1478,2
2022,4,Qassim Region,Repair of Computers and Personal and Household Goods,medium,30,43,33,10,2667,2664,3
2022,4,Al Madinah Region,Repair of Computers and Personal and Household Goods,small,16,10,3,7,158,155,3
2022,4,Al Madinah Region,Repair of Computers and Personal and Household Goods,micro,361,69,42,27,741,734,7
2022,4,Tabuk Region,Repair of Computers and Personal and Household Goods,small,17,13,12,1,134,134,0
2022,4,Tabuk Region,Repair of Computers and Personal and Household Goods,micro,255,36,29,7,551,549,2
2022,4,Tabuk Region,Repair of Computers and Personal and Household Goods,medium,2,0,0,0,148,148,0
2022,4,Jazan Region,Repair of Computers and Personal and Household Goods,small,14,17,8,9,109,109,0
2022,4,Jazan Region,Repair of Computers and Personal and Household Goods,micro,269,43,25,18,622,619,3
2022,4,Hail Region,Repair of Computers and Personal and Household Goods,small,23,18,6,12,234,234,0
2022,4,Hail Region,Repair of Computers and Personal and Household Goods,micro,302,24,17,7,710,706,4
2022,4,Aseer Region,Repair of Computers and Personal and Household Goods,small,35,27,10,17,287,287,0
2022,4,Aseer Region,Repair of Computers and Personal and Household Goods,micro,550,81,48,33,1242,1241,1
2022,4,Makkah Region,Repair of Computers and Personal and Household Goods,small,127,211,121,90,1156,1145,11
2022,4,Makkah Region,Repair of Computers and Personal and Household Goods,micro,1441,270,165,105,3193,3160,33
2022,4,Makkah Region,Repair of Computers and Personal and Household Goods,medium,7,200,136,64,421,421,0
2022,4,Najran Region,Repair of Computers and Personal and Household Goods,small,47,28,11,17,785,784,1
2022,4,Najran Region,Repair of Computers and Personal and Household Goods,micro,223,16,4,12,545,543,2
2022,4,Najran Region,Repair of Computers and Personal and Household Goods,medium,5,0,0,0,709,709,0
2022,4,Eastern Province,Extraction of Crude Petroleum and Natural Gas,small,17,137,98,39,218,218,0
2022,4,Eastern Province,Extraction of Crude Petroleum and Natural Gas,large,5,65997,62183,3814,7304,6687,617
2022,4,Eastern Province,Extraction of Crude Petroleum and Natural Gas,micro,29,22,15,7,43,43,0
2022,4,Eastern Province,Extraction of Crude Petroleum and Natural Gas,medium,10,793,754,39,555,550,5
2022,4,Al Jawf Region,Extraction of Crude Petroleum and Natural Gas,micro,7,0,0,0,14,14,0
2022,4,Riyadh Region,Extraction of Crude Petroleum and Natural Gas,small,8,2,1,1,111,111,0
2022,4,Riyadh Region,Extraction of Crude Petroleum and Natural Gas,micro,17,7,4,3,30,30,0
2022,4,Riyadh Region,Extraction of Crude Petroleum and Natural Gas,medium,2,49,37,12,130,130,0
2022,4,Qassim Region,Extraction of Crude Petroleum and Natural Gas,micro,1,1,0,1,4,4,0
2022,4,Al Madinah Region,Extraction of Crude Petroleum and Natural Gas,micro,1,0,0,0,2,2,0
2022,4,Al Madinah Region,Extraction of Crude Petroleum and Natural Gas,medium,1,76,76,0,34,34,0
2022,4,Jazan Region,Extraction of Crude Petroleum and Natural Gas,micro,1,0,0,0,3,3,0
2022,4,Aseer Region,Extraction of Crude Petroleum and Natural Gas,micro,3,1,0,1,4,4,0
2022,4,Makkah Region,Extraction of Crude Petroleum and Natural Gas,large,1,335,333,2,25,25,0
2022,4,Makkah Region,Extraction of Crude Petroleum and Natural Gas,micro,2,1,0,1,9,9,0
2022,4,Najran Region,Extraction of Crude Petroleum and Natural Gas,small,2,3,3,0,15,15,0
2022,4,Najran Region,Extraction of Crude Petroleum and Natural Gas,micro,6,2,2,0,12,11,1
2022,4,Eastern Province,Advertising and Market Research,small,209,992,432,560,1591,1566,25
2022,4,Eastern Province,Advertising and Market Research,large,3,651,589,62,716,713,3
2022,4,Eastern Province,Advertising and Market Research,micro,686,424,153,271,1237,1214,23
2022,4,Eastern Province,Advertising and Market Research,medium,9,412,100,312,429,424,5
2022,4,Al Bahah Region,Advertising and Market Research,small,2,7,5,2,7,7,0
2022,4,Al Bahah Region,Advertising and Market Research,micro,28,17,11,6,52,52,0
2022,4,Al Jawf Region,Advertising and Market Research,small,7,9,7,2,39,39,0
2022,4,Al Jawf Region,Advertising and Market Research,micro,77,12,6,6,165,163,2
2022,4,Northern Borders Region,Advertising and Market Research,small,3,17,7,10,27,27,0
2022,4,Northern Borders Region,Advertising and Market Research,micro,31,5,3,2,55,55,0
2022,4,Riyadh Region,Advertising and Market Research,small,632,3648,1518,2130,4812,4583,229
2022,4,Riyadh Region,Advertising and Market Research,large,7,6791,5440,1351,1255,1017,238
2022,4,Riyadh Region,Advertising and Market Research,micro,1981,1287,513,774,3227,3075,152
2022,4,Riyadh Region,Advertising and Market Research,medium,34,1446,763,683,1629,1398,231
2022,4,Qassim Region,Advertising and Market Research,small,34,130,62,68,283,282,1
2022,4,Qassim Region,Advertising and Market Research,micro,162,66,41,25,314,311,3
2022,4,Al Madinah Region,Advertising and Market Research,small,29,98,45,53,152,151,1
2022,4,Al Madinah Region,Advertising and Market Research,micro,225,108,43,65,395,383,12
2022,4,Tabuk Region,Advertising and Market Research,small,11,43,19,24,74,74,0
2022,4,Tabuk Region,Advertising and Market Research,micro,82,24,13,11,176,173,3
2022,4,Jazan Region,Advertising and Market Research,small,10,30,14,16,72,71,1
2022,4,Jazan Region,Advertising and Market Research,micro,102,28,12,16,200,200,0
2022,4,Hail Region,Advertising and Market Research,small,4,5,1,4,23,23,0
2022,4,Hail Region,Advertising and Market Research,micro,71,24,11,13,147,147,0
2022,4,Aseer Region,Advertising and Market Research,small,30,129,64,65,225,225,0
2022,4,Aseer Region,Advertising and Market Research,micro,168,76,45,31,319,319,0
2022,4,Aseer Region,Advertising and Market Research,medium,1,61,1,60,3,3,0
2022,4,Makkah Region,Advertising and Market Research,small,361,1772,787,985,2811,2656,155
2022,4,Makkah Region,Advertising and Market Research,large,1,172,166,6,232,231,1
2022,4,Makkah Region,Advertising and Market Research,micro,1531,738,291,447,2748,2567,181
2022,4,Makkah Region,Advertising and Market Research,medium,20,797,354,443,833,749,84
2022,4,Najran Region,Advertising and Market Research,small,9,29,8,21,97,97,0
2022,4,Najran Region,Advertising and Market Research,micro,42,10,6,4,104,102,2
2022,4,Eastern Province,Unknown,small,160,370,193,177,1449,1412,37
2022,4,Eastern Province,Unknown,large,1,0,0,0,293,238,55
2022,4,Eastern Province,Unknown,micro,4293,685,387,298,7445,7396,49
2022,4,Eastern Province,Unknown,medium,1,29,13,16,64,64,0
2022,4,Al Bahah Region,Unknown,small,12,21,15,6,93,93,0
2022,4,Al Bahah Region,Unknown,micro,659,107,79,28,970,961,9
2022,4,Al Jawf Region,Unknown,small,19,27,6,21,159,157,2
2022,4,Al Jawf Region,Unknown,micro,1378,85,61,24,2326,2304,22
2022,4,Northern Borders Region,Unknown,small,16,25,17,8,118,118,0
2022,4,Northern Borders Region,Unknown,micro,520,67,45,22,879,871,8
2022,4,Riyadh Region,Unknown,small,915,1537,683,854,7757,7603,154
2022,4,Riyadh Region,Unknown,large,7,1964,1190,774,1911,1873,38
2022,4,Riyadh Region,Unknown,micro,60961,3771,1824,1947,139101,137982,1119
2022,4,Riyadh Region,Unknown,medium,15,253,169,84,965,948,17
2022,4,Qassim Region,Unknown,small,46,55,38,17,429,428,1
2022,4,Qassim Region,Unknown,micro,2303,182,105,77,4680,4642,38
2022,4,Qassim Region,Unknown,medium,1,34,19,15,78,33,45
2022,4,Al Madinah Region,Unknown,small,90,181,97,84,689,683,6
2022,4,Al Madinah Region,Unknown,micro,3685,406,254,152,6065,5956,109
2022,4,Tabuk Region,Unknown,small,35,79,53,26,303,303,0
2022,4,Tabuk Region,Unknown,micro,1342,157,93,64,2160,2147,13
2022,4,Tabuk Region,Unknown,medium,1,3,2,1,78,41,37
2022,4,Jazan Region,Unknown,small,48,69,37,32,384,379,5
2022,4,Jazan Region,Unknown,micro,2857,253,142,111,4804,4756,48
2022,4,Jazan Region,Unknown,medium,1,19,15,4,118,118,0
2022,4,Hail Region,Unknown,small,31,56,35,21,305,305,0
2022,4,Hail Region,Unknown,micro,3035,191,93,98,6485,6458,27
2022,4,Hail Region,Unknown,medium,1,0,0,0,100,54,46
2022,4,Aseer Region,Unknown,small,91,155,103,52,657,639,18
2022,4,Aseer Region,Unknown,micro,4575,554,361,193,6702,6659,43
2022,4,Aseer Region,Unknown,medium,1,0,0,0,174,174,0
2022,4,Makkah Region,Unknown,small,412,691,363,328,3347,3285,62
2022,4,Makkah Region,Unknown,large,1,42,26,16,405,405,0
2022,4,Makkah Region,Unknown,micro,11840,1493,819,674,19484,18911,573
2022,4,Makkah Region,Unknown,medium,9,212,136,76,610,577,33
2022,4,Najran Region,Unknown,small,51,44,25,19,418,418,0
2022,4,Najran Region,Unknown,micro,2950,173,81,92,6333,6302,31
